id,画像名,物件名,車番,地域名,分類番号,ひらがな,入出庫日,カテゴリ,幅,高さ,左上x座標,左上y座標,右下x座標,右下y座標
172477,30066_20190815105438.jpg,ジョーシン和泉中央,***8,和泉,30,ま,2019/8/15 10:54,2-1_all_corrected,51,40,330,126,381,166
174317,30078_20190815182730.jpg,イオンスタイル仙台卸町店,8580,宮城,503,と,2019/8/15 18:26,2-1_all_corrected,56,42,343,101,399,143
172484,30045_20190815105649.jpg,マックスバリュー徳川明倫,*358,名古屋,32,と,2019/8/15 10:56,2-1_all_corrected,55,45,257,208,312,253
172470,30144_20190815105203.jpg,イオン幕張,*988,千葉,530,ち,2019/8/15 10:51,2-1_all_corrected,90,65,192,342,282,407
173168,30144_20190815161238.jpg,イオン幕張,2030,千葉,533,ね,2019/8/15 16:12,2-1_all_corrected,54,38,131,96,185,134
173953,30078_20190815180317.jpg,イオンスタイル仙台卸町店,4250,宮城,300,く,2019/8/15 18:02,2-1_all_corrected,95,62,356,366,451,428
174375,30144_20190815183205.jpg,イオン幕張,5555,千葉,314,あ,2019/8/15 18:31,2-1_all_corrected,41,32,202,33,243,65
172244,30060_20190815085756.jpg,関西スーパー小野原,8450,大阪,503,る,2019/8/15 8:57,2-1_all_corrected,98,78,501,225,599,303
173965,30078_20190815180410.jpg,イオンスタイル仙台卸町店,*844,仙台,330,な,2019/8/15 18:03,2-1_all_corrected,81,58,287,258,368,316
173192,30110_20190815162419.jpg,イオン金沢八景,6483,横浜,505,つ,2019/8/15 16:23,2-1_all_corrected,84,66,179,350,263,416
173353,30144_20190815164721.jpg,イオン幕張,6960,千葉,330,ね,2019/8/15 16:47,2-1_all_corrected,63,43,193,213,256,256
172281,30068_20190815093405.jpg,ケーヨーデイツー唐木田,***5,多摩,30,も,2019/8/15 9:33,2-1_all_corrected,55,43,414,207,469,250
173754,30085_20190815175222.jpg,業務スーパー南津守,***8,なにわ,30,つ,2019/8/15 17:51,2-1_all_corrected,74,58,254,321,328,379
172216,30072_20190815082928.jpg,関西スーパー京阪大和田１F,*762,京都,800,せ,2019/8/15 8:29,2-1_all_corrected,84,65,52,323,136,388
174316,30001_20190815182730.jpg,関西スーパー高石駅前,5769,和泉,480,け,2019/8/15 18:27,2-1_all_corrected,92,58,66,143,158,201
173557,30111_20190815173053.jpg,イオン稲毛,*201,千葉,335,さ,2019/8/15 17:30,2-1_all_corrected,70,51,330,151,400,202
174775,30144_20190815195954.jpg,イオン幕張,8358,千葉,331,と,2019/8/15 19:59,2-1_all_corrected,49,33,177,69,226,102
174781,30001_20190815200227.jpg,関西スーパー高石駅前,*310,和泉,333,る,2019/8/15 20:02,2-1_all_corrected,73,70,36,344,109,414
175208,30167_20190815211458.jpg,イオン東雲店,6990,足立,480,か,2019/8/15 21:14,2-1_all_corrected,86,68,111,327,197,395
173504,30144_20190815165804.jpg,イオン幕張,6558,千葉,580,ち,2019/8/15 16:57,2-1_all_corrected,86,63,203,325,289,388
173990,30078_20190815180547.jpg,イオンスタイル仙台卸町店,3654,仙台,380,つ,2019/8/15 18:05,2-1_all_corrected,74,55,318,158,392,213
173955,30078_20190815180323.jpg,イオンスタイル仙台卸町店,1907,仙台,580,つ,2019/8/15 18:02,2-1_all_corrected,73,53,323,167,396,220
175255,30111_20190815212201.jpg,イオン稲毛,1482,千葉,302,ね,2019/8/15 21:18,2-1_all_corrected,50,40,104,95,154,135
172559,30169_20190815113811.jpg,イオン相模原ショッピングセンター,1543,多摩,500,い,2019/8/15 11:37,2-1_all_corrected,89,77,357,310,446,387
172901,30103_20190815142041.jpg,八尾老原１丁目,***5,なにわ,30,ぬ,2019/8/15 14:20,2-1_all_corrected,73,56,237,206,310,262
172930,30144_20190815143241.jpg,イオン幕張,1004,袖ヶ浦,483,い,2019/8/15 14:32,2-1_all_corrected,85,62,375,388,460,450
172937,30144_20190815143444.jpg,イオン幕張,1007,千葉,349,に,2019/8/15 14:34,2-1_all_corrected,60,42,152,160,212,202
172339,30136_20190815095944.jpg,イオンスタイル新百合ヶ丘,8450,川崎,300,ほ,2019/8/15 9:58,2-1_all_corrected,51,38,306,130,357,168
172709,30144_20190815125128.jpg,イオン幕張,*903,千葉,534,ま,2019/8/15 12:51,2-1_all_corrected,55,40,196,123,251,163
173880,30144_20190815175850.jpg,イオン幕張,1028,千葉,586,ひ,2019/8/15 17:58,2-1_all_corrected,82,58,200,290,282,348
172738,30144_20190815130638.jpg,イオン幕張,3821,習志野,580,に,2019/8/15 13:06,2-1_all_corrected,51,47,115,197,166,244
172397,30072_20190815102010.jpg,関西スーパー京阪大和田１F,3010,京都,332,み,2019/8/15 10:19,2-1_all_corrected,82,61,39,153,121,214
172535,30111_20190815112020.jpg,イオン稲毛,5050,千葉,544,さ,2019/8/15 11:19,2-1_all_corrected,57,44,324,159,381,203
173084,30091_20190815152701.jpg,イトーヨーカドー木場 立体,4150,足立,502,の,2019/8/15 15:26,2-1_all_corrected,83,60,179,236,262,296
173626,30078_20190815174414.jpg,イオンスタイル仙台卸町店,9103,仙台,590,け,2019/8/15 17:43,2-1_all_corrected,69,55,190,130,259,185
172556,30145_20190815113356.jpg,イオン高根木戸,8000,習志野,588,ほ,2019/8/15 11:33,2-1_all_corrected,51,40,218,208,269,248
172764,30138_20190815131918.jpg,イオンスタイル湘南茅ヶ崎,2402,湘南,502,と,2019/8/15 13:18,2-1_all_corrected,58,44,206,105,264,149
174697,30110_20190815193833.jpg,イオン金沢八景,1188,横浜,540,て,2019/8/15 19:38,2-1_all_corrected,69,54,98,234,167,288
172752,30110_20190815131042.jpg,イオン金沢八景,6829,足立,502,と,2019/8/15 13:10,2-1_all_corrected,66,54,157,225,223,279
172594,30039_20190815115659.jpg,イトーヨーカドー大井町,9629,品川,480,こ,2019/8/15 11:56,2-1_all_corrected,67,65,172,229,239,294
173479,30103_20190815165412.jpg,八尾老原１丁目,***1,大阪,30,は,2019/8/15 16:53,2-1_all_corrected,101,72,408,334,509,406
174630,30144_20190815191254.jpg,イオン幕張,1173,千葉,547,て,2019/8/15 19:12,2-1_all_corrected,76,54,226,218,302,272
173243,30144_20190815163421.jpg,イオン幕張,*375,千葉,536,る,2019/8/15 16:33,2-1_all_corrected,44,31,178,81,222,112
173881,30078_20190815175850.jpg,イオンスタイル仙台卸町店,*428,仙台,583,よ,2019/8/15 17:58,2-1_all_corrected,71,56,252,119,323,175
173049,30051_20190815151312.jpg,スエヒロ館新百合ヶ丘,***7,横浜,30,の,2019/8/15 15:12,2-1_all_corrected,95,76,116,341,211,417
172362,30139_20190815100522.jpg,イオン板橋ショッピングセンター,***1,練馬,30,ね,2019/8/15 10:04,2-1_all_corrected,52,42,275,186,327,228
174637,30144_20190815191552.jpg,イオン幕張,7451,千葉,301,ぬ,2019/8/15 19:15,2-1_all_corrected,87,61,315,336,402,397
174601,30006_20190815190449.jpg,スギ薬局南千里,6786,大阪,504,せ,2019/8/15 19:04,2-1_all_corrected,108,59,259,203,367,262
173844,30144_20190815175655.jpg,イオン幕張,8933,千葉,580,そ,2019/8/15 17:56,2-1_all_corrected,78,58,332,278,410,336
173633,30078_20190815174440.jpg,イオンスタイル仙台卸町店,4659,宮城,500,ゆ,2019/8/15 17:44,2-1_all_corrected,72,55,204,131,276,186
173268,30144_20190815163612.jpg,イオン幕張,3131,習志野,301,む,2019/8/15 16:35,2-1_all_corrected,73,50,94,240,167,290
172520,30072_20190815111327.jpg,関西スーパー京阪大和田１F,6814,なにわ,800,あ,2019/8/15 11:12,2-1_all_corrected,69,58,215,183,284,241
174247,30078_20190815181821.jpg,イオンスタイル仙台卸町店,9408,仙台,500,す,2019/8/15 18:17,2-1_all_corrected,59,44,278,86,337,130
174615,30110_20190815190656.jpg,イオン金沢八景,1557,横浜,401,む,2019/8/15 19:06,2-1_all_corrected,49,43,392,92,441,135
174276,30078_20190815182215.jpg,イオンスタイル仙台卸町店,7887,仙台,332,す,2019/8/15 18:21,2-1_all_corrected,70,52,352,173,422,225
172976,30022_20190815144808.jpg,業務スーパー平野駅前,***8,大阪,30,も,2019/8/15 14:47,2-1_all_corrected,39,33,385,100,424,133
172748,30144_20190815130905.jpg,イオン幕張,6847,旭川,500,と,2019/8/15 13:08,2-1_all_corrected,74,50,255,186,329,236
173007,30110_20190815150030.jpg,イオン金沢八景,**46,横浜,341,す,2019/8/15 15:00,2-1_all_corrected,52,46,509,134,561,180
172783,30078_20190815132758.jpg,イオンスタイル仙台卸町店,1664,仙台,480,う,2019/8/15 13:27,2-1_all_corrected,78,54,208,211,286,265
174473,30169_20190815184443.jpg,イオン相模原ショッピングセンター,2560,相模,330,く,2019/8/15 18:44,2-1_all_corrected,52,41,201,252,253,293
174641,30079_20190815191647.jpg,ピットデザイン仙台卸町駅前駐車場,1933,仙台,580,ぬ,2019/8/15 19:16,2-1_all_corrected,85,74,245,364,330,438
174683,30169_20190815193243.jpg,イオン相模原ショッピングセンター,5339,多摩,71,な,2019/8/15 19:32,2-1_all_corrected,86,46,147,140,233,186
174677,30006_20190815192908.jpg,スギ薬局南千里,8931,大阪,300,ね,2019/8/15 19:28,2-1_all_corrected,115,69,176,187,291,256
174489,30001_20190815184627.jpg,関西スーパー高石駅前,3133,和泉,581,て,2019/8/15 18:46,2-1_all_corrected,98,67,126,382,224,449
174684,30132_20190815193300.jpg,イオンスタイル東神奈川,***8,横浜,30,に,2019/8/15 19:32,2-1_all_corrected,55,45,373,234,428,279
173099,30144_20190815153343.jpg,イオン幕張,2751,足立,502,に,2019/8/15 15:33,2-1_all_corrected,58,39,182,137,240,176
173409,30144_20190815165023.jpg,イオン幕張,2700,習志野,400,れ,2019/8/15 16:50,2-1_all_corrected,35,34,275,102,310,136
174270,30078_20190815182115.jpg,イオンスタイル仙台卸町店,3683,仙台,580,す,2019/8/15 18:20,2-1_all_corrected,72,57,156,136,228,193
173293,30144_20190815164045.jpg,イオン幕張,*770,千葉,301,ち,2019/8/15 16:40,2-1_all_corrected,49,36,173,81,222,117
173097,30169_20190815153236.jpg,イオン相模原ショッピングセンター,7069,相模,301,む,2019/8/15 15:32,2-1_all_corrected,52,36,172,87,224,123
175152,30169_20190815210547.jpg,イオン相模原ショッピングセンター,1015,相模,537,め,2019/8/15 21:05,2-1_all_corrected,77,71,397,261,474,332
172915,30167_20190815142607.jpg,イオン東雲店,3542,千葉,330,ち,2019/8/15 14:25,2-1_all_corrected,91,86,64,302,155,388
174018,30078_20190815180652.jpg,イオンスタイル仙台卸町店,*635,仙台,530,に,2019/8/15 18:06,2-1_all_corrected,54,45,356,108,410,153
174215,30078_20190815181714.jpg,イオンスタイル仙台卸町店,*315,仙台,550,つ,2019/8/15 18:16,2-1_all_corrected,51,62,169,83,220,145
173008,30110_20190815150035.jpg,イオン金沢八景,**46,横浜,341,す,2019/8/15 15:00,2-1_all_corrected,50,41,388,113,438,154
173039,30144_20190815150930.jpg,イオン幕張,3624,千葉,301,ふ,2019/8/15 15:09,2-1_all_corrected,72,54,86,208,158,262
172544,30144_20190815112512.jpg,イオン幕張,8855,習志野,532,の,2019/8/15 11:24,2-1_all_corrected,49,44,8,207,57,251
174163,30078_20190815181411.jpg,イオンスタイル仙台卸町店,1001,宮城,357,ら,2019/8/15 18:13,2-1_all_corrected,75,62,158,220,233,282
173517,30085_20190815170536.jpg,業務スーパー南津守,1001,なにわ,31,ね,2019/8/15 17:05,2-1_all_corrected,46,35,175,202,221,237
174394,30168_20190815183519.jpg,イオン東雲店（屋上）,***4,足立,349,ち,2019/8/15 18:34,2-1_all_corrected,77,67,459,281,536,348
172256,30157_20190815091306.jpg,関西スーパー中央,***5,神戸,30,ふ,2019/8/15 9:12,2-1_all_corrected,44,40,449,212,493,252
173189,30144_20190815162324.jpg,イオン幕張,*530,千葉,342,さ,2019/8/15 16:23,2-1_all_corrected,58,43,158,160,216,203
173129,30169_20190815155009.jpg,イオン相模原ショッピングセンター,*178,相模,535,は,2019/8/15 15:49,2-1_all_corrected,54,41,356,121,410,162
173572,30144_20190815173707.jpg,イオン幕張,5041,千葉,302,さ,2019/8/15 17:36,2-1_all_corrected,61,41,219,131,280,172
174139,30078_20190815181329.jpg,イオンスタイル仙台卸町店,3611,福島,540,の,2019/8/15 18:13,2-1_all_corrected,54,47,185,72,239,119
173111,30078_20190815154056.jpg,イオンスタイル仙台卸町店,1153,仙台,300,ろ,2019/8/15 15:40,2-1_all_corrected,92,67,180,340,272,407
175223,30078_20190815211709.jpg,イオンスタイル仙台卸町店,***1,宮城,524,り,2019/8/15 21:16,2-1_all_corrected,96,67,238,337,334,404
174795,30066_20190815200517.jpg,ジョーシン和泉中央,**33,和泉,31,さ,2019/8/15 20:04,2-1_all_corrected,73,57,192,250,265,307
173520,30111_20190815171019.jpg,イオン稲毛,1131,千葉,531,さ,2019/8/15 17:10,2-1_all_corrected,72,52,375,248,447,300
173516,30144_20190815170444.jpg,イオン幕張,7829,千葉,501,は,2019/8/15 17:04,2-1_all_corrected,84,62,293,311,377,373
172266,30060_20190815091911.jpg,関西スーパー小野原,4024,大阪,580,ほ,2019/8/15 9:18,2-1_all_corrected,79,64,323,334,402,398
173181,30144_20190815162058.jpg,イオン幕張,2728,習志野,581,そ,2019/8/15 16:20,2-1_all_corrected,38,34,290,90,328,124
174961,30103_20190815202715.jpg,八尾老原１丁目,6164,大阪,503,ね,2019/8/15 20:26,2-1_all_corrected,72,50,256,194,328,244
172210,30167_20190815081545.jpg,イオン東雲店,*220,足立,302,の,2019/8/15 8:15,2-1_all_corrected,52,39,337,131,389,170
172656,30144_20190815122429.jpg,イオン幕張,8765,千葉,583,い,2019/8/15 12:23,2-1_all_corrected,59,43,211,175,270,218
172452,30062_20190815103759.jpg,ミスミモール,8888,神戸,30,ひ,2019/8/15 10:37,2-1_all_corrected,55,45,371,142,426,187
172832,30045_20190815135923.jpg,マックスバリュー徳川明倫,***3,名古屋,31,は,2019/8/15 13:59,2-1_all_corrected,54,42,301,143,355,185
173128,30106_20190815154958.jpg,ジョーシン東大阪長田,***1,大阪,30,な,2019/8/15 15:49,2-1_all_corrected,48,38,346,95,394,133
172667,30144_20190815122827.jpg,イオン幕張,*622,千葉,338,せ,2019/8/15 12:28,2-1_all_corrected,63,46,154,188,217,234
172882,30103_20190815141428.jpg,八尾老原１丁目,8008,大阪,31,み,2019/8/15 14:13,2-1_all_corrected,47,46,171,126,218,172
174349,30111_20190815183008.jpg,イオン稲毛,2525,千葉,545,に,2019/8/15 18:29,2-1_all_corrected,56,41,339,136,395,177
172416,30068_20190815102446.jpg,ケーヨーデイツー唐木田,***3,多摩,30,は,2019/8/15 10:24,2-1_all_corrected,55,42,466,235,521,277
175257,30006_20190815212214.jpg,スギ薬局南千里,1040,大阪,583,は,2019/8/15 21:22,2-1_all_corrected,86,53,322,77,408,130
172878,30082_20190815141036.jpg,今池ビル,*358,名古屋,32,ら,2019/8/15 14:10,2-1_all_corrected,56,43,344,259,400,302
172282,30022_20190815093615.jpg,業務スーパー平野駅前,***3,なにわ,30,ぬ,2019/8/15 9:35,2-1_all_corrected,81,65,145,75,226,140
173162,30144_20190815161039.jpg,イオン幕張,8531,千葉,530,に,2019/8/15 16:10,2-1_all_corrected,93,60,379,388,472,448
172418,30060_20190815102523.jpg,関西スーパー小野原,3406,大阪,480,な,2019/8/15 10:24,2-1_all_corrected,80,63,377,340,457,403
175490,30073_20190815223531.jpg,関西スーパー京阪大和田２F,*920,なにわ,338,ほ,2019/8/15 22:34,2-1_all_corrected,74,57,280,75,354,132
174784,30169_20190815200420.jpg,イオン相模原ショッピングセンター,9693,多摩,71,ま,2019/8/15 20:03,2-1_all_corrected,62,34,334,114,396,148
172474,30001_20190815105418.jpg,関西スーパー高石駅前,5223,堺,500,と,2019/8/15 10:53,2-1_all_corrected,89,63,339,188,428,251
173904,30078_20190815180007.jpg,イオンスタイル仙台卸町店,**39,札幌,343,み,2019/8/15 17:59,2-1_all_corrected,89,66,248,233,337,299
172822,30078_20190815135055.jpg,イオンスタイル仙台卸町店,*311,八戸,530,め,2019/8/15 13:50,2-1_all_corrected,82,60,346,299,428,359
172419,30072_20190815102531.jpg,関西スーパー京阪大和田１F,9207,なにわ,480,り,2019/8/15 10:24,2-1_all_corrected,67,65,2,274,69,339
172246,30045_20190815085935.jpg,マックスバリュー徳川明倫,**22,名古屋,31,ろ,2019/8/15 8:59,2-1_all_corrected,54,43,269,162,323,205
173536,30144_20190815171947.jpg,イオン幕張,1168,千葉,300,す,2019/8/15 17:19,2-1_all_corrected,83,63,340,349,423,412
172676,30078_20190815123439.jpg,イオンスタイル仙台卸町店,5280,仙台,580,ほ,2019/8/15 12:34,2-1_all_corrected,80,51,278,185,358,236
172682,30144_20190815123959.jpg,イオン幕張,5677,習志野,330,ほ,2019/8/15 12:39,2-1_all_corrected,78,56,266,259,344,315
173139,30144_20190815155424.jpg,イオン幕張,*625,千葉,340,の,2019/8/15 15:53,2-1_all_corrected,50,39,228,103,278,142
174572,30144_20190815190018.jpg,イオン幕張,3428,千葉,581,う,2019/8/15 18:59,2-1_all_corrected,52,48,6,213,58,261
172488,30110_20190815105958.jpg,イオン金沢八景,2922,横浜,331,さ,2019/8/15 10:59,2-1_all_corrected,73,66,127,211,200,277
173902,30078_20190815180001.jpg,イオンスタイル仙台卸町店,1838,仙台,580,て,2019/8/15 17:59,2-1_all_corrected,75,55,250,167,325,222
173137,30103_20190815155344.jpg,八尾老原１丁目,**10,大阪,31,め,2019/8/15 15:53,2-1_all_corrected,68,53,227,200,295,253
174315,30001_20190815182727.jpg,関西スーパー高石駅前,2719,和泉,501,つ,2019/8/15 18:26,2-1_all_corrected,103,72,80,240,183,312
173554,30169_20190815172901.jpg,イオン相模原ショッピングセンター,4073,多摩,500,ぬ,2019/8/15 17:28,2-1_all_corrected,47,33,314,76,361,109
172486,30079_20190815105801.jpg,ピットデザイン仙台卸町駅前駐車場,7687,仙台,500,ぬ,2019/8/15 10:57,2-1_all_corrected,47,37,429,170,476,207
172815,30103_20190815134701.jpg,八尾老原１丁目,***7,大阪,30,ひ,2019/8/15 13:46,2-1_all_corrected,51,48,75,176,126,224
174267,30078_20190815182035.jpg,イオンスタイル仙台卸町店,9918,宮城,500,つ,2019/8/15 18:20,2-1_all_corrected,70,56,301,135,371,191
172531,30082_20190815111616.jpg,今池ビル,*358,名古屋,31,せ,2019/8/15 11:14,2-1_all_corrected,50,38,330,213,380,251
172703,30090_20190815124905.jpg,イトーヨーカドー木場 西棟,1881,練馬,339,せ,2019/8/15 12:48,2-1_all_corrected,89,65,400,345,489,410
174400,30167_20190815183546.jpg,イオン東雲店,***4,足立,349,ち,2019/8/15 18:35,2-1_all_corrected,78,50,163,287,241,337
172394,30144_20190815101940.jpg,イオン幕張,3199,千葉,580,み,2019/8/15 10:19,2-1_all_corrected,52,39,190,127,242,166
173080,30144_20190815152439.jpg,イオン幕張,6928,習志野,530,て,2019/8/15 15:24,2-1_all_corrected,83,58,247,318,330,376
174692,30070_20190815193656.jpg,カナートモール住道第一,***1,大阪,30,ら,2019/8/15 19:36,2-1_all_corrected,59,41,220,148,279,189
172565,30167_20190815114006.jpg,イオン東雲店,1216,品川,342,み,2019/8/15 11:39,2-1_all_corrected,92,52,105,396,197,448
172553,30144_20190815113127.jpg,イオン幕張,4038,千葉,302,す,2019/8/15 11:31,2-1_all_corrected,47,37,227,107,274,144
174465,30070_20190815184347.jpg,カナートモール住道第一,**55,大阪,31,に,2019/8/15 18:43,2-1_all_corrected,82,62,64,229,146,291
172933,30110_20190815143404.jpg,イオン金沢八景,4093,横浜,41,た,2019/8/15 14:33,2-1_all_corrected,105,90,403,275,508,365
173081,30144_20190815152505.jpg,イオン幕張,*501,習志野,338,や,2019/8/15 15:24,2-1_all_corrected,49,34,138,87,187,121
175382,30111_20190815215149.jpg,イオン稲毛,***7,習志野,354,つ,2019/8/15 21:51,2-1_all_corrected,81,60,333,233,414,293
174634,30167_20190815191459.jpg,イオン東雲店,8740,足立,580,く,2019/8/15 19:14,2-1_all_corrected,77,65,93,314,170,379
174268,30110_20190815182036.jpg,イオン金沢八景,8008,横浜,585,ら,2019/8/15 18:20,2-1_all_corrected,74,55,280,155,354,210
173072,30144_20190815152252.jpg,イオン幕張,6288,とちぎ,530,す,2019/8/15 15:22,2-1_all_corrected,92,64,294,360,386,424
174408,30144_20190815183749.jpg,イオン幕張,**24,千葉,355,ゆ,2019/8/15 18:37,2-1_all_corrected,86,61,293,307,379,368
173878,30078_20190815175845.jpg,イオンスタイル仙台卸町店,*428,仙台,583,よ,2019/8/15 17:58,2-1_all_corrected,73,55,257,169,330,224
173271,30144_20190815163637.jpg,イオン幕張,3588,習志野,334,ね,2019/8/15 16:36,2-1_all_corrected,90,61,248,365,338,426
174266,30110_20190815182032.jpg,イオン金沢八景,8381,横浜,534,は,2019/8/15 18:20,2-1_all_corrected,66,52,303,133,369,185
174656,30103_20190815192111.jpg,八尾老原１丁目,*594,大阪,580,る,2019/8/15 19:20,2-1_all_corrected,90,59,312,324,402,383
173222,30144_20190815162754.jpg,イオン幕張,2230,千葉,531,め,2019/8/15 16:27,2-1_all_corrected,60,41,248,195,308,236
172760,30111_20190815131616.jpg,イオン稲毛,6895,千葉,500,た,2019/8/15 13:15,2-1_all_corrected,39,32,41,64,80,96
172304,30157_20190815094856.jpg,関西スーパー中央,***5,神戸,30,ふ,2019/8/15 9:48,2-1_all_corrected,52,39,154,342,206,381
172756,30078_20190815131200.jpg,イオンスタイル仙台卸町店,*666,仙台,332,む,2019/8/15 13:11,2-1_all_corrected,85,63,354,306,439,369
172597,30110_20190815115951.jpg,イオン金沢八景,1929,横浜,503,ね,2019/8/15 11:59,2-1_all_corrected,59,45,296,209,355,254
172773,30144_20190815132407.jpg,イオン幕張,3223,習志野,332,さ,2019/8/15 13:23,2-1_all_corrected,46,34,153,61,199,95
174642,30050_20190815191711.jpg,スエヒロ館扇,***8,足立,300,ぬ,2019/8/15 19:16,2-1_all_corrected,78,55,88,324,166,379
174226,30078_20190815181740.jpg,イオンスタイル仙台卸町店,6611,仙台,390,み,2019/8/15 18:17,2-1_all_corrected,75,64,135,160,210,224
173236,30110_20190815163217.jpg,イオン金沢八景,3601,宇都宮,500,め,2019/8/15 16:31,2-1_all_corrected,69,53,216,232,285,285
174687,30001_20190815193554.jpg,関西スーパー高石駅前,1101,和泉,430,ち,2019/8/15 19:35,2-1_all_corrected,107,75,244,307,351,382
172548,30157_20190815112643.jpg,関西スーパー中央,*111,京都,30,ち,2019/8/15 11:26,2-1_all_corrected,55,43,221,228,276,271
172523,30138_20190815111347.jpg,イオンスタイル湘南茅ヶ崎,7000,湘南,319,つ,2019/8/15 11:13,2-1_all_corrected,74,53,211,126,285,179
172381,30072_20190815101409.jpg,関西スーパー京阪大和田１F,3707,大阪,480,ひ,2019/8/15 10:13,2-1_all_corrected,81,68,138,292,219,360
174620,30111_20190815190825.jpg,イオン稲毛,1112,千葉,544,わ,2019/8/15 19:07,2-1_all_corrected,46,37,84,96,130,133
174627,30144_20190815191145.jpg,イオン幕張,*801,湘南,340,な,2019/8/15 19:11,2-1_all_corrected,76,56,264,250,340,306
173092,30110_20190815152949.jpg,イオン金沢八景,2008,横浜,347,せ,2019/8/15 15:29,2-1_all_corrected,78,63,162,178,240,241
173059,30138_20190815151524.jpg,イオンスタイル湘南茅ヶ崎,1173,湘南,374,さ,2019/8/15 15:14,2-1_all_corrected,59,41,260,108,319,149
174286,30006_20190815182328.jpg,スギ薬局南千里,5634,大阪,581,は,2019/8/15 18:23,2-1_all_corrected,124,76,80,204,204,280
173808,30167_20190815175511.jpg,イオン東雲店,*316,足立,341,を,2019/8/15 17:54,2-1_all_corrected,42,34,288,207,330,241
174675,30014_20190815192846.jpg,フォルテ蘇我ベルク棟,***3,千葉,30,む,2019/8/15 19:28,2-1_all_corrected,65,56,163,72,228,128
172929,30052_20190815143229.jpg,西友市ヶ尾,*111,横浜,30,た,2019/8/15 14:32,2-1_all_corrected,79,62,335,265,414,327
172585,30045_20190815115310.jpg,マックスバリュー徳川明倫,2525,名古屋,31,そ,2019/8/15 11:52,2-1_all_corrected,51,42,316,162,367,204
174440,30111_20190815184032.jpg,イオン稲毛,9883,千葉,500,や,2019/8/15 18:40,2-1_all_corrected,42,32,431,81,473,113
174220,30078_20190815181720.jpg,イオンスタイル仙台卸町店,5575,仙台,500,か,2019/8/15 18:16,2-1_all_corrected,55,43,298,36,353,79
174644,30110_20190815191714.jpg,イオン金沢八景,7450,横浜,301,ろ,2019/8/15 19:16,2-1_all_corrected,53,47,495,110,548,157
172329,30168_20190815095651.jpg,イオン東雲店（屋上）,1000,滋賀,359,む,2019/8/15 9:56,2-1_all_corrected,72,56,353,107,425,163
173264,30111_20190815163559.jpg,イオン稲毛,3605,袖ヶ浦,100,さ,2019/8/15 16:35,2-1_all_corrected,54,46,252,157,306,203
172973,30078_20190815144558.jpg,イオンスタイル仙台卸町店,9744,仙台,580,こ,2019/8/15 14:45,2-1_all_corrected,98,63,262,352,360,415
173093,30144_20190815153133.jpg,イオン幕張,*279,横浜,304,の,2019/8/15 15:31,2-1_all_corrected,56,43,166,147,222,190
173067,30144_20190815151836.jpg,イオン幕張,3110,千葉,544,ほ,2019/8/15 15:18,2-1_all_corrected,46,36,165,59,211,95
174621,30078_20190815190908.jpg,イオンスタイル仙台卸町店,***3,宮城,580,の,2019/8/15 19:08,2-1_all_corrected,78,55,199,201,277,256
173299,30144_20190815164209.jpg,イオン幕張,6782,千葉,502,は,2019/8/15 16:41,2-1_all_corrected,46,45,129,152,175,197
174798,30144_20190815200556.jpg,イオン幕張,2525,千葉,320,さ,2019/8/15 20:05,2-1_all_corrected,79,56,244,236,323,292
173549,30103_20190815172519.jpg,八尾老原１丁目,**55,大阪,31,も,2019/8/15 17:24,2-1_all_corrected,51,36,348,88,399,124
175211,30006_20190815211537.jpg,スギ薬局南千里,3744,なにわ,880,あ,2019/8/15 21:15,2-1_all_corrected,85,46,431,0,516,46
173916,30072_20190815180037.jpg,関西スーパー京阪大和田１F,8808,大阪,430,ね,2019/8/15 18:00,2-1_all_corrected,66,55,295,111,361,166
172801,30078_20190815133801.jpg,イオンスタイル仙台卸町店,1982,仙台,330,と,2019/8/15 13:37,2-1_all_corrected,57,46,320,120,377,166
172230,30072_20190815084510.jpg,関西スーパー京阪大和田１F,***7,大阪,30,ち,2019/8/15 8:44,2-1_all_corrected,44,34,365,163,409,197
174301,30110_20190815182550.jpg,イオン金沢八景,8888,浜松,353,は,2019/8/15 18:25,2-1_all_corrected,54,44,405,93,459,137
174765,30078_20190815195630.jpg,イオンスタイル仙台卸町店,3122,千葉,581,く,2019/8/15 19:55,2-1_all_corrected,78,50,189,159,267,209
173170,30167_20190815161305.jpg,イオン東雲店,*673,春日部,880,り,2019/8/15 16:12,2-1_all_corrected,45,39,245,161,290,200
173177,30045_20190815161725.jpg,マックスバリュー徳川明倫,**17,名古屋,31,り,2019/8/15 16:16,2-1_all_corrected,49,39,412,106,461,145
174963,30167_20190815202758.jpg,イオン東雲店,8888,足立,383,て,2019/8/15 20:27,2-1_all_corrected,54,39,361,283,415,322
174364,30110_20190815183106.jpg,イオン金沢八景,6104,横浜,301,と,2019/8/15 18:30,2-1_all_corrected,58,45,380,73,438,118
172403,30072_20190815102152.jpg,関西スーパー京阪大和田１F,4670,大阪,580,ね,2019/8/15 10:21,2-1_all_corrected,71,54,29,144,100,198
172255,30066_20190815091228.jpg,ジョーシン和泉中央,**33,和泉,31,さ,2019/8/15 9:11,2-1_all_corrected,75,61,134,236,209,297
174397,30111_20190815183530.jpg,イオン稲毛,6667,千葉,301,れ,2019/8/15 18:35,2-1_all_corrected,49,37,135,99,184,136
174707,30169_20190815194051.jpg,イオン相模原ショッピングセンター,1186,宇都宮,330,め,2019/8/15 19:40,2-1_all_corrected,80,70,423,297,503,367
172800,30144_20190815133543.jpg,イオン幕張,2000,千葉,514,た,2019/8/15 13:35,2-1_all_corrected,87,61,450,339,537,400
173125,30144_20190815154915.jpg,イオン幕張,1592,習志野,580,わ,2019/8/15 15:48,2-1_all_corrected,60,40,150,165,210,205
173541,30133_20190815172311.jpg,イトーヨーカドー食品館厚木第1,8008,相模,338,ね,2019/8/15 17:22,2-1_all_corrected,76,57,190,156,266,213
174797,30144_20190815200545.jpg,イオン幕張,8596,習志野,501,も,2019/8/15 20:05,2-1_all_corrected,79,56,244,286,323,342
173546,30103_20190815172437.jpg,八尾老原１丁目,**11,大阪,31,そ,2019/8/15 17:24,2-1_all_corrected,73,64,130,196,203,260
172664,30110_20190815122700.jpg,イオン金沢八景,6000,横浜,333,せ,2019/8/15 12:26,2-1_all_corrected,45,46,501,108,546,154
172809,30014_20190815134345.jpg,フォルテ蘇我ベルク棟,***1,千葉,30,も,2019/8/15 13:43,2-1_all_corrected,51,76,109,122,160,198
173523,30111_20190815171137.jpg,イオン稲毛,1221,千葉,353,そ,2019/8/15 17:11,2-1_all_corrected,66,55,265,192,331,247
174391,30105_20190815183443.jpg,カスミフードスクエア春日部武里,*331,春日部,586,さ,2019/8/15 18:34,2-1_all_corrected,65,64,34,297,99,361
173524,30169_20190815171156.jpg,イオン相模原ショッピングセンター,7312,相模,330,て,2019/8/15 17:11,2-1_all_corrected,55,48,117,256,172,304
172262,30072_20190815091653.jpg,関西スーパー京阪大和田１F,***7,大阪,30,ち,2019/8/15 9:16,2-1_all_corrected,68,52,368,101,436,153
174161,30078_20190815181406.jpg,イオンスタイル仙台卸町店,1127,仙台,332,ゆ,2019/8/15 18:13,2-1_all_corrected,69,53,387,165,456,218
174398,30168_20190815183530.jpg,イオン東雲店（屋上）,***4,足立,349,ち,2019/8/15 18:34,2-1_all_corrected,72,59,392,236,464,295
173171,30039_20190815161348.jpg,イトーヨーカドー大井町,*116,横浜,533,ろ,2019/8/15 16:13,2-1_all_corrected,69,58,227,140,296,198
174502,30144_20190815184850.jpg,イオン幕張,9639,千葉,502,た,2019/8/15 18:48,2-1_all_corrected,81,57,238,321,319,378
175040,30111_20190815203957.jpg,イオン稲毛,7880,千葉,330,ほ,2019/8/15 20:39,2-1_all_corrected,51,41,164,103,215,144
167955,30169_20190812185357.jpg,イオン相模原ショッピングセンター,1125,相模,532,て,2019/8/12 18:53,2-1_all_corrected,93,73,363,355,456,428
167160,30060_20190812142316.jpg,関西スーパー小野原,9999,大阪,31,り,2019/8/12 14:22,2-1_all_corrected,75,65,125,236,200,301
167399,30144_20190812155655.jpg,イオン幕張,6988,千葉,302,さ,2019/8/12 15:56,2-1_all_corrected,53,39,210,116,263,155
166845,30110_20190812120006.jpg,イオン金沢八景,9777,横浜,581,あ,2019/8/12 11:59,2-1_all_corrected,67,56,233,250,300,306
167997,30110_20190812191636.jpg,イオン金沢八景,*703,横浜,359,の,2019/8/12 19:16,2-1_all_corrected,51,43,342,85,393,128
167503,30072_20190812162840.jpg,関西スーパー京阪大和田１F,3411,大阪,330,て,2019/8/12 16:28,2-1_all_corrected,80,62,50,209,130,271
167167,30078_20190812142521.jpg,イオンスタイル仙台卸町店,9811,宮,58,る,2019/8/12 14:24,2-1_all_corrected,64,41,270,183,334,224
167937,30090_20190812184557.jpg,イトーヨーカドー木場 西棟,1887,足立,330,ね,2019/8/12 18:45,2-1_all_corrected,57,43,323,173,380,216
167908,30144_20190812183457.jpg,イオン幕張,1010,千葉,561,せ,2019/8/12 18:34,2-1_all_corrected,80,54,326,248,406,302
167550,30167_20190812164033.jpg,イオン東雲店,9625,袖ヶ浦,583,う,2019/8/12 16:39,2-1_all_corrected,93,58,133,392,226,450
167762,30144_20190812174139.jpg,イオン幕張,***1,千葉,353,み,2019/8/12 17:41,2-1_all_corrected,53,35,177,122,230,157
167796,30144_20190812175445.jpg,イオン幕張,1309,千葉,502,な,2019/8/12 17:54,2-1_all_corrected,44,30,175,68,219,98
166644,30072_20190812104054.jpg,関西スーパー京阪大和田１F,4010,大阪,530,と,2019/8/12 10:39,2-1_all_corrected,86,75,19,299,105,374
168175,30169_20190812203352.jpg,イオン相模原ショッピングセンター,8545,相模,301,め,2019/8/12 20:33,2-1_all_corrected,83,72,476,343,559,415
166818,30078_20190812114359.jpg,イオンスタイル仙台卸町店,*108,仙台,583,え,2019/8/12 11:43,2-1_all_corrected,82,55,228,208,310,263
167798,30078_20190812175640.jpg,イオンスタイル仙台卸町店,7833,仙台,300,ち,2019/8/12 17:56,2-1_all_corrected,48,46,156,19,204,65
168172,30039_20190812203244.jpg,イトーヨーカドー大井町,7854,足立,300,わ,2019/8/12 20:32,2-1_all_corrected,72,63,161,108,233,171
167105,30167_20190812140126.jpg,イオン東雲店,2721,湘南,502,ふ,2019/8/12 14:00,2-1_all_corrected,87,68,20,345,107,413
167939,30103_20190812184609.jpg,八尾老原１丁目,**55,大阪,31,ち,2019/8/12 18:45,2-1_all_corrected,92,61,313,313,405,374
167965,30045_20190812185838.jpg,マックスバリュー徳川明倫,1010,名古屋,31,ゆ,2019/8/12 18:58,2-1_all_corrected,82,67,115,239,197,306
166843,30110_20190812115859.jpg,イオン金沢八景,1950,横浜,336,り,2019/8/12 11:58,2-1_all_corrected,51,40,352,107,403,147
167737,30144_20190812173303.jpg,イオン幕張,8181,千葉,341,の,2019/8/12 17:32,2-1_all_corrected,48,36,203,105,251,141
167996,30091_20190812191554.jpg,イトーヨーカドー木場 立体,**34,足立,340,め,2019/8/12 19:15,2-1_all_corrected,79,61,388,151,467,212
166618,30111_20190812103103.jpg,イオン稲毛,**78,千葉,336,も,2019/8/12 10:30,2-1_all_corrected,65,58,255,193,320,251
167150,30100_20190812142041.jpg,JBM長崎三芳町,***3,横浜,30,せ,2019/8/12 14:20,2-1_all_corrected,83,62,86,342,169,404
167953,30091_20190812185331.jpg,イトーヨーカドー木場 立体,**11,足立,394,や,2019/8/12 18:52,2-1_all_corrected,68,65,93,271,161,336
166479,30045_20190812085230.jpg,マックスバリュー徳川明倫,*358,名古屋,32,ひ,2019/8/12 8:52,2-1_all_corrected,55,46,170,228,225,274
166674,30001_20190812105315.jpg,関西スーパー高石駅前,3808,堺,500,ね,2019/8/12 10:52,2-1_all_corrected,69,55,222,158,291,213
167331,30110_20190812153631.jpg,イオン金沢八景,3919,横浜,530,ほ,2019/8/12 15:36,2-1_all_corrected,73,57,243,175,316,232
168142,30006_20190812201719.jpg,スギ薬局南千里,3998,岡崎,400,す,2019/8/12 20:17,2-1_all_corrected,94,55,409,42,503,97
166645,30072_20190812104100.jpg,関西スーパー京阪大和田１F,4010,大阪,530,と,2019/8/12 10:40,2-1_all_corrected,71,55,29,159,100,214
168189,30078_20190812204730.jpg,イオンスタイル仙台卸町店,8008,宮城,353,る,2019/8/12 20:47,2-1_all_corrected,88,61,386,359,474,420
166689,30111_20190812105708.jpg,イオン稲毛,6491,千葉,501,わ,2019/8/12 10:56,2-1_all_corrected,58,45,369,134,427,179
167888,30078_20190812182816.jpg,イオンスタイル仙台卸町店,5963,大宮,541,て,2019/8/12 18:27,2-1_all_corrected,98,55,217,394,315,449
167423,30106_20190812160321.jpg,ジョーシン東大阪長田,**77,大阪,31,せ,2019/8/12 16:02,2-1_all_corrected,78,57,454,286,532,343
167047,30060_20190812133425.jpg,関西スーパー小野原,*725,大阪,483,き,2019/8/12 13:34,2-1_all_corrected,70,56,188,286,258,342
166962,30144_20190812125149.jpg,イオン幕張,1225,千葉,545,さ,2019/8/12 12:51,2-1_all_corrected,55,43,147,121,202,164
167243,30144_20190812145624.jpg,イオン幕張,2128,千葉,302,と,2019/8/12 14:55,2-1_all_corrected,44,34,184,71,228,105
167872,30078_20190812182510.jpg,イオンスタイル仙台卸町店,1219,福島,339,ま,2019/8/12 18:24,2-1_all_corrected,90,63,382,320,472,383
166706,30072_20190812110020.jpg,関西スーパー京阪大和田１F,7719,大阪,330,に,2019/8/12 10:59,2-1_all_corrected,87,75,513,260,600,335
166560,30167_20190812100031.jpg,イオン東雲店,*320,品川,535,り,2019/8/12 9:59,2-1_all_corrected,92,55,108,393,200,448
167446,30167_20190812161207.jpg,イオン東雲店,7952,足立,302,そ,2019/8/12 16:11,2-1_all_corrected,77,59,217,222,294,281
168258,30167_20190812215714.jpg,イオン東雲店,1188,足立,387,と,2019/8/12 21:56,2-1_all_corrected,57,44,408,304,465,348
168052,30068_20190812193643.jpg,ケーヨーデイツー唐木田,*522,多摩,580,る,2019/8/12 19:35,2-1_all_corrected,68,56,287,300,355,356
168294,30079_20190812225258.jpg,ピットデザイン仙台卸町駅前駐車場,1188,仙台,583,ぬ,2019/8/12 22:52,2-1_all_corrected,79,62,304,329,383,391
166593,30167_20190812101924.jpg,イオン東雲店,5213,富山,300,に,2019/8/12 10:18,2-1_all_corrected,83,73,77,242,160,315
168256,30169_20190812215542.jpg,イオン相模原ショッピングセンター,8008,相模,549,と,2019/8/12 21:55,2-1_all_corrected,69,68,493,292,562,360
167013,30167_20190812131735.jpg,イオン東雲店,4519,足立,481,り,2019/8/12 13:16,2-1_all_corrected,70,59,254,223,324,282
167621,30144_20190812165617.jpg,イオン幕張,9211,千葉,583,い,2019/8/12 16:55,2-1_all_corrected,45,31,176,76,221,107
166707,30072_20190812110031.jpg,関西スーパー京阪大和田１F,7719,大阪,330,に,2019/8/12 11:00,2-1_all_corrected,52,38,155,59,207,97
167084,30110_20190812135144.jpg,イオン金沢八景,9185,横浜,480,け,2019/8/12 13:51,2-1_all_corrected,81,62,364,271,445,333
168007,30052_20190812191927.jpg,西友市ヶ尾,**93,横浜,480,る,2019/8/12 19:18,2-1_all_corrected,65,55,163,295,228,350
168235,30098_20190812213045.jpg,BRANCH仙台（東棟）,1111,仙台,312,さ,2019/8/12 21:30,2-1_all_corrected,102,70,267,345,369,415
167422,30111_20190812160315.jpg,イオン稲毛,2525,千葉,382,る,2019/8/12 16:02,2-1_all_corrected,69,53,327,155,396,208
167845,30110_20190812181745.jpg,イオン金沢八景,*703,横浜,346,む,2019/8/12 18:17,2-1_all_corrected,73,57,459,100,532,157
168204,30110_20190812205903.jpg,イオン金沢八景,7450,横浜,301,ろ,2019/8/12 20:58,2-1_all_corrected,77,64,133,210,210,274
167015,30072_20190812131901.jpg,関西スーパー京阪大和田１F,1964,大阪,332,ひ,2019/8/12 13:18,2-1_all_corrected,48,34,145,128,193,162
167811,30144_20190812180344.jpg,イオン幕張,***1,千葉,30,も,2019/8/12 18:03,2-1_all_corrected,58,43,184,213,242,256
167482,30052_20190812162308.jpg,西友市ヶ尾,2525,横浜,31,の,2019/8/12 16:22,2-1_all_corrected,47,31,416,172,463,203
167644,30086_20190812170237.jpg,テックランド大阪りんくう,***1,和泉,30,さ,2019/8/12 17:02,2-1_all_corrected,51,36,279,185,330,221
168268,30156_20190812220645.jpg,万代 西神中央店,6810,神戸,301,ら,2019/8/12 22:06,2-1_all_corrected,56,41,278,214,334,255
167827,30091_20190812181149.jpg,イトーヨーカドー木場 立体,2044,足立,301,る,2019/8/12 18:11,2-1_all_corrected,42,37,368,109,410,146
167818,30144_20190812180811.jpg,イオン幕張,3215,千葉,583,さ,2019/8/12 18:07,2-1_all_corrected,50,35,139,98,189,133
167820,30078_20190812180927.jpg,イオンスタイル仙台卸町店,2827,仙台,380,す,2019/8/12 18:09,2-1_all_corrected,54,45,179,62,233,107
168054,30111_20190812193649.jpg,イオン稲毛,6710,千葉,583,う,2019/8/12 19:36,2-1_all_corrected,55,42,151,148,206,190
166561,30072_20190812100052.jpg,関西スーパー京阪大和田１F,8000,大阪,30,す,2019/8/12 10:00,2-1_all_corrected,84,65,16,158,100,223
166924,30111_20190812123737.jpg,イオン稲毛,*924,千葉,533,ね,2019/8/12 12:37,2-1_all_corrected,68,52,321,159,389,211
166544,30072_20190812095232.jpg,関西スーパー京阪大和田１F,8000,大阪,30,す,2019/8/12 9:52,2-1_all_corrected,69,58,302,239,371,297
167039,30144_20190812133020.jpg,イオン幕張,1104,習志野,534,な,2019/8/12 13:29,2-1_all_corrected,76,55,288,246,364,301
166572,30072_20190812100647.jpg,関西スーパー京阪大和田１F,7750,大阪,330,る,2019/8/12 10:06,2-1_all_corrected,80,73,64,232,144,305
167202,30167_20190812143806.jpg,イオン東雲店,9100,足立,580,え,2019/8/12 14:37,2-1_all_corrected,38,35,11,55,49,90
167833,30078_20190812181406.jpg,イオンスタイル仙台卸町店,***8,仙台,585,あ,2019/8/12 18:13,2-1_all_corrected,68,56,143,153,211,209
166946,30078_20190812124559.jpg,イオンスタイル仙台卸町店,***1,仙台,335,な,2019/8/12 12:45,2-1_all_corrected,86,57,230,231,316,288
167867,30072_20190812182305.jpg,関西スーパー京阪大和田１F,8000,大阪,30,す,2019/8/12 18:22,2-1_all_corrected,73,59,60,134,133,193
167856,30078_20190812182056.jpg,イオンスタイル仙台卸町店,4870,仙台,580,け,2019/8/12 18:20,2-1_all_corrected,57,44,298,103,355,147
167431,30091_20190812160632.jpg,イトーヨーカドー木場 立体,1213,足立,343,ま,2019/8/12 16:05,2-1_all_corrected,51,45,279,62,330,107
166574,30144_20190812100909.jpg,イオン幕張,***8,袖ヶ浦,351,ま,2019/8/12 10:08,2-1_all_corrected,58,41,249,152,307,193
167452,30111_20190812161506.jpg,イオン稲毛,2020,千葉,536,ほ,2019/8/12 16:14,2-1_all_corrected,56,45,323,159,379,204
167203,30167_20190812143850.jpg,イオン東雲店,9100,足立,580,え,2019/8/12 14:38,2-1_all_corrected,70,59,124,255,194,314
166573,30062_20190812100741.jpg,ミスミモール,**18,神戸,31,ふ,2019/8/12 10:07,2-1_all_corrected,77,61,187,224,264,285
167490,30169_20190812162610.jpg,イオン相模原ショッピングセンター,4570,相模,530,さ,2019/8/12 16:25,2-1_all_corrected,86,69,224,125,310,194
167656,30144_20190812170502.jpg,イオン幕張,**55,千葉,371,と,2019/8/12 17:04,2-1_all_corrected,74,55,407,310,481,365
166529,30001_20190812094023.jpg,関西スーパー高石駅前,9281,姫路,501,の,2019/8/12 9:40,2-1_all_corrected,80,58,462,117,542,175
167408,30091_20190812155923.jpg,イトーヨーカドー木場 立体,*781,品川,430,そ,2019/8/12 15:58,2-1_all_corrected,51,41,374,129,425,170
166473,30073_20190812084527.jpg,関西スーパー京阪大和田２F,*762,京都,800,せ,2019/8/12 8:44,2-1_all_corrected,42,36,340,110,382,146
167866,30144_20190812182255.jpg,イオン幕張,*992,高崎,580,か,2019/8/12 18:22,2-1_all_corrected,37,44,0,239,37,283
168012,30110_20190812192207.jpg,イオン金沢八景,**21,横浜,379,る,2019/8/12 19:21,2-1_all_corrected,52,40,400,106,452,146
167892,30169_20190812183010.jpg,イオン相模原ショッピングセンター,7036,多摩,301,む,2019/8/12 18:29,2-1_all_corrected,54,41,110,75,164,116
167859,30144_20190812182122.jpg,イオン幕張,5300,千葉,331,の,2019/8/12 18:20,2-1_all_corrected,54,46,51,207,105,253
167091,30169_20190812135447.jpg,イオン相模原ショッピングセンター,7943,八王子,501,ほ,2019/8/12 13:54,2-1_all_corrected,82,60,363,205,445,265
167895,30122_20190812183101.jpg,イオン長浦（第４）,1326,袖ヶ浦,300,ろ,2019/8/12 18:30,2-1_all_corrected,70,56,98,43,168,99
167439,30138_20190812160836.jpg,イオンスタイル湘南茅ヶ崎,2402,湘南,502,と,2019/8/12 16:07,2-1_all_corrected,58,44,255,115,313,159
167406,30110_20190812155831.jpg,イオン金沢八景,1892,横浜,503,ひ,2019/8/12 15:58,2-1_all_corrected,68,54,316,132,384,186
168194,30091_20190812204947.jpg,イトーヨーカドー木場 立体,***8,練馬,300,そ,2019/8/12 20:49,2-1_all_corrected,58,44,231,177,289,221
168160,30110_20190812202607.jpg,イオン金沢八景,1006,横浜,543,な,2019/8/12 20:25,2-1_all_corrected,52,48,506,140,558,188
167783,30072_20190812175123.jpg,関西スーパー京阪大和田１F,8000,大阪,30,す,2019/8/12 17:51,2-1_all_corrected,54,39,346,215,400,254
167922,30078_20190812184129.jpg,イオンスタイル仙台卸町店,9622,仙台,501,そ,2019/8/12 18:41,2-1_all_corrected,87,66,206,288,293,354
167126,30072_20190812140832.jpg,関西スーパー京阪大和田１F,*283,大阪,583,も,2019/8/12 14:07,2-1_all_corrected,54,42,246,175,300,217
166857,30144_20190812120742.jpg,イオン幕張,1221,習志野,343,は,2019/8/12 12:07,2-1_all_corrected,62,44,196,178,258,222
167516,30144_20190812163247.jpg,イオン幕張,8702,千葉,530,さ,2019/8/12 16:32,2-1_all_corrected,90,65,413,381,503,446
167949,30066_20190812185227.jpg,ジョーシン和泉中央,***5,和泉,30,ろ,2019/8/12 18:51,2-1_all_corrected,56,44,218,182,274,226
167143,30144_20190812141600.jpg,イオン幕張,5614,千葉,302,ち,2019/8/12 14:15,2-1_all_corrected,52,35,185,76,237,111
167382,30060_20190812155243.jpg,関西スーパー小野原,3406,大阪,480,な,2019/8/12 15:52,2-1_all_corrected,78,65,482,364,560,429
166668,30072_20190812105134.jpg,関西スーパー京阪大和田１F,9900,大阪,580,ふ,2019/8/12 10:51,2-1_all_corrected,76,62,27,247,103,309
167312,30072_20190812152730.jpg,関西スーパー京阪大和田１F,6233,大阪,530,に,2019/8/12 15:26,2-1_all_corrected,68,49,148,148,216,197
167776,30144_20190812174809.jpg,イオン幕張,1452,千葉,330,ぬ,2019/8/12 17:47,2-1_all_corrected,61,42,162,229,223,271
166692,30144_20190812105819.jpg,イオン幕張,2209,千葉,301,せ,2019/8/12 10:57,2-1_all_corrected,86,57,208,299,294,356
167575,30078_20190812164649.jpg,イオンスタイル仙台卸町店,9999,山形,335,ゆ,2019/8/12 16:46,2-1_all_corrected,87,65,452,344,539,409
166695,30072_20190812105913.jpg,関西スーパー京阪大和田１F,*675,大阪,503,な,2019/8/12 10:58,2-1_all_corrected,56,44,126,136,182,180
166635,30072_20190812103522.jpg,関西スーパー京阪大和田１F,1386,大阪,581,ふ,2019/8/12 10:34,2-1_all_corrected,46,31,402,58,448,89
167977,30110_20190812190357.jpg,イオン金沢八景,2828,横浜,539,の,2019/8/12 19:03,2-1_all_corrected,55,45,370,160,425,205
167983,30111_20190812191017.jpg,イオン稲毛,*929,堺,131,ち,2019/8/12 19:09,2-1_all_corrected,44,33,65,85,109,118
166604,30072_20190812102606.jpg,関西スーパー京阪大和田１F,1737,大阪,530,む,2019/8/12 10:25,2-1_all_corrected,79,61,33,224,112,285
167984,30072_20190812191112.jpg,関西スーパー京阪大和田１F,8877,大阪,333,ゆ,2019/8/12 19:10,2-1_all_corrected,94,75,126,224,220,299
168140,30006_20190812201646.jpg,スギ薬局南千里,3998,岡崎,400,す,2019/8/12 20:16,2-1_all_corrected,117,63,255,182,372,245
167934,30167_20190812184430.jpg,イオン東雲店,5966,横浜,301,む,2019/8/12 18:43,2-1_all_corrected,103,75,121,354,224,429
166647,30072_20190812104239.jpg,関西スーパー京阪大和田１F,1138,大阪,331,て,2019/8/12 10:42,2-1_all_corrected,51,40,91,111,142,151
167139,30169_20190812141437.jpg,イオン相模原ショッピングセンター,9968,多摩,301,ひ,2019/8/12 14:14,2-1_all_corrected,91,72,304,125,395,197
167750,30110_20190812173808.jpg,イオン金沢八景,3768,横浜,580,よ,2019/8/12 17:37,2-1_all_corrected,54,45,224,153,278,198
166685,30103_20190812105612.jpg,八尾老原１丁目,***5,なにわ,30,ぬ,2019/8/12 10:55,2-1_all_corrected,73,56,292,208,365,264
167333,30144_20190812153648.jpg,イオン幕張,4695,千葉,301,み,2019/8/12 15:36,2-1_all_corrected,56,40,155,134,211,174
166622,30101_20190812103148.jpg,にしてつストアレガネット姪浜,**55,福岡,31,ね,2019/8/12 10:31,2-1_all_corrected,57,43,400,219,457,262
166877,30091_20190812121939.jpg,イトーヨーカドー木場 立体,6052,足立,330,を,2019/8/12 12:18,2-1_all_corrected,78,65,3,385,81,450
166883,30168_20190812122042.jpg,イオン東雲店（屋上）,2525,長岡,130,つ,2019/8/12 12:20,2-1_all_corrected,72,62,353,141,425,203
167190,30006_20190812143310.jpg,スギ薬局南千里,2746,大阪,503,み,2019/8/12 14:33,2-1_all_corrected,97,60,294,88,391,148
167960,30060_20190812185540.jpg,関西スーパー小野原,1888,大阪,880,り,2019/8/12 18:55,2-1_all_corrected,72,66,322,332,394,398
167903,30157_20190812183258.jpg,関西スーパー中央,**55,神戸,31,め,2019/8/12 18:32,2-1_all_corrected,49,42,66,406,115,448
167564,30090_20190812164505.jpg,イトーヨーカドー木場 西棟,1127,足立,338,さ,2019/8/12 16:44,2-1_all_corrected,57,45,218,201,275,246
167751,30072_20190812173834.jpg,関西スーパー京阪大和田１F,6925,大阪,503,み,2019/8/12 17:38,2-1_all_corrected,73,52,207,102,280,154
166474,30072_20190812084546.jpg,関西スーパー京阪大和田１F,*762,京都,800,せ,2019/8/12 8:45,2-1_all_corrected,87,62,310,302,397,364
167501,30144_20190812162826.jpg,イオン幕張,1115,千葉,348,そ,2019/8/12 16:28,2-1_all_corrected,58,41,239,144,297,185
167733,30136_20190812173035.jpg,イオンスタイル新百合ヶ丘,1219,川崎,334,ら,2019/8/12 17:29,2-1_all_corrected,54,47,247,202,301,249
167357,30111_20190812154413.jpg,イオン稲毛,1352,千葉,500,て,2019/8/12 15:43,2-1_all_corrected,41,31,33,85,74,116
166615,30072_20190812102915.jpg,関西スーパー京阪大和田１F,2200,大阪,583,は,2019/8/12 10:28,2-1_all_corrected,56,44,183,206,239,250
167537,30144_20190812163722.jpg,イオン幕張,*111,千葉,364,や,2019/8/12 16:36,2-1_all_corrected,74,47,259,240,333,287
167198,30144_20190812143638.jpg,イオン幕張,1305,習志野,583,え,2019/8/12 14:36,2-1_all_corrected,74,49,229,260,303,309
167392,30144_20190812155459.jpg,イオン幕張,*666,千葉,580,の,2019/8/12 15:54,2-1_all_corrected,56,41,170,149,226,190
167702,30169_20190812172014.jpg,イオン相模原ショッピングセンター,*722,相模,534,む,2019/8/12 17:19,2-1_all_corrected,51,44,432,16,483,60
167154,30110_20190812142200.jpg,イオン金沢八景,*123,横浜,535,ち,2019/8/12 14:21,2-1_all_corrected,69,54,326,113,395,167
167825,30078_20190812181108.jpg,イオンスタイル仙台卸町店,*324,福島,331,ね,2019/8/12 18:10,2-1_all_corrected,40,41,179,4,219,45
168069,30144_20190812194306.jpg,イオン幕張,3082,習志野,540,に,2019/8/12 19:42,2-1_all_corrected,41,37,173,128,214,165
168060,30111_20190812193752.jpg,イオン稲毛,1026,宮城,336,ね,2019/8/12 19:37,2-1_all_corrected,56,42,164,141,220,183
167081,30144_20190812135016.jpg,イオン幕張,8585,千葉,530,め,2019/8/12 13:49,2-1_all_corrected,77,52,128,212,205,264
167623,30110_20190812165826.jpg,イオン金沢八景,4448,横浜,580,の,2019/8/12 16:57,2-1_all_corrected,79,54,48,394,127,448
167075,30006_20190812134726.jpg,スギ薬局南千里,*501,大阪,538,つ,2019/8/12 13:47,2-1_all_corrected,104,64,254,106,358,170
166968,30091_20190812125429.jpg,イトーヨーカドー木場 立体,**77,練馬,327,き,2019/8/12 12:54,2-1_all_corrected,72,69,4,364,76,433
168005,30072_20190812191914.jpg,関西スーパー京阪大和田１F,*123,大阪,308,そ,2019/8/12 19:18,2-1_all_corrected,73,57,7,132,80,189
167678,30060_20190812171352.jpg,関西スーパー小野原,1324,大阪,330,の,2019/8/12 17:13,2-1_all_corrected,69,56,269,180,338,236
167029,30144_20190812132449.jpg,イオン幕張,3905,習志野,501,の,2019/8/12 13:24,2-1_all_corrected,81,61,334,329,415,390
167016,30169_20190812131906.jpg,イオン相模原ショッピングセンター,1001,相模,549,る,2019/8/12 13:18,2-1_all_corrected,79,62,254,108,333,170
167444,30157_20190812161203.jpg,関西スーパー中央,***7,神戸,30,や,2019/8/12 16:11,2-1_all_corrected,55,40,137,292,192,332
167824,30111_20190812181031.jpg,イオン稲毛,7562,千葉,550,む,2019/8/12 18:10,2-1_all_corrected,43,34,49,82,92,116
167685,30111_20190812171622.jpg,イオン稲毛,3605,袖ヶ浦,100,さ,2019/8/12 17:15,2-1_all_corrected,54,45,288,161,342,206
166591,30062_20190812101832.jpg,ミスミモール,***3,神戸,30,ほ,2019/8/12 10:18,2-1_all_corrected,66,69,8,177,74,246
167671,30072_20190812171037.jpg,関西スーパー京阪大和田１F,3318,大阪,483,う,2019/8/12 17:10,2-1_all_corrected,45,32,157,78,202,110
167087,30001_20190812135226.jpg,関西スーパー高石駅前,2002,大阪,354,ま,2019/8/12 13:52,2-1_all_corrected,72,53,465,69,537,122
167417,30110_20190812160222.jpg,イオン金沢八景,1128,横浜,364,ゆ,2019/8/12 16:01,2-1_all_corrected,69,56,316,116,385,172
167428,30144_20190812160446.jpg,イオン幕張,9385,熊本,330,せ,2019/8/12 16:04,2-1_all_corrected,52,35,153,91,205,126
168236,30091_20190812213132.jpg,イトーヨーカドー木場 立体,3339,杉並,500,さ,2019/8/12 21:31,2-1_all_corrected,80,54,206,249,286,303
167622,30110_20190812165800.jpg,イオン金沢八景,7143,相模,530,ち,2019/8/12 16:57,2-1_all_corrected,53,42,428,80,481,122
167074,30144_20190812134644.jpg,イオン幕張,6377,千葉,500,に,2019/8/12 13:46,2-1_all_corrected,86,59,231,296,317,355
166704,30167_20190812110012.jpg,イオン東雲店,2015,足立,530,り,2019/8/12 10:59,2-1_all_corrected,85,67,145,287,230,354
167877,30066_20190812182647.jpg,ジョーシン和泉中央,*111,なにわ,30,る,2019/8/12 18:26,2-1_all_corrected,75,61,173,261,248,322
168207,30169_20190812210256.jpg,イオン相模原ショッピングセンター,*711,横浜,335,て,2019/8/12 21:02,2-1_all_corrected,49,35,353,84,402,119
167879,30091_20190812182657.jpg,イトーヨーカドー木場 立体,2600,足立,331,ふ,2019/8/12 18:26,2-1_all_corrected,77,61,51,277,128,338
167890,30169_20190812182918.jpg,イオン相模原ショッピングセンター,***3,八王子,361,ち,2019/8/12 18:28,2-1_all_corrected,53,43,154,228,207,271
168017,30091_20190812192309.jpg,イトーヨーカドー木場 立体,1569,足立,530,ち,2019/8/12 19:22,2-1_all_corrected,56,45,311,67,367,112
167290,30167_20190812151755.jpg,イオン東雲店,*529,足立,332,の,2019/8/12 15:17,2-1_all_corrected,38,29,31,0,69,29
166974,30039_20190812130019.jpg,イトーヨーカドー大井町,2212,神戸,333,そ,2019/8/12 12:59,2-1_all_corrected,78,62,194,150,272,212
167839,30078_20190812181529.jpg,イオンスタイル仙台卸町店,7196,仙台,580,ふ,2019/8/12 18:14,2-1_all_corrected,62,44,232,126,294,170
168086,30072_20190812194849.jpg,関西スーパー京阪大和田１F,**83,大阪,583,を,2019/8/12 19:48,2-1_all_corrected,80,62,157,177,237,239
167806,30045_20190812180140.jpg,マックスバリュー徳川明倫,**17,名古屋,31,り,2019/8/12 18:01,2-1_all_corrected,55,43,302,162,357,205
167206,30157_20190812144013.jpg,関西スーパー中央,**10,神戸,31,の,2019/8/12 14:39,2-1_all_corrected,56,43,199,309,255,352
167665,30110_20190812170849.jpg,イオン金沢八景,7023,横浜,580,と,2019/8/12 17:08,2-1_all_corrected,94,65,402,385,496,450
167830,30078_20190812181312.jpg,イオンスタイル仙台卸町店,*538,宮崎,581,つ,2019/8/12 18:12,2-1_all_corrected,81,58,286,215,367,273
168044,30167_20190812193102.jpg,イオン東雲店,6702,横浜,304,ま,2019/8/12 19:30,2-1_all_corrected,85,67,202,275,287,342
168215,30169_20190812210436.jpg,イオン相模原ショッピングセンター,2564,相模,500,ろ,2019/8/12 21:03,2-1_all_corrected,74,76,501,329,575,405
167639,30045_20190812170156.jpg,マックスバリュー徳川明倫,***1,名古屋,30,む,2019/8/12 17:01,2-1_all_corrected,56,42,140,184,196,226
167291,30167_20190812151839.jpg,イオン東雲店,*529,足立,332,の,2019/8/12 15:17,2-1_all_corrected,82,66,155,251,237,317
167865,30078_20190812182241.jpg,イオンスタイル仙台卸町店,2359,仙台,100,す,2019/8/12 18:22,2-1_all_corrected,56,44,348,95,404,139
166548,30160_20190812095521.jpg,マックスバリュ米野木店（平面）,*518,名古屋,480,い,2019/8/12 9:55,2-1_all_corrected,47,39,358,129,405,168
167655,30110_20190812170459.jpg,イオン金沢八景,1366,横浜,304,て,2019/8/12 17:04,2-1_all_corrected,41,31,398,80,439,111
167800,30101_20190812175810.jpg,にしてつストアレガネット姪浜,**55,福岡,31,ね,2019/8/12 17:57,2-1_all_corrected,60,42,181,257,241,299
166579,30072_20190812101345.jpg,関西スーパー京阪大和田１F,3251,和歌山,500,む,2019/8/12 10:12,2-1_all_corrected,91,76,28,276,119,352
166639,30001_20190812103831.jpg,関西スーパー高石駅前,1376,和泉,500,む,2019/8/12 10:38,2-1_all_corrected,99,68,317,320,416,388
167986,30078_20190812191153.jpg,イオンスタイル仙台卸町店,2127,仙台,580,か,2019/8/12 19:11,2-1_all_corrected,73,56,318,140,391,196
167944,30144_20190812184727.jpg,イオン幕張,2501,徳島,300,ち,2019/8/12 18:46,2-1_all_corrected,40,36,238,90,278,126
167943,30078_20190812184723.jpg,イオンスタイル仙台卸町店,2211,仙台,530,ゆ,2019/8/12 18:46,2-1_all_corrected,90,64,332,300,422,364
166664,30060_20190812104951.jpg,関西スーパー小野原,*221,大阪,583,と,2019/8/12 10:49,2-1_all_corrected,66,64,120,142,186,206
166831,30078_20190812115511.jpg,イオンスタイル仙台卸町店,*446,仙台,300,む,2019/8/12 11:54,2-1_all_corrected,93,75,168,309,261,384
166697,30078_20190812105938.jpg,イオンスタイル仙台卸町店,7488,宮城,580,ふ,2019/8/12 10:59,2-1_all_corrected,91,64,252,310,343,374
167579,30110_20190812164752.jpg,イオン金沢八景,5036,横浜,530,は,2019/8/12 16:47,2-1_all_corrected,55,47,116,180,171,227
167921,30062_20190812184126.jpg,ミスミモール,9999,神戸,31,は,2019/8/12 18:40,2-1_all_corrected,70,52,355,148,425,200
168136,30157_20190812201327.jpg,関西スーパー中央,***3,神戸,300,ゆ,2019/8/12 20:13,2-1_all_corrected,53,41,218,277,271,318
168109,30144_20190812195949.jpg,イオン幕張,8324,千葉,502,て,2019/8/12 19:59,2-1_all_corrected,77,51,232,202,309,253
167719,30110_20190812172633.jpg,イオン金沢八景,5588,横浜,359,は,2019/8/12 17:26,2-1_all_corrected,41,32,335,69,376,101
168100,30090_20190812195704.jpg,イトーヨーカドー木場 西棟,*316,足立,341,る,2019/8/12 19:56,2-1_all_corrected,73,54,418,265,491,319
167980,30111_20190812190725.jpg,イオン稲毛,1271,千葉,301,る,2019/8/12 19:06,2-1_all_corrected,51,42,162,150,213,192
166607,30045_20190812102645.jpg,マックスバリュー徳川明倫,*111,名古屋,30,ち,2019/8/12 10:26,2-1_all_corrected,55,45,241,163,296,208
167781,30111_20190812175024.jpg,イオン稲毛,1027,千葉,343,め,2019/8/12 17:49,2-1_all_corrected,59,44,335,142,394,186
167920,30091_20190812184017.jpg,イトーヨーカドー木場 立体,*623,世田谷,310,て,2019/8/12 18:39,2-1_all_corrected,74,60,352,122,426,182
166806,30169_20190812113748.jpg,イオン相模原ショッピングセンター,1017,神戸,339,さ,2019/8/12 11:37,2-1_all_corrected,69,54,399,47,468,101
168198,30039_20190812205249.jpg,イトーヨーカドー大井町,6039,福山,300,ま,2019/8/12 20:52,2-1_all_corrected,68,53,270,143,338,196
167124,30072_20190812140816.jpg,関西スーパー京阪大和田１F,5773,なにわ,800,す,2019/8/12 14:07,2-1_all_corrected,70,59,203,154,273,213
167918,30146_20190812183947.jpg,BRANCH仙台（西棟）,5539,仙台,583,あ,2019/8/12 18:39,2-1_all_corrected,77,64,69,266,146,330
167329,30157_20190812153600.jpg,関西スーパー中央,1517,岡山,532,に,2019/8/12 15:35,2-1_all_corrected,54,76,443,305,497,381
168153,30169_20190812202311.jpg,イオン相模原ショッピングセンター,2874,相模,301,め,2019/8/12 20:22,2-1_all_corrected,83,76,484,356,567,432
167576,30144_20190812164704.jpg,イオン幕張,9147,習志野,330,さ,2019/8/12 16:46,2-1_all_corrected,49,37,126,112,175,149
158749,30111_20190807190926.jpg,イオン稲毛,**56,千葉,581,ち,2019/8/7 19:09,2-1_all_corrected,52,41,172,149,224,190
158127,30098_20190807122838.jpg,BRANCH仙台（東棟）,***7,仙台,327,ま,2019/8/7 12:27,2-1_all_corrected,89,58,319,235,408,293
158543,30110_20190807172152.jpg,イオン金沢八景,3012,横浜,480,ち,2019/8/7 17:21,2-1_all_corrected,70,53,306,189,376,242
159052,30063_20190807220644.jpg,コーナン相模原小山モール,2048,土浦,501,ゆ,2019/8/7 22:05,2-1_all_corrected,64,56,496,201,560,257
158722,30110_20190807185549.jpg,イオン金沢八景,1111,横浜,333,つ,2019/8/7 18:55,2-1_all_corrected,52,42,421,68,473,110
158174,30110_20190807130013.jpg,イオン金沢八景,*754,横浜,502,み,2019/8/7 12:59,2-1_all_corrected,49,34,331,64,380,98
158913,30009_20190807201654.jpg,西友新北習志野,**10,習志野,367,め,2019/8/7 20:16,2-1_all_corrected,145,110,178,0,323,110
158580,30169_20190807174544.jpg,イオン相模原ショッピングセンター,6555,相模,502,て,2019/8/7 17:45,2-1_all_corrected,84,71,286,115,370,186
158144,30110_20190807123922.jpg,イオン金沢八景,*500,横浜,50,み,2019/8/7 12:38,2-1_all_corrected,54,44,328,166,382,210
158527,30072_20190807171202.jpg,関西スーパー京阪大和田１F,4444,大阪,373,す,2019/8/7 17:11,2-1_all_corrected,80,63,38,151,118,214
158038,30072_20190807113228.jpg,関西スーパー京阪大和田１F,1267,なにわ,580,む,2019/8/7 11:32,2-1_all_corrected,58,44,442,196,500,240
158651,30111_20190807182140.jpg,イオン稲毛,2468,習志野,301,ね,2019/8/7 18:21,2-1_all_corrected,67,54,210,119,277,173
158009,30110_20190807111140.jpg,イオン金沢八景,6857,横浜,583,あ,2019/8/7 11:10,2-1_all_corrected,44,41,487,57,531,98
158065,30060_20190807115016.jpg,関西スーパー小野原,1335,大阪,530,る,2019/8/7 11:49,2-1_all_corrected,39,43,446,25,485,68
158892,30072_20190807200933.jpg,関西スーパー京阪大和田１F,*870,大阪,501,ろ,2019/8/7 20:09,2-1_all_corrected,87,83,98,363,185,446
158866,30078_20190807195515.jpg,イオンスタイル仙台卸町店,*301,宮城,331,の,2019/8/7 19:54,2-1_all_corrected,81,62,151,222,232,284
158605,30110_20190807180015.jpg,イオン金沢八景,1001,横浜,31,の,2019/8/7 17:59,2-1_all_corrected,81,69,498,184,579,253
158834,30169_20190807194012.jpg,イオン相模原ショッピングセンター,*778,横浜,303,や,2019/8/7 19:39,2-1_all_corrected,81,72,422,301,503,373
158453,30072_20190807162534.jpg,関西スーパー京阪大和田１F,1188,大阪,598,と,2019/8/7 16:25,2-1_all_corrected,73,63,249,89,322,152
158454,30157_20190807162537.jpg,関西スーパー中央,1010,神戸,31,の,2019/8/7 16:25,2-1_all_corrected,56,44,324,305,380,349
158668,30070_20190807183042.jpg,カナートモール住道第一,**17,大阪,380,め,2019/8/7 18:29,2-1_all_corrected,86,65,202,251,288,316
158657,30169_20190807182436.jpg,イオン相模原ショッピングセンター,3745,相模,400,と,2019/8/7 18:24,2-1_all_corrected,55,42,391,98,446,140
158233,30145_20190807133635.jpg,イオン高根木戸,*565,練馬,501,む,2019/8/7 13:35,2-1_all_corrected,59,42,228,185,287,227
157875,30110_20190807093829.jpg,イオン金沢八景,5602,横浜,302,ら,2019/8/7 9:37,2-1_all_corrected,48,37,399,48,447,85
158052,30062_20190807114505.jpg,ミスミモール,**18,神戸,31,ち,2019/8/7 11:44,2-1_all_corrected,50,39,455,120,505,159
158438,30111_20190807161603.jpg,イオン稲毛,*809,水戸,331,つ,2019/8/7 16:15,2-1_all_corrected,57,45,245,187,302,232
158860,30079_20190807195141.jpg,ピットデザイン仙台卸町駅前駐車場,4857,仙台,480,う,2019/8/7 19:50,2-1_all_corrected,78,63,254,306,332,369
158874,30072_20190807200008.jpg,関西スーパー京阪大和田１F,1216,大阪,347,と,2019/8/7 19:59,2-1_all_corrected,49,39,469,58,518,97
158820,30062_20190807193505.jpg,ミスミモール,***3,神戸,30,ふ,2019/8/7 19:34,2-1_all_corrected,69,51,291,157,360,208
158672,30169_20190807183109.jpg,イオン相模原ショッピングセンター,7312,相模,330,て,2019/8/7 18:30,2-1_all_corrected,63,56,123,245,186,301
158811,30110_20190807193230.jpg,イオン金沢八景,4416,横浜,531,こ,2019/8/7 19:31,2-1_all_corrected,65,58,518,232,583,290
158471,30045_20190807164047.jpg,マックスバリュー徳川明倫,**77,名古屋,31,ほ,2019/8/7 16:40,2-1_all_corrected,39,29,316,81,355,110
158227,30111_20190807133454.jpg,イオン稲毛,7151,千葉,583,か,2019/8/7 13:34,2-1_all_corrected,41,30,433,46,474,76
158816,30169_20190807193335.jpg,イオン相模原ショッピングセンター,*112,相模,335,か,2019/8/7 19:32,2-1_all_corrected,52,43,404,20,456,63
158071,30111_20190807115510.jpg,イオン稲毛,8711,千葉,483,か,2019/8/7 11:54,2-1_all_corrected,43,34,74,95,117,129
158844,30111_20190807194440.jpg,イオン稲毛,6296,千葉,530,す,2019/8/7 19:44,2-1_all_corrected,46,35,94,110,140,145
158423,30078_20190807160311.jpg,イオンスタイル仙台卸町店,***9,宮城,353,ふ,2019/8/7 16:02,2-1_all_corrected,77,54,321,148,398,202
158629,30039_20190807181344.jpg,イトーヨーカドー大井町,*329,品川,337,た,2019/8/7 18:13,2-1_all_corrected,53,43,287,184,340,227
158817,30060_20190807193346.jpg,関西スーパー小野原,4333,大阪,302,ゆ,2019/8/7 19:33,2-1_all_corrected,71,60,364,239,435,299
158228,30045_20190807133515.jpg,マックスバリュー徳川明倫,*358,名古屋,32,つ,2019/8/7 13:34,2-1_all_corrected,51,42,225,149,276,191
158396,30111_20190807155346.jpg,イオン稲毛,5061,千葉,581,さ,2019/8/7 15:53,2-1_all_corrected,57,44,333,166,390,210
158998,30111_20190807211700.jpg,イオン稲毛,**12,千葉,589,ほ,2019/8/7 21:16,2-1_all_corrected,55,46,298,177,353,223
158534,30111_20190807171729.jpg,イオン稲毛,2632,千葉,330,の,2019/8/7 17:16,2-1_all_corrected,51,43,195,136,246,179
158533,30111_20190807171723.jpg,イオン稲毛,6902,沼津,501,つ,2019/8/7 17:16,2-1_all_corrected,73,50,351,159,424,209
158192,30167_20190807131158.jpg,イオン東雲店,*106,足立,530,く,2019/8/7 13:11,2-1_all_corrected,67,53,281,201,348,254
158354,30111_20190807151831.jpg,イオン稲毛,*333,千葉,517,ね,2019/8/7 15:18,2-1_all_corrected,55,46,435,197,490,243
158502,30072_20190807165911.jpg,関西スーパー京阪大和田１F,1137,大阪,581,か,2019/8/7 16:58,2-1_all_corrected,49,36,323,44,372,80
157979,30111_20190807105136.jpg,イオン稲毛,***5,千葉,30,ふ,2019/8/7 10:51,2-1_all_corrected,44,32,420,80,464,112
158909,30063_20190807201542.jpg,コーナン相模原小山モール,2667,相模,501,ら,2019/8/7 20:15,2-1_all_corrected,69,62,479,189,548,251
158755,30110_20190807191107.jpg,イオン金沢八景,8883,横浜,583,ろ,2019/8/7 19:10,2-1_all_corrected,103,91,484,278,587,369
158352,30072_20190807151638.jpg,関西スーパー京阪大和田１F,8463,大阪,100,え,2019/8/7 15:16,2-1_all_corrected,71,57,36,184,107,241
158364,30103_20190807152748.jpg,八尾老原１丁目,***1,大阪,30,は,2019/8/7 15:26,2-1_all_corrected,57,46,247,152,304,198
158707,30080_20190807184541.jpg,フォーレストモール新前橋,**17,高崎,531,ひ,2019/8/7 18:44,2-1_all_corrected,56,46,185,153,241,199
158151,30157_20190807124337.jpg,関西スーパー中央,6973,三重,502,み,2019/8/7 12:43,2-1_all_corrected,49,45,71,390,120,435
158363,30062_20190807152738.jpg,ミスミモール,**11,神戸,31,め,2019/8/7 15:27,2-1_all_corrected,71,55,305,158,376,213
158397,30110_20190807155352.jpg,イオン金沢八景,2226,横浜,580,そ,2019/8/7 15:53,2-1_all_corrected,74,59,392,253,466,312
159024,30156_20190807214039.jpg,万代 西神中央店,**78,神戸,545,つ,2019/8/7 21:40,2-1_all_corrected,48,38,386,216,434,254
158330,30105_20190807145958.jpg,カスミフードスクエア春日部武里,1593,春日部,500,あ,2019/8/7 14:59,2-1_all_corrected,65,65,64,276,129,341
158559,30110_20190807173234.jpg,イオン金沢八景,3921,世田谷,500,す,2019/8/7 17:31,2-1_all_corrected,55,45,242,152,297,197
158908,30169_20190807201535.jpg,イオン相模原ショッピングセンター,8298,山梨,530,す,2019/8/7 20:15,2-1_all_corrected,52,43,201,97,253,140
158301,30028_20190807144209.jpg,ピットデザイン南摂津,1001,大阪,31,も,2019/8/7 14:41,2-1_all_corrected,68,58,287,64,355,122
159015,30023_20190807212857.jpg,ピットデザイン山科東野,**87,福岡,588,や,2019/8/7 21:28,2-1_all_corrected,82,61,257,111,339,172
158568,30111_20190807173700.jpg,イオン稲毛,1238,千葉,532,ね,2019/8/7 17:36,2-1_all_corrected,57,44,343,153,400,197
158387,30066_20190807154456.jpg,ジョーシン和泉中央,1000,和泉,30,み,2019/8/7 15:44,2-1_all_corrected,49,37,301,122,350,159
158525,30073_20190807171142.jpg,関西スーパー京阪大和田２F,4444,大阪,373,す,2019/8/7 17:11,2-1_all_corrected,98,84,460,196,558,280
158585,30070_20190807174857.jpg,カナートモール住道第一,***8,大阪,30,ま,2019/8/7 17:48,2-1_all_corrected,91,67,381,304,472,371
159033,30079_20190807214911.jpg,ピットデザイン仙台卸町駅前駐車場,*806,仙台,330,め,2019/8/7 21:48,2-1_all_corrected,88,77,205,228,293,305
157961,30060_20190807104120.jpg,関西スーパー小野原,5689,大阪,480,の,2019/8/7 10:40,2-1_all_corrected,46,34,105,238,151,272
158743,30110_20190807190558.jpg,イオン金沢八景,*181,横浜,333,あ,2019/8/7 19:05,2-1_all_corrected,65,59,492,108,557,167
158112,30111_20190807122027.jpg,イオン稲毛,7788,千葉,555,つ,2019/8/7 12:20,2-1_all_corrected,74,56,300,171,374,227
158582,30111_20190807174627.jpg,イオン稲毛,1739,千葉,330,は,2019/8/7 17:45,2-1_all_corrected,56,43,326,159,382,202
158316,30110_20190807145215.jpg,イオン金沢八景,8124,横浜,504,ま,2019/8/7 14:51,2-1_all_corrected,51,35,95,43,146,78
158772,30169_20190807191758.jpg,イオン相模原ショッピングセンター,*501,多摩,536,み,2019/8/7 19:17,2-1_all_corrected,76,58,368,175,444,233
159002,30110_20190807211955.jpg,イオン金沢八景,1339,横浜,304,す,2019/8/7 21:19,2-1_all_corrected,77,51,418,66,495,117
158781,30079_20190807192153.jpg,ピットデザイン仙台卸町駅前駐車場,**11,宮城,355,う,2019/8/7 19:21,2-1_all_corrected,78,62,239,222,317,284
158547,30062_20190807172400.jpg,ミスミモール,***5,神戸,30,に,2019/8/7 17:23,2-1_all_corrected,66,57,213,170,279,227
158716,30063_20190807185123.jpg,コーナン相模原小山モール,***5,多摩,30,は,2019/8/7 18:50,2-1_all_corrected,75,64,15,275,90,339
157933,30062_20190807102245.jpg,ミスミモール,*123,神戸,31,ぬ,2019/8/7 10:22,2-1_all_corrected,83,74,82,244,165,318
158972,30169_20190807205518.jpg,イオン相模原ショッピングセンター,8008,多摩,591,は,2019/8/7 20:54,2-1_all_corrected,84,73,376,352,460,425
157902,30151_20190807095848.jpg,テックランド今福東店,3054,なにわ,501,ら,2019/8/7 9:58,2-1_all_corrected,52,39,252,107,304,146
158787,30169_20190807192435.jpg,イオン相模原ショッピングセンター,7001,川崎,330,り,2019/8/7 19:24,2-1_all_corrected,83,74,470,369,553,443
159003,30078_20190807212013.jpg,イオンスタイル仙台卸町店,*115,仙台,334,に,2019/8/7 21:19,2-1_all_corrected,64,59,162,45,226,104
158317,30060_20190807145218.jpg,関西スーパー小野原,***7,大阪,536,は,2019/8/7 14:51,2-1_all_corrected,69,60,397,271,466,331
157958,30072_20190807103633.jpg,関西スーパー京阪大和田１F,4444,大阪,373,す,2019/8/7 10:36,2-1_all_corrected,87,74,92,337,179,411
157967,30078_20190807104604.jpg,イオンスタイル仙台卸町店,9999,山形,335,ゆ,2019/8/7 10:45,2-1_all_corrected,71,56,191,139,262,195
158570,30001_20190807173804.jpg,関西スーパー高石駅前,**55,和泉,31,る,2019/8/7 17:37,2-1_all_corrected,70,52,456,78,526,130
157994,30169_20190807110222.jpg,イオン相模原ショッピングセンター,8136,相模,501,ゆ,2019/8/7 11:01,2-1_all_corrected,80,67,350,203,430,270
158254,30110_20190807135100.jpg,イオン金沢八景,6386,横浜,580,ぬ,2019/8/7 13:50,2-1_all_corrected,78,60,55,390,133,450
158298,30078_20190807143721.jpg,イオンスタイル仙台卸町店,**25,宮城,333,す,2019/8/7 14:36,2-1_all_corrected,70,57,370,175,440,232
158291,30169_20190807143343.jpg,イオン相模原ショッピングセンター,7120,多摩,580,や,2019/8/7 14:33,2-1_all_corrected,95,74,348,376,443,450
158853,30072_20190807194937.jpg,関西スーパー京阪大和田１F,***2,大阪,30,そ,2019/8/7 19:49,2-1_all_corrected,89,70,130,174,219,244
158231,30111_20190807133620.jpg,イオン稲毛,1164,千葉,500,ち,2019/8/7 13:35,2-1_all_corrected,42,33,81,94,123,127
157841,30072_20190807085709.jpg,関西スーパー京阪大和田１F,*762,京都,800,せ,2019/8/7 8:56,2-1_all_corrected,83,69,417,308,500,377
158809,30110_20190807193225.jpg,イオン金沢八景,4416,横浜,531,か,2019/8/7 19:31,2-1_all_corrected,71,69,13,377,84,446
157825,30163_20190807084639.jpg,コープ葛飾白鳥店(地上),***8,足立,30,す,2019/8/7 8:46,2-1_all_corrected,55,42,395,136,450,178
158435,30060_20190807161206.jpg,関西スーパー小野原,2102,大阪,503,や,2019/8/7 16:11,2-1_all_corrected,74,75,511,299,585,374
158638,30111_20190807181634.jpg,イオン稲毛,9374,千葉,302,そ,2019/8/7 18:16,2-1_all_corrected,69,51,354,150,423,201
158600,30111_20190807175902.jpg,イオン稲毛,*620,千葉,537,た,2019/8/7 17:58,2-1_all_corrected,58,44,347,161,405,205
158636,30060_20190807181627.jpg,関西スーパー小野原,*628,大阪,483,あ,2019/8/7 18:15,2-1_all_corrected,74,60,324,328,398,388
158863,30169_20190807195322.jpg,イオン相模原ショッピングセンター,1000,相模,510,さ,2019/8/7 19:52,2-1_all_corrected,56,46,392,30,448,76
158837,30072_20190807194200.jpg,関西スーパー京阪大和田１F,***2,大阪,30,そ,2019/8/7 19:41,2-1_all_corrected,66,55,232,254,298,309
158808,30078_20190807193205.jpg,イオンスタイル仙台卸町店,**39,宮城,583,ひ,2019/8/7 19:31,2-1_all_corrected,55,39,293,59,348,98
158034,30072_20190807112814.jpg,関西スーパー京阪大和田１F,7011,大阪,581,ひ,2019/8/7 11:27,2-1_all_corrected,47,34,159,82,206,116
158459,30110_20190807163036.jpg,イオン金沢八景,1030,横浜,364,ち,2019/8/7 16:29,2-1_all_corrected,51,39,308,34,359,73
158492,30078_20190807165342.jpg,イオンスタイル仙台卸町店,5069,山形,580,の,2019/8/7 16:53,2-1_all_corrected,60,44,261,112,321,156
158002,30110_20190807110801.jpg,イオン金沢八景,3107,横浜,581,き,2019/8/7 11:07,2-1_all_corrected,46,36,487,152,533,188
158671,30062_20190807183109.jpg,ミスミモール,1188,神戸,31,さ,2019/8/7 18:30,2-1_all_corrected,74,72,92,225,166,297
158682,30072_20190807183622.jpg,関西スーパー京阪大和田１F,**22,なにわ,538,ぬ,2019/8/7 18:35,2-1_all_corrected,57,43,332,205,389,248
158475,30145_20190807164312.jpg,イオン高根木戸,*565,練馬,501,む,2019/8/7 16:42,2-1_all_corrected,61,45,245,176,306,221
158812,30110_20190807193235.jpg,イオン金沢八景,4416,横浜,531,と,2019/8/7 19:31,2-1_all_corrected,65,55,454,186,519,241
158883,30169_20190807200529.jpg,イオン相模原ショッピングセンター,3159,相模,301,も,2019/8/7 20:04,2-1_all_corrected,79,78,424,258,503,336
158279,30111_20190807142421.jpg,イオン稲毛,9381,千葉,580,や,2019/8/7 14:23,2-1_all_corrected,56,43,178,166,234,209
158080,30111_20190807120104.jpg,イオン稲毛,*726,千葉,585,た,2019/8/7 12:00,2-1_all_corrected,54,41,339,139,393,180
158074,30163_20190807115552.jpg,コープ葛飾白鳥店(地上),***8,足立,30,す,2019/8/7 11:55,2-1_all_corrected,56,44,199,117,255,161
158848,30169_20190807194715.jpg,イオン相模原ショッピングセンター,*358,多摩,345,ぬ,2019/8/7 19:46,2-1_all_corrected,80,69,417,319,497,388
158428,30001_20190807160631.jpg,関西スーパー高石駅前,***4,和泉,589,こ,2019/8/7 16:06,2-1_all_corrected,94,72,185,347,279,419
158813,30066_20190807193302.jpg,ジョーシン和泉中央,**55,和泉,31,ち,2019/8/7 19:32,2-1_all_corrected,67,54,183,213,250,267
158473,30111_20190807164143.jpg,イオン稲毛,3605,袖ヶ浦,100,さ,2019/8/7 16:41,2-1_all_corrected,53,45,248,146,301,191
157897,30009_20190807095432.jpg,西友新北習志野,8347,習志野,330,せ,2019/8/7 9:54,2-1_all_corrected,192,120,250,8,442,128
158677,30072_20190807183148.jpg,関西スーパー京阪大和田１F,8551,大阪,480,ね,2019/8/7 18:30,2-1_all_corrected,91,68,56,318,147,386
158489,30072_20190807165104.jpg,関西スーパー京阪大和田１F,*626,大阪,585,あ,2019/8/7 16:50,2-1_all_corrected,82,60,231,204,313,264
158416,30169_20190807160026.jpg,イオン相模原ショッピングセンター,8424,相模,301,て,2019/8/7 15:59,2-1_all_corrected,73,50,140,148,213,198
158612,30111_20190807180332.jpg,イオン稲毛,*333,千葉,517,ね,2019/8/7 18:03,2-1_all_corrected,65,58,449,239,514,297
158935,30169_20190807203527.jpg,イオン相模原ショッピングセンター,7217,相模,301,と,2019/8/7 20:35,2-1_all_corrected,72,70,452,227,524,297
157792,30169_20190807082146.jpg,イオン相模原ショッピングセンター,2929,相模,331,も,2019/8/7 8:21,2-1_all_corrected,77,57,370,20,447,77
158107,30111_20190807121624.jpg,イオン稲毛,2913,千葉,301,す,2019/8/7 12:15,2-1_all_corrected,58,42,350,143,408,185
158332,30103_20190807150301.jpg,八尾老原１丁目,***1,大阪,30,は,2019/8/7 15:02,2-1_all_corrected,72,58,229,198,301,256
157980,30001_20190807105254.jpg,関西スーパー高石駅前,8890,和泉,502,つ,2019/8/7 10:52,2-1_all_corrected,96,64,164,290,260,354
158769,30072_20190807191712.jpg,関西スーパー京阪大和田１F,2495,大阪,503,や,2019/8/7 19:16,2-1_all_corrected,41,34,247,67,288,101
158366,30060_20190807152803.jpg,関西スーパー小野原,*128,和泉,502,な,2019/8/7 15:27,2-1_all_corrected,36,40,481,30,517,70
158395,30110_20190807155306.jpg,イオン金沢八景,2297,横浜,332,め,2019/8/7 15:52,2-1_all_corrected,39,32,497,67,536,99
158153,30110_20190807124422.jpg,イオン金沢八景,9372,横浜,301,ぬ,2019/8/7 12:43,2-1_all_corrected,70,59,500,121,570,180
158539,30072_20190807171911.jpg,関西スーパー京阪大和田１F,9713,大坂,503,や,2019/8/7 17:18,2-1_all_corrected,73,52,108,132,181,184
158562,30072_20190807173421.jpg,関西スーパー京阪大和田１F,3483,大阪,581,く,2019/8/7 17:33,2-1_all_corrected,43,30,183,16,226,46
158351,30078_20190807151626.jpg,イオンスタイル仙台卸町店,8000,仙台,584,み,2019/8/7 15:16,2-1_all_corrected,76,52,329,262,405,314
158509,30045_20190807170350.jpg,マックスバリュー徳川明倫,*358,名古屋,32,と,2019/8/7 17:03,2-1_all_corrected,54,43,270,141,324,184
146221,30063_20190801191810.jpg,コーナン相模原小山モール,9613,札幌,301,も,2019/8/1 19:17,2-1_all_corrected,55,47,497,105,552,152
146275,30169_20190801194224.jpg,イオン相模原ショッピングセンター,1021,相模,338,る,2019/8/1 19:42,2-1_all_corrected,83,78,491,362,574,440
145460,30072_20190801120953.jpg,関西スーパー京阪大和田１F,***8,奈良,30,ひ,2019/8/1 12:09,2-1_all_corrected,67,54,182,157,249,211
146447,30169_20190801220530.jpg,イオン相模原ショッピングセンター,**77,相模,375,く,2019/8/1 22:05,2-1_all_corrected,71,53,399,19,470,72
145655,30078_20190801140259.jpg,イオンスタイル仙台卸町店,5288,仙台,580,ほ,2019/8/1 14:02,2-1_all_corrected,95,66,213,316,308,382
146015,30111_20190801174027.jpg,イオン稲毛,8787,土浦,-1,ふ,2019/8/1 17:40,2-1_all_corrected,36,30,33,45,69,75
146218,30138_20190801191731.jpg,イオンスタイル湘南茅ヶ崎,2402,湘南,502,と,2019/8/1 19:16,2-1_all_corrected,57,44,275,114,332,158
146287,30078_20190801194842.jpg,イオンスタイル仙台卸町店,3825,仙台,480,か,2019/8/1 19:47,2-1_all_corrected,91,64,148,329,239,393
145862,30079_20190801160836.jpg,ピットデザイン仙台卸町駅前駐車場,7483,仙台,300,み,2019/8/1 16:08,2-1_all_corrected,49,38,409,116,458,154
146280,30072_20190801194335.jpg,関西スーパー京阪大和田１F,4953,大阪,581,な,2019/8/1 19:43,2-1_all_corrected,46,34,331,68,377,102
145745,30023_20190801145611.jpg,ピットデザイン山科東野,7777,京都,522,み,2019/8/1 14:55,2-1_all_corrected,80,62,289,42,369,104
145711,30079_20190801144013.jpg,ピットデザイン仙台卸町駅前駐車場,8540,秋田,501,と,2019/8/1 14:39,2-1_all_corrected,48,36,354,176,402,212
146151,30111_20190801184621.jpg,イオン稲毛,*228,千葉,584,も,2019/8/1 18:45,2-1_all_corrected,68,54,169,166,237,220
145772,30110_20190801150820.jpg,イオン金沢八景,7907,横浜,504,の,2019/8/1 15:07,2-1_all_corrected,45,34,518,78,563,112
145124,30118_20190801082529.jpg,ショッパーズプラザ横須賀(6F・屋上),**22,野田,430,は,2019/8/1 8:25,2-1_all_corrected,70,64,238,233,308,297
145719,30151_20190801144514.jpg,テックランド今福東店,3054,なにわ,50,ら,2019/8/1 14:44,2-1_all_corrected,58,42,368,122,426,164
146365,30169_20190801203102.jpg,イオン相模原ショッピングセンター,8008,多摩,327,や,2019/8/1 20:30,2-1_all_corrected,55,42,346,122,401,164
145525,30078_20190801125211.jpg,イオンスタイル仙台卸町店,**30,仙台,583,そ,2019/8/1 12:51,2-1_all_corrected,77,57,248,181,325,238
146382,30078_20190801205121.jpg,イオンスタイル仙台卸町店,*910,仙台,300,く,2019/8/1 20:50,2-1_all_corrected,53,49,186,54,239,103
145960,30169_20190801170920.jpg,イオン相模原ショッピングセンター,5132,多摩,530,は,2019/8/1 17:08,2-1_all_corrected,54,42,133,59,187,101
145951,30078_20190801170011.jpg,イオンスタイル仙台卸町店,1136,庄内,33,せ,2019/8/1 16:59,2-1_all_corrected,70,58,95,298,165,356
146172,30169_20190801185908.jpg,イオン相模原ショッピングセンター,*625,多摩,585,る,2019/8/1 18:58,2-1_all_corrected,49,39,212,180,261,219
145759,30103_20190801150027.jpg,八尾老原１丁目,8888,大阪,30,そ,2019/8/1 14:59,2-1_all_corrected,46,33,383,79,429,112
145302,30072_20190801104807.jpg,関西スーパー京阪大和田１F,***8,奈良,30,ひ,2019/8/1 10:47,2-1_all_corrected,71,54,319,277,390,331
145934,30086_20190801165004.jpg,テックランド大阪りんくう,9632,和泉,581,け,2019/8/1 16:49,2-1_all_corrected,46,44,129,205,175,249
145957,30111_20190801170409.jpg,イオン稲毛,3605,袖ヶ浦,100,さ,2019/8/1 17:03,2-1_all_corrected,69,55,292,188,361,243
145198,30156_20190801093240.jpg,万代 西神中央店,1010,神戸,31,す,2019/8/1 9:32,2-1_all_corrected,53,43,325,193,378,236
146142,30111_20190801184257.jpg,イオン稲毛,*310,千葉,507,あ,2019/8/1 18:42,2-1_all_corrected,54,41,159,154,213,195
145734,30006_20190801145046.jpg,スギ薬局南千里,*101,大阪,365,な,2019/8/1 14:50,2-1_all_corrected,153,121,23,198,176,319
146383,30111_20190801205122.jpg,イオン稲毛,4811,千葉,530,ね,2019/8/1 20:50,2-1_all_corrected,54,43,172,128,226,171
146120,30078_20190801183102.jpg,イオンスタイル仙台卸町店,2436,仙台,300,の,2019/8/1 18:30,2-1_all_corrected,94,63,330,376,424,439
145564,30078_20190801131143.jpg,イオンスタイル仙台卸町店,9438,宮城,580,ね,2019/8/1 13:11,2-1_all_corrected,81,60,257,199,338,259
146258,30079_20190801193253.jpg,ピットデザイン仙台卸町駅前駐車場,2031,仙台,330,て,2019/8/1 19:32,2-1_all_corrected,54,88,14,332,68,420
145849,30078_20190801160235.jpg,イオンスタイル仙台卸町店,5840,仙台,580,ち,2019/8/1 16:02,2-1_all_corrected,55,43,251,75,306,118
146064,30045_20190801180221.jpg,マックスバリュー徳川明倫,**17,名古屋,31,り,2019/8/1 18:01,2-1_all_corrected,53,41,303,102,356,143
145102,30073_20190801080133.jpg,関西スーパー京阪大和田２F,2404,神戸,100,す,2019/8/1 8:00,2-1_all_corrected,75,60,392,215,467,275
146097,30157_20190801181817.jpg,関西スーパー中央,1101,神戸,364,つ,2019/8/1 18:17,2-1_all_corrected,46,66,384,136,430,202
145646,30111_20190801135659.jpg,イオン稲毛,6171,千葉,580,ま,2019/8/1 13:56,2-1_all_corrected,40,33,55,80,95,113
146234,30045_20190801192257.jpg,マックスバリュー徳川明倫,***3,名古屋,30,は,2019/8/1 19:22,2-1_all_corrected,54,48,136,188,190,236
145684,30111_20190801141959.jpg,イオン稲毛,9907,千葉,500,ほ,2019/8/1 14:19,2-1_all_corrected,44,34,34,91,78,125
145284,30062_20190801103933.jpg,ミスミモール,***3,神戸,30,ふ,2019/8/1 10:38,2-1_all_corrected,50,37,388,122,438,159
146098,30110_20190801181817.jpg,イオン金沢八景,1515,横浜,341,ろ,2019/8/1 18:17,2-1_all_corrected,55,45,188,136,243,181
146235,30072_20190801192304.jpg,関西スーパー京阪大和田１F,9146,大阪,581,に,2019/8/1 19:22,2-1_all_corrected,84,65,85,318,169,383
146411,30169_20190801211702.jpg,イオン相模原ショッピングセンター,6630,相模,301,は,2019/8/1 21:16,2-1_all_corrected,49,40,202,93,251,133
145453,30072_20190801120731.jpg,関西スーパー京阪大和田１F,*701,神戸,830,か,2019/8/1 12:06,2-1_all_corrected,41,39,64,76,105,115
146213,30111_20190801191538.jpg,イオン稲毛,4267,千葉,581,う,2019/8/1 19:15,2-1_all_corrected,55,44,189,167,244,211
146214,30111_20190801191551.jpg,イオン稲毛,9201,千葉,541,す,2019/8/1 19:15,2-1_all_corrected,47,39,108,119,155,158
145257,30106_20190801102715.jpg,ジョーシン東大阪長田,8008,京都,31,ふ,2019/8/1 10:26,2-1_all_corrected,59,42,272,198,331,240
146073,30078_20190801180435.jpg,イオンスタイル仙台卸町店,8000,仙台,584,み,2019/8/1 18:04,2-1_all_corrected,76,54,289,237,365,291
145490,30111_20190801122836.jpg,イオン稲毛,5231,千葉,503,た,2019/8/1 12:28,2-1_all_corrected,47,37,94,96,141,133
146224,30072_20190801191840.jpg,関西スーパー京阪大和田１F,8783,大阪,580,あ,2019/8/1 19:18,2-1_all_corrected,68,64,227,234,295,298
145520,30110_20190801124613.jpg,イオン金沢八景,1331,横浜,583,さ,2019/8/1 12:45,2-1_all_corrected,72,58,267,210,339,268
145712,30078_20190801144134.jpg,イオンスタイル仙台卸町店,1595,仙台,300,そ,2019/8/1 14:41,2-1_all_corrected,92,63,285,302,377,365
145382,30111_20190801113603.jpg,イオン稲毛,*702,千葉,551,て,2019/8/1 11:35,2-1_all_corrected,47,39,94,105,141,144
145188,30072_20190801092607.jpg,関西スーパー京阪大和田１F,*810,大阪,580,や,2019/8/1 9:25,2-1_all_corrected,47,39,105,93,152,132
145385,30014_20190801113711.jpg,フォルテ蘇我ベルク棟,**11,千葉,31,ゆ,2019/8/1 11:36,2-1_all_corrected,43,44,104,78,147,122
146356,30169_20190801202438.jpg,イオン相模原ショッピングセンター,2856,多摩,302,や,2019/8/1 20:24,2-1_all_corrected,79,76,500,366,579,442
146199,30110_20190801191019.jpg,イオン金沢八景,*612,つくば,333,ひ,2019/8/1 19:09,2-1_all_corrected,69,55,367,176,436,231
145976,30139_20190801171919.jpg,イオン板橋ショッピングセンター,***1,練馬,30,ね,2019/8/1 17:18,2-1_all_corrected,54,43,304,190,358,233
146360,30111_20190801202824.jpg,イオン稲毛,8883,千葉,502,む,2019/8/1 20:28,2-1_all_corrected,51,40,169,131,220,171
145971,30062_20190801171849.jpg,ミスミモール,**10,神戸,31,む,2019/8/1 17:17,2-1_all_corrected,51,42,418,110,469,152
146139,30169_20190801184118.jpg,イオン相模原ショッピングセンター,*111,相模,590,さ,2019/8/1 18:40,2-1_all_corrected,74,59,259,122,333,181
145573,30110_20190801131603.jpg,イオン金沢八景,*180,横浜,583,て,2019/8/1 13:15,2-1_all_corrected,76,56,289,134,365,190
145174,30078_20190801091253.jpg,イオンスタイル仙台卸町店,1355,仙台,330,つ,2019/8/1 9:12,2-1_all_corrected,79,56,265,263,344,319
146165,30111_20190801185604.jpg,イオン稲毛,4848,千葉,301,わ,2019/8/1 18:55,2-1_all_corrected,51,43,153,110,204,153
146303,30111_20190801195746.jpg,イオン稲毛,1620,千葉,11,ろ,2019/8/1 19:57,2-1_all_corrected,40,31,431,34,471,65
145776,30078_20190801151058.jpg,イオンスタイル仙台卸町店,**38,仙台,583,を,2019/8/1 15:10,2-1_all_corrected,72,54,242,136,314,190
145782,30078_20190801151259.jpg,イオンスタイル仙台卸町店,7583,仙台,530,た,2019/8/1 15:12,2-1_all_corrected,77,57,282,215,359,272
145749,30078_20190801145656.jpg,イオンスタイル仙台卸町店,6362,仙台,580,そ,2019/8/1 14:56,2-1_all_corrected,73,52,245,146,318,198
145561,30078_20190801130706.jpg,イオンスタイル仙台卸町店,7159,仙台,501,た,2019/8/1 13:06,2-1_all_corrected,58,44,322,82,380,126
146113,30111_20190801182856.jpg,イオン稲毛,3543,袖ヶ浦,300,と,2019/8/1 18:28,2-1_all_corrected,66,60,342,203,408,263
145963,30114_20190801171215.jpg,イオン南行徳（立体）,8317,足立,300,ろ,2019/8/1 17:11,2-1_all_corrected,52,44,368,139,420,183
145790,30006_20190801152036.jpg,スギ薬局南千里,7788,大阪,317,そ,2019/8/1 15:20,2-1_all_corrected,137,119,35,147,172,266
145909,30072_20190801163949.jpg,関西スーパー京阪大和田１F,8650,大阪,581,き,2019/8/1 16:39,2-1_all_corrected,81,61,2,271,83,332
146124,30117_20190801183212.jpg,ショッパーズプラザ横須賀,1520,横浜,531,む,2019/8/1 18:31,2-1_all_corrected,78,60,300,321,378,381
145752,30078_20190801145729.jpg,イオンスタイル仙台卸町店,7145,仙台,501,つ,2019/8/1 14:56,2-1_all_corrected,74,53,297,173,371,226
145362,30106_20190801112746.jpg,ジョーシン東大阪長田,8008,京都,31,ふ,2019/8/1 11:26,2-1_all_corrected,77,53,258,294,335,347
146177,30169_20190801190009.jpg,イオン相模原ショッピングセンター,8230,多摩,530,て,2019/8/1 18:59,2-1_all_corrected,86,72,393,285,479,357
146184,30089_20190801190405.jpg,ままともプラザ町田（店舗）,1000,横浜,30,あ,2019/8/1 19:03,2-1_all_corrected,61,40,325,153,386,193
146374,30110_20190801203817.jpg,イオン金沢八景,1111,横浜,333,つ,2019/8/1 20:37,2-1_all_corrected,48,43,474,66,522,109
145962,30111_20190801171156.jpg,イオン稲毛,3921,千葉,503,す,2019/8/1 17:11,2-1_all_corrected,57,45,230,161,287,206
145159,30106_20190801090014.jpg,ジョーシン東大阪長田,8008,京都,31,ふ,2019/8/1 8:59,2-1_all_corrected,49,44,346,136,395,180
146201,30111_20190801191103.jpg,イオン稲毛,5295,千葉,302,ぬ,2019/8/1 19:10,2-1_all_corrected,75,57,264,214,339,271
146230,30169_20190801192105.jpg,イオン相模原ショッピングセンター,8322,相模,330,な,2019/8/1 19:20,2-1_all_corrected,66,57,102,314,168,371
146466,30111_20190801223056.jpg,イオン稲毛,9131,千葉,581,い,2019/8/1 22:30,2-1_all_corrected,55,43,166,174,221,217
145479,30072_20190801122152.jpg,関西スーパー京阪大和田１F,6548,なにわ,800,あ,2019/8/1 12:21,2-1_all_corrected,70,58,7,231,77,289
146051,30066_20190801175401.jpg,ジョーシン和泉中央,**55,和泉,31,ま,2019/8/1 17:53,2-1_all_corrected,56,44,239,206,295,250
145620,30078_20190801134008.jpg,イオンスタイル仙台卸町店,8526,仙台,580,ぬ,2019/8/1 13:39,2-1_all_corrected,59,44,265,113,324,157
146290,30110_20190801195023.jpg,イオン金沢八景,4802,横浜,303,つ,2019/8/1 19:49,2-1_all_corrected,37,29,370,71,407,100
145272,30111_20190801103246.jpg,イオン稲毛,**21,千葉,580,り,2019/8/1 10:32,2-1_all_corrected,42,33,74,90,116,123
146093,30111_20190801181636.jpg,イオン稲毛,*212,千葉,342,な,2019/8/1 18:16,2-1_all_corrected,58,44,343,158,401,202
145820,30078_20190801153956.jpg,イオンスタイル仙台卸町店,*111,宮城,320,さ,2019/8/1 15:39,2-1_all_corrected,80,64,123,246,203,310
146209,30068_20190801191359.jpg,ケーヨーデイツー唐木田,8044,多摩,302,ゆ,2019/8/1 19:12,2-1_all_corrected,68,55,261,158,329,213
146004,30045_20190801173539.jpg,マックスバリュー徳川明倫,*358,名古屋,32,と,2019/8/1 17:35,2-1_all_corrected,84,60,185,247,269,307
145686,30078_20190801142126.jpg,イオンスタイル仙台卸町店,6152,仙台,580,に,2019/8/1 14:21,2-1_all_corrected,70,55,247,153,317,208
145449,30045_20190801120541.jpg,マックスバリュー徳川明倫,**23,名古屋,31,み,2019/8/1 12:04,2-1_all_corrected,55,47,229,141,284,188
145644,30078_20190801135420.jpg,イオンスタイル仙台卸町店,9818,仙台,300,め,2019/8/1 13:53,2-1_all_corrected,58,44,343,84,401,128
145476,30160_20190801122000.jpg,マックスバリュ米野木店（平面）,*358,名古屋,31,ほ,2019/8/1 12:19,2-1_all_corrected,69,54,213,224,282,278
146200,30110_20190801191024.jpg,イオン金沢八景,*612,つくば,333,ひ,2019/8/1 19:09,2-1_all_corrected,73,58,382,184,455,242
146066,30079_20190801180235.jpg,ピットデザイン仙台卸町駅前駐車場,7445,宮城,51,う,2019/8/1 18:01,2-1_all_corrected,54,41,405,168,459,209
145287,30120_20190801104108.jpg,イオン長浦（第１・第２）,*845,大分,501,す,2019/8/1 10:40,2-1_all_corrected,68,59,286,244,354,303
145274,30038_20190801103345.jpg,ザ・ダイソー東大和,8883,多摩,100,い,2019/8/1 10:33,2-1_all_corrected,47,46,435,164,482,210
145245,30063_20190801102051.jpg,コーナン相模原小山モール,***3,多摩,30,ゆ,2019/8/1 10:19,2-1_all_corrected,61,62,1,160,62,222
146262,30111_20190801193535.jpg,イオン稲毛,6667,千葉,503,て,2019/8/1 19:35,2-1_all_corrected,53,45,175,132,228,177
157166,30169_20190806194041.jpg,イオン相模原ショッピングセンター,***5,多摩,30,な,2019/8/6 19:40,2-1_all_corrected,79,55,164,22,243,77
157192,30169_20190806195058.jpg,イオン相模原ショッピングセンター,8888,相模,342,ひ,2019/8/6 19:50,2-1_all_corrected,87,64,185,71,272,135
155890,30001_20190806103721.jpg,関西スーパー高石駅前,4066,和泉,580,め,2019/8/6 10:37,2-1_all_corrected,55,42,439,23,494,65
156886,30169_20190806173924.jpg,イオン相模原ショッピングセンター,8490,相模,580,め,2019/8/6 17:38,2-1_all_corrected,89,70,252,295,341,365
157594,30111_20190806224736.jpg,イオン稲毛,6952,習志野,580,そ,2019/8/6 22:47,2-1_all_corrected,68,55,178,162,246,217
156673,30072_20190806161810.jpg,関西スーパー京阪大和田１F,1010,大阪,578,の,2019/8/6 16:17,2-1_all_corrected,58,44,94,141,152,185
156013,30111_20190806112730.jpg,イオン稲毛,9845,千葉,302,す,2019/8/6 11:27,2-1_all_corrected,72,58,290,209,362,267
156817,30111_20190806172251.jpg,イオン稲毛,3605,袖ヶ浦,100,さ,2019/8/6 17:22,2-1_all_corrected,53,42,237,144,290,186
157132,30111_20190806192417.jpg,イオン稲毛,1621,千葉,530,き,2019/8/6 19:23,2-1_all_corrected,45,34,61,89,106,123
157151,30045_20190806193132.jpg,マックスバリュー徳川明倫,**33,名古屋,31,も,2019/8/6 19:31,2-1_all_corrected,87,71,84,325,171,396
155862,30157_20190806102305.jpg,関西スーパー中央,2795,神戸,51,ふ,2019/8/6 10:22,2-1_all_corrected,46,72,304,285,350,357
156079,30110_20190806115550.jpg,イオン金沢八景,5345,横浜,580,は,2019/8/6 11:54,2-1_all_corrected,80,56,229,231,309,287
157193,30050_20190806195407.jpg,スエヒロ館扇,***8,練馬,30,は,2019/8/6 19:53,2-1_all_corrected,72,56,93,368,165,424
156889,30110_20190806174001.jpg,イオン金沢八景,1103,横浜,31,に,2019/8/6 17:39,2-1_all_corrected,54,45,186,90,240,135
156397,30110_20190806141005.jpg,イオン金沢八景,9029,横浜,304,に,2019/8/6 14:09,2-1_all_corrected,69,60,15,212,84,272
156151,30111_20190806122308.jpg,イオン稲毛,*308,千葉,337,ね,2019/8/6 12:22,2-1_all_corrected,59,44,379,165,438,209
157084,30078_20190806190403.jpg,イオンスタイル仙台卸町店,5945,宮城,580,ふ,2019/8/6 19:03,2-1_all_corrected,82,62,233,210,315,272
156700,30111_20190806162926.jpg,イオン稲毛,*221,千葉,336,ま,2019/8/6 16:29,2-1_all_corrected,68,52,329,132,397,184
156390,30063_20190806140742.jpg,コーナン相模原小山モール,***7,横浜,30,は,2019/8/6 14:07,2-1_all_corrected,80,63,125,189,205,252
156399,30111_20190806141057.jpg,イオン稲毛,7661,千葉,381,つ,2019/8/6 14:10,2-1_all_corrected,41,31,30,76,71,107
157041,30111_20190806184402.jpg,イオン稲毛,3905,千葉,7,ゆ,2019/8/6 18:43,2-1_all_corrected,46,35,63,91,109,126
156990,30110_20190806182417.jpg,イオン金沢八景,1203,横浜,364,た,2019/8/6 18:23,2-1_all_corrected,39,39,55,94,94,133
155742,30160_20190806090310.jpg,マックスバリュ米野木店（平面）,*518,名古屋,480,い,2019/8/6 9:02,2-1_all_corrected,50,41,305,159,355,200
156339,30078_20190806134200.jpg,イオンスタイル仙台卸町店,*764,仙台,501,わ,2019/8/6 13:41,2-1_all_corrected,60,45,271,94,331,139
156102,30046_20190806120343.jpg,マミーマート船橋日大[地上],1661,習志野,580,け,2019/8/6 12:03,2-1_all_corrected,79,64,100,328,179,392
157440,30169_20190806213524.jpg,イオン相模原ショッピングセンター,**33,相模,367,ぬ,2019/8/6 21:34,2-1_all_corrected,71,66,409,266,480,332
157047,30169_20190806184613.jpg,イオン相模原ショッピングセンター,1626,相模,531,せ,2019/8/6 18:45,2-1_all_corrected,83,71,402,289,485,360
156996,30111_20190806182614.jpg,イオン稲毛,3110,千葉,341,ほ,2019/8/6 18:25,2-1_all_corrected,38,29,34,63,72,92
155726,30072_20190806085113.jpg,関西スーパー京阪大和田１F,*762,京都,800,せ,2019/8/6 8:50,2-1_all_corrected,68,63,415,220,483,283
157082,30111_20190806190225.jpg,イオン稲毛,*538,千葉,301,ろ,2019/8/6 19:02,2-1_all_corrected,73,64,382,277,455,341
156953,30169_20190806180717.jpg,イオン相模原ショッピングセンター,5131,多摩,530,つ,2019/8/6 18:06,2-1_all_corrected,74,59,246,167,320,226
157217,30110_20190806200416.jpg,イオン金沢八景,8888,浜松,353,は,2019/8/6 20:03,2-1_all_corrected,77,72,4,232,81,304
156135,30110_20190806121600.jpg,イオン金沢八景,1847,横浜,505,に,2019/8/6 12:15,2-1_all_corrected,77,60,416,191,493,251
156556,30072_20190806152832.jpg,関西スーパー京阪大和田１F,8867,なにわ,830,あ,2019/8/6 15:27,2-1_all_corrected,73,60,121,153,194,213
156573,30006_20190806153903.jpg,スギ薬局南千里,5567,神戸,502,ら,2019/8/6 15:38,2-1_all_corrected,131,118,114,125,245,243
157235,30078_20190806201932.jpg,イオンスタイル仙台卸町店,1122,仙台,347,む,2019/8/6 20:19,2-1_all_corrected,90,68,155,321,245,389
157007,30169_20190806182914.jpg,イオン相模原ショッピングセンター,8375,多摩,330,て,2019/8/6 18:28,2-1_all_corrected,84,84,468,302,552,386
156121,30111_20190806121141.jpg,イオン稲毛,*620,千葉,502,も,2019/8/6 12:11,2-1_all_corrected,69,55,237,187,306,242
155951,30103_20190806110349.jpg,八尾老原１丁目,**11,大阪,31,り,2019/8/6 11:03,2-1_all_corrected,76,60,140,230,216,290
157053,30001_20190806184751.jpg,関西スーパー高石駅前,5302,堺,581,て,2019/8/6 18:47,2-1_all_corrected,52,38,432,6,484,44
156175,30111_20190806123028.jpg,イオン稲毛,2239,千葉,330,ま,2019/8/6 12:30,2-1_all_corrected,58,41,337,153,395,194
156940,30169_20190806180043.jpg,イオン相模原ショッピングセンター,3330,相模,430,た,2019/8/6 18:00,2-1_all_corrected,93,69,263,271,356,340
156143,30078_20190806121941.jpg,イオンスタイル仙台卸町店,7583,仙台,530,た,2019/8/6 12:19,2-1_all_corrected,57,45,301,91,358,136
156543,30078_20190806151925.jpg,イオンスタイル仙台卸町店,4490,福島,581,う,2019/8/6 15:18,2-1_all_corrected,59,43,267,85,326,128
155903,30169_20190806104240.jpg,イオン相模原ショッピングセンター,4171,多摩,503,ひ,2019/8/6 10:42,2-1_all_corrected,73,51,329,145,402,196
156575,30062_20190806153937.jpg,ミスミモール,*123,神戸,31,ぬ,2019/8/6 15:39,2-1_all_corrected,47,39,439,107,486,146
157064,30072_20190806185441.jpg,関西スーパー京阪大和田１F,**29,大阪,339,ほ,2019/8/6 18:53,2-1_all_corrected,108,87,72,323,180,410
157099,30169_20190806191011.jpg,イオン相模原ショッピングセンター,5551,相模,500,む,2019/8/6 19:09,2-1_all_corrected,88,72,373,314,461,386
156722,30045_20190806164135.jpg,マックスバリュー徳川明倫,**17,名古屋,31,り,2019/8/6 16:40,2-1_all_corrected,49,38,250,107,299,145
156657,30110_20190806161159.jpg,イオン金沢八景,3118,横浜,505,て,2019/8/6 16:11,2-1_all_corrected,45,34,384,33,429,67
156833,30078_20190806172633.jpg,イオンスタイル仙台卸町店,*263,仙台,500,ろ,2019/8/6 17:26,2-1_all_corrected,81,70,151,245,232,315
156498,30111_20190806145634.jpg,イオン稲毛,4362,千葉,500,ち,2019/8/6 14:56,2-1_all_corrected,45,36,79,106,124,142
156409,30110_20190806141442.jpg,イオン金沢八景,3593,横浜,580,つ,2019/8/6 14:13,2-1_all_corrected,53,44,148,206,201,250
155882,30045_20190806103343.jpg,マックスバリュー徳川明倫,8008,名古屋,31,さ,2019/8/6 10:32,2-1_all_corrected,51,41,256,115,307,156
156052,30111_20190806114510.jpg,イオン稲毛,*101,千葉,586,め,2019/8/6 11:44,2-1_all_corrected,46,36,40,97,86,133
156267,30111_20190806131051.jpg,イオン稲毛,*632,千葉,581,い,2019/8/6 13:10,2-1_all_corrected,67,57,162,178,229,235
157322,30169_20190806211406.jpg,イオン相模原ショッピングセンター,*375,相模,580,る,2019/8/6 21:13,2-1_all_corrected,52,41,119,103,171,144
156259,30062_20190806130528.jpg,ミスミモール,***3,神戸,30,ほ,2019/8/6 13:04,2-1_all_corrected,53,40,352,92,405,132
156602,30066_20190806154946.jpg,ジョーシン和泉中央,***3,和泉,30,つ,2019/8/6 15:48,2-1_all_corrected,54,45,262,175,316,220
156266,30111_20190806131021.jpg,イオン稲毛,*773,柏,583,る,2019/8/6 13:09,2-1_all_corrected,70,59,213,179,283,238
156408,30001_20190806141418.jpg,関西スーパー高石駅前,***8,和泉,30,ら,2019/8/6 14:13,2-1_all_corrected,73,55,322,80,395,135
157175,30063_20190806194309.jpg,コーナン相模原小山モール,**18,横浜,31,み,2019/8/6 19:42,2-1_all_corrected,75,55,233,253,308,308
157371,30078_20190806212617.jpg,イオンスタイル仙台卸町店,***9,仙台,585,を,2019/8/6 21:25,2-1_all_corrected,92,66,169,302,261,368
156684,30001_20190806162219.jpg,関西スーパー高石駅前,***8,和泉,30,ね,2019/8/6 16:22,2-1_all_corrected,71,53,417,67,488,120
156028,30110_20190806113613.jpg,イオン金沢八景,8186,横浜,304,ふ,2019/8/6 11:35,2-1_all_corrected,90,65,240,202,330,267
157599,30110_20190806225405.jpg,イオン金沢八景,4218,品川,480,け,2019/8/6 22:53,2-1_all_corrected,74,60,312,271,386,331
156474,30110_20190806144224.jpg,イオン金沢八景,5747,横浜,530,ち,2019/8/6 14:41,2-1_all_corrected,47,31,430,66,477,97
157196,30072_20190806195552.jpg,関西スーパー京阪大和田１F,3399,大阪,583,こ,2019/8/6 19:55,2-1_all_corrected,41,33,167,89,208,122
157165,30169_20190806194023.jpg,イオン相模原ショッピングセンター,*403,相模,530,ま,2019/8/6 19:39,2-1_all_corrected,90,78,403,331,493,409
156081,30054_20190806115604.jpg,ナショナルスーパー麻布,**18,品川,31,は,2019/8/6 11:55,2-1_all_corrected,89,75,13,374,102,449
156411,30045_20190806141531.jpg,マックスバリュー徳川明倫,**77,名古屋,31,ほ,2019/8/6 14:14,2-1_all_corrected,40,30,232,27,272,57
155851,30072_20190806101931.jpg,関西スーパー京阪大和田１F,4444,大阪,373,す,2019/8/6 10:18,2-1_all_corrected,90,80,80,358,170,438
156885,30139_20190806173906.jpg,イオン板橋ショッピングセンター,***1,練馬,30,ね,2019/8/6 17:38,2-1_all_corrected,51,43,276,171,327,214
157359,30041_20190806212421.jpg,ライフ宮内,5282,川崎,580,す,2019/8/6 21:23,2-1_all_corrected,72,54,430,295,502,349
157598,30110_20190806225331.jpg,イオン金沢八景,4218,品川,480,け,2019/8/6 22:52,2-1_all_corrected,47,36,313,123,360,159
156815,30111_20190806172224.jpg,イオン稲毛,1130,千葉,546,ま,2019/8/6 17:21,2-1_all_corrected,71,54,301,187,372,241
157139,30072_20190806192628.jpg,関西スーパー京阪大和田１F,*858,神戸,504,ぬ,2019/8/6 19:25,2-1_all_corrected,71,57,249,152,320,209
156676,30072_20190806161928.jpg,関西スーパー京阪大和田１F,4429,なにわ,400,ま,2019/8/6 16:18,2-1_all_corrected,54,42,177,144,231,186
157106,30104_20190806191306.jpg,カスミフードスクエア咲が丘,5517,習志野,330,と,2019/8/6 19:12,2-1_all_corrected,69,57,223,175,292,232
156488,30001_20190806145120.jpg,関西スーパー高石駅前,7015,和泉,502,に,2019/8/6 14:50,2-1_all_corrected,58,43,475,29,533,72
156671,30072_20190806161613.jpg,関西スーパー京阪大和田１F,2251,大阪,101,あ,2019/8/6 16:15,2-1_all_corrected,67,62,192,181,259,243
156283,30072_20190806132144.jpg,関西スーパー京阪大和田１F,5577,大阪,530,あ,2019/8/6 13:21,2-1_all_corrected,45,36,390,55,435,91
155746,30086_20190806090833.jpg,テックランド大阪りんくう,**11,和泉,31,ゆ,2019/8/6 9:07,2-1_all_corrected,69,51,376,262,445,313
156759,30072_20190806165818.jpg,関西スーパー京阪大和田１F,6185,大阪,302,に,2019/8/6 16:57,2-1_all_corrected,59,42,215,151,274,193
155741,30045_20190806090228.jpg,マックスバリュー徳川明倫,**77,名古屋,31,ほ,2019/8/6 9:01,2-1_all_corrected,71,57,245,213,316,270
156766,30014_20190806170043.jpg,フォルテ蘇我ベルク棟,***3,千葉,30,ね,2019/8/6 17:00,2-1_all_corrected,47,47,54,36,101,83
156596,30070_20190806154806.jpg,カナートモール住道第一,8888,大阪,30,て,2019/8/6 15:47,2-1_all_corrected,55,44,246,130,301,174
155985,30111_20190806111544.jpg,イオン稲毛,9671,千葉,583,さ,2019/8/6 11:15,2-1_all_corrected,60,43,326,160,386,203
157080,30110_20190806190126.jpg,イオン金沢八景,4051,横浜,303,さ,2019/8/6 19:00,2-1_all_corrected,37,28,314,79,351,107
156769,30169_20190806170211.jpg,イオン相模原ショッピングセンター,*619,堺,532,に,2019/8/6 17:01,2-1_all_corrected,73,64,363,181,436,245
157214,30169_20190806200241.jpg,イオン相模原ショッピングセンター,8453,相模,502,と,2019/8/6 20:02,2-1_all_corrected,80,53,435,126,515,179
157026,30078_20190806183807.jpg,イオンスタイル仙台卸町店,1122,仙台,347,む,2019/8/6 18:37,2-1_all_corrected,58,43,275,172,333,215
156303,30110_20190806133124.jpg,イオン金沢八景,9276,横浜,400,ひ,2019/8/6 13:30,2-1_all_corrected,67,60,2,167,69,227
157474,30104_20190806214859.jpg,カスミフードスクエア咲が丘,*214,習志野,585,い,2019/8/6 21:48,2-1_all_corrected,73,62,501,311,574,373
155946,30111_20190806110243.jpg,イオン稲毛,4473,千葉,500,て,2019/8/6 11:02,2-1_all_corrected,45,33,67,86,112,119
156959,30111_20190806181117.jpg,イオン稲毛,7129,千葉,530,そ,2019/8/6 18:10,2-1_all_corrected,54,47,206,154,260,201
156191,30001_20190806123931.jpg,関西スーパー高石駅前,8890,和泉,502,つ,2019/8/6 12:39,2-1_all_corrected,93,66,245,230,338,296
157247,30078_20190806202412.jpg,イオンスタイル仙台卸町店,6000,仙台,332,の,2019/8/6 20:23,2-1_all_corrected,95,66,254,334,349,400
157075,30078_20190806190021.jpg,イオンスタイル仙台卸町店,***7,仙台,324,な,2019/8/6 18:59,2-1_all_corrected,89,64,222,274,311,338
155722,30052_20190806084625.jpg,西友市ヶ尾,***5,横浜,30,み,2019/8/6 8:46,2-1_all_corrected,68,54,326,242,394,296
156508,30143_20190806150049.jpg,イオン久里浜,9847,横浜,330,に,2019/8/6 15:00,2-1_all_corrected,52,41,410,164,462,205
157240,30079_20190806202114.jpg,ピットデザイン仙台卸町駅前駐車場,8672,仙台,530,ち,2019/8/6 20:20,2-1_all_corrected,75,69,252,301,327,370
156702,30078_20190806162927.jpg,イオンスタイル仙台卸町店,4769,仙台,480,り,2019/8/6 16:29,2-1_all_corrected,58,41,304,151,362,192
156727,30110_20190806164418.jpg,イオン金沢八景,9992,横浜,330,ぬ,2019/8/6 16:43,2-1_all_corrected,48,42,15,105,63,147
157601,30110_20190806225515.jpg,イオン金沢八景,4218,品川,480,け,2019/8/6 22:54,2-1_all_corrected,54,45,323,155,377,200
155963,30006_20190806110838.jpg,スギ薬局南千里,*488,大阪,330,て,2019/8/6 11:08,2-1_all_corrected,96,59,497,65,593,124
156386,30110_20190806140455.jpg,イオン金沢八景,9397,横浜,530,そ,2019/8/6 14:04,2-1_all_corrected,74,59,411,166,485,225
156988,30110_20190806182335.jpg,イオン金沢八景,*174,横浜,580,ゆ,2019/8/6 18:22,2-1_all_corrected,42,30,144,20,186,50
157093,30098_20190806190745.jpg,BRANCH仙台（東棟）,*182,仙台,500,ろ,2019/8/6 19:06,2-1_all_corrected,87,64,391,275,478,339
156989,30110_20190806182341.jpg,イオン金沢八景,*302,横浜,534,と,2019/8/6 18:23,2-1_all_corrected,43,30,147,44,190,74
156389,30169_20190806140627.jpg,イオン相模原ショッピングセンター,***3,相模,376,り,2019/8/6 14:06,2-1_all_corrected,64,35,160,176,224,211
155954,30062_20190806110433.jpg,ミスミモール,*111,神戸,30,て,2019/8/6 11:03,2-1_all_corrected,48,34,467,86,515,120
157600,30110_20190806225440.jpg,イオン金沢八景,4218,品川,480,け,2019/8/6 22:53,2-1_all_corrected,79,58,208,239,287,297
156170,30144_20190806122829.jpg,イオン幕張,*222,習志野,587,り,2019/8/6 12:27,2-1_all_corrected,45,38,257,176,302,214
157607,30110_20190806225942.jpg,イオン金沢八景,4218,品川,480,け,2019/8/6 22:59,2-1_all_corrected,69,56,370,212,439,268
156578,30078_20190806154042.jpg,イオンスタイル仙台卸町店,*416,仙台,583,え,2019/8/6 15:40,2-1_all_corrected,76,57,283,183,359,240
156786,30169_20190806170952.jpg,イオン相模原ショッピングセンター,6006,多摩,531,つ,2019/8/6 17:09,2-1_all_corrected,67,53,185,135,252,188
156897,30072_20190806174303.jpg,関西スーパー京阪大和田１F,5296,大阪,586,て,2019/8/6 17:42,2-1_all_corrected,72,58,93,132,165,190
156069,30110_20190806114947.jpg,イオン金沢八景,*812,横浜,349,ほ,2019/8/6 11:48,2-1_all_corrected,44,36,441,54,485,90
157184,30045_20190806194658.jpg,マックスバリュー徳川明倫,***3,名古屋,30,る,2019/8/6 19:46,2-1_all_corrected,72,64,29,281,101,345
157345,30105_20190806211943.jpg,カスミフードスクエア春日部武里,8888,春日部,335,つ,2019/8/6 21:18,2-1_all_corrected,73,61,153,284,226,345
156899,30060_20190806174359.jpg,関西スーパー小野原,6435,大阪,302,み,2019/8/6 17:43,2-1_all_corrected,68,54,385,213,453,267
156806,30045_20190806171839.jpg,マックスバリュー徳川明倫,1001,名古屋,31,ひ,2019/8/6 17:17,2-1_all_corrected,50,39,265,118,315,157
156808,30111_20190806171941.jpg,イオン稲毛,1123,千葉,551,す,2019/8/6 17:19,2-1_all_corrected,54,46,218,164,272,210
156691,30078_20190806162428.jpg,イオンスタイル仙台卸町店,*106,宮城,581,こ,2019/8/6 16:24,2-1_all_corrected,77,54,259,189,336,243
156068,30078_20190806114842.jpg,イオンスタイル仙台卸町店,7583,仙台,530,た,2019/8/6 11:48,2-1_all_corrected,59,44,244,181,303,225
157178,30110_20190806194356.jpg,イオン金沢八景,*612,つくば,333,ひ,2019/8/6 19:43,2-1_all_corrected,68,58,432,205,500,263
157114,30159_20190806191511.jpg,イオン臼井,4708,千葉,502,と,2019/8/6 19:14,2-1_all_corrected,55,43,258,193,313,236
155829,30066_20190806100653.jpg,ジョーシン和泉中央,8008,和泉,31,ひ,2019/8/6 10:06,2-1_all_corrected,54,42,213,184,267,226
156809,30111_20190806172001.jpg,イオン稲毛,7102,千葉,330,ひ,2019/8/6 17:19,2-1_all_corrected,56,44,361,144,417,188
169803,30167_20190813192523.jpg,イオン東雲店,**31,品川,345,せ,2019/8/13 19:24,2-1_all_corrected,55,45,415,327,470,372
169464,30090_20190813165246.jpg,イトーヨーカドー木場 西棟,1122,足立,386,た,2019/8/13 16:52,2-1_all_corrected,76,56,253,255,329,311
169490,30144_20190813170747.jpg,イオン幕張,5544,千葉,503,た,2019/8/13 17:07,2-1_all_corrected,58,40,221,139,279,179
168748,30001_20190813112324.jpg,関西スーパー高石駅前,*926,和泉,533,は,2019/8/13 11:23,2-1_all_corrected,69,53,325,85,394,138
169463,30110_20190813165244.jpg,イオン金沢八景,*753,横浜,347,ひ,2019/8/13 16:52,2-1_all_corrected,80,69,184,176,264,245
169031,30169_20190813132716.jpg,イオン相模原ショッピングセンター,*405,多摩,583,も,2019/8/13 13:26,2-1_all_corrected,69,57,250,175,319,232
168587,30091_20190813100515.jpg,イトーヨーカドー木場 立体,8798,つくば,300,ね,2019/8/13 10:04,2-1_all_corrected,55,45,166,153,221,198
169694,30169_20190813183704.jpg,イオン相模原ショッピングセンター,1533,多摩,503,み,2019/8/13 18:36,2-1_all_corrected,87,79,435,330,522,409
169096,30157_20190813135531.jpg,関西スーパー中央,7270,神戸,503,に,2019/8/13 13:55,2-1_all_corrected,41,69,456,195,497,264
169895,30098_20190813202912.jpg,BRANCH仙台（東棟）,*211,仙台,333,ぬ,2019/8/13 20:28,2-1_all_corrected,103,72,222,311,325,383
169098,30144_20190813135750.jpg,イオン幕張,3471,千葉,330,に,2019/8/13 13:57,2-1_all_corrected,57,38,187,143,244,181
169850,30169_20190813195231.jpg,イオン相模原ショッピングセンター,9322,所沢,530,ち,2019/8/13 19:52,2-1_all_corrected,91,73,423,368,514,441
169008,30072_20190813131249.jpg,関西スーパー京阪大和田１F,**11,大阪,31,ま,2019/8/13 13:12,2-1_all_corrected,70,51,124,99,194,150
168581,30045_20190813100147.jpg,マックスバリュー徳川明倫,8008,名古屋,31,さ,2019/8/13 10:01,2-1_all_corrected,42,36,303,94,345,130
169833,30045_20190813194015.jpg,マックスバリュー徳川明倫,1001,名古屋,31,ほ,2019/8/13 19:39,2-1_all_corrected,71,57,176,155,247,212
169692,30094_20190813183644.jpg,西友熱田三番町店,8118,名古屋,388,め,2019/8/13 18:35,2-1_all_corrected,57,45,227,242,284,287
169006,30144_20190813131223.jpg,イオン幕張,8483,長岡,580,は,2019/8/13 13:12,2-1_all_corrected,47,43,93,188,140,231
168776,30144_20190813113827.jpg,イオン幕張,***5,多摩,30,な,2019/8/13 11:38,2-1_all_corrected,48,35,170,105,218,140
169233,30110_20190813151227.jpg,イオン金沢八景,*500,横浜,360,ふ,2019/8/13 15:11,2-1_all_corrected,70,84,500,212,570,296
169465,30106_20190813165250.jpg,ジョーシン東大阪長田,1122,大阪,31,は,2019/8/13 16:52,2-1_all_corrected,57,42,164,117,221,159
169603,30078_20190813180444.jpg,イオンスタイル仙台卸町店,4423,足立,580,こ,2019/8/13 18:04,2-1_all_corrected,75,52,208,121,283,173
168528,30111_20190813091139.jpg,イオン稲毛,1020,千葉,483,む,2019/8/13 9:11,2-1_all_corrected,53,42,361,149,414,191
169436,30090_20190813163735.jpg,イトーヨーカドー木場 西棟,7227,足立,332,つ,2019/8/13 16:37,2-1_all_corrected,51,35,247,160,298,195
168948,30072_20190813124621.jpg,関西スーパー京阪大和田１F,7594,大阪,302,む,2019/8/13 12:45,2-1_all_corrected,69,56,370,120,439,176
168526,30111_20190813090911.jpg,イオン稲毛,1020,千葉,589,ね,2019/8/13 9:08,2-1_all_corrected,74,61,225,229,299,290
168834,30068_20190813115912.jpg,ケーヨーデイツー唐木田,6271,多摩,11,ら,2019/8/13 11:58,2-1_all_corrected,70,57,246,203,316,260
168695,30167_20190813105943.jpg,イオン東雲店,5893,群馬,301,つ,2019/8/13 10:59,2-1_all_corrected,50,35,343,125,393,160
168661,30110_20190813103721.jpg,イオン金沢八景,4620,横浜,304,ね,2019/8/13 10:37,2-1_all_corrected,50,47,42,181,92,228
169915,30137_20190813203957.jpg,イオンスタイル品川シーサイド,5858,品川,532,た,2019/8/13 20:39,2-1_all_corrected,95,55,397,395,492,450
168692,30144_20190813105703.jpg,イオン幕張,*830,千葉,543,の,2019/8/13 10:56,2-1_all_corrected,53,40,230,104,283,144
169120,30157_20190813141022.jpg,関西スーパー中央,1010,神戸,31,な,2019/8/13 14:09,2-1_all_corrected,68,55,228,317,296,372
169785,30169_20190813191823.jpg,イオン相模原ショッピングセンター,*110,相模,345,に,2019/8/13 19:17,2-1_all_corrected,42,42,203,94,245,136
168657,30045_20190813103515.jpg,マックスバリュー徳川明倫,*111,名古屋,30,ち,2019/8/13 10:34,2-1_all_corrected,49,39,261,139,310,178
169173,30039_20190813144317.jpg,イトーヨーカドー大井町,4171,品川,300,ろ,2019/8/13 14:42,2-1_all_corrected,64,68,110,180,174,248
168603,30072_20190813101029.jpg,関西スーパー京阪大和田１F,8572,なにわ,800,す,2019/8/13 10:07,2-1_all_corrected,81,69,0,303,81,372
168604,30072_20190813101056.jpg,関西スーパー京阪大和田１F,*563,京都,800,せ,2019/8/13 10:10,2-1_all_corrected,70,56,46,195,116,251
169722,30144_20190813184949.jpg,イオン幕張,3718,千葉,331,す,2019/8/13 18:49,2-1_all_corrected,92,68,411,380,503,448
169983,30039_20190813214122.jpg,イトーヨーカドー大井町,*329,品川,337,た,2019/8/13 21:40,2-1_all_corrected,69,58,222,148,291,206
168656,30001_20190813103504.jpg,関西スーパー高石駅前,9515,京都,301,ね,2019/8/13 10:34,2-1_all_corrected,78,55,438,115,516,170
169712,30072_20190813184226.jpg,関西スーパー京阪大和田１F,2323,大阪,583,ち,2019/8/13 18:41,2-1_all_corrected,80,65,1,226,81,291
168892,30045_20190813122313.jpg,マックスバリュー徳川明倫,*358,名古屋,32,と,2019/8/13 12:22,2-1_all_corrected,54,41,334,126,388,167
169516,30144_20190813172057.jpg,イオン幕張,3108,千葉,331,な,2019/8/13 17:20,2-1_all_corrected,52,35,156,102,208,137
169985,30168_20190813214337.jpg,イオン東雲店（屋上）,*888,足立,346,ま,2019/8/13 21:43,2-1_all_corrected,73,55,325,140,398,195
168844,30167_20190813120110.jpg,イオン東雲店,6298,品川,58,り,2019/8/13 12:00,2-1_all_corrected,46,30,273,253,319,283
169505,30085_20190813171649.jpg,業務スーパー南津守,***5,なにわ,30,の,2019/8/13 17:16,2-1_all_corrected,43,29,334,173,377,202
169502,30144_20190813171212.jpg,イオン幕張,***1,千葉,595,う,2019/8/13 17:11,2-1_all_corrected,57,36,220,152,277,188
169132,30167_20190813142232.jpg,イオン東雲店,*119,品川,333,の,2019/8/13 14:22,2-1_all_corrected,54,44,440,322,494,366
169797,30144_20190813192248.jpg,イオン幕張,3567,千葉,503,す,2019/8/13 19:22,2-1_all_corrected,58,42,211,153,269,195
170027,30091_20190813224856.jpg,イトーヨーカドー木場 立体,5000,横浜,370,ち,2019/8/13 22:48,2-1_all_corrected,79,60,165,251,244,311
169755,30167_20190813190836.jpg,イオン東雲店,1635,品川,583,う,2019/8/13 19:08,2-1_all_corrected,52,39,363,317,415,356
169900,30039_20190813203234.jpg,イトーヨーカドー大井町,*516,品川,532,の,2019/8/13 20:32,2-1_all_corrected,67,72,41,231,108,303
169390,30144_20190813161115.jpg,イオン幕張,6881,尾張小牧,502,ふ,2019/8/13 16:10,2-1_all_corrected,79,51,235,243,314,294
168626,30144_20190813102014.jpg,イオン幕張,3199,千葉,580,み,2019/8/13 10:19,2-1_all_corrected,55,40,198,144,253,184
168874,30167_20190813121252.jpg,イオン東雲店,1569,足立,580,ち,2019/8/13 12:12,2-1_all_corrected,70,56,398,349,468,405
168621,30060_20190813101800.jpg,関西スーパー小野原,3350,大阪,483,あ,2019/8/13 10:17,2-1_all_corrected,79,66,277,347,356,413
169561,30078_20190813174337.jpg,イオンスタイル仙台卸町店,1215,宮城,584,は,2019/8/13 17:43,2-1_all_corrected,55,41,276,80,331,121
168681,30144_20190813104933.jpg,イオン幕張,*321,袖ヶ浦,587,え,2019/8/13 10:49,2-1_all_corrected,54,43,173,136,227,179
169595,30078_20190813175926.jpg,イオンスタイル仙台卸町店,4758,山形,500,み,2019/8/13 17:59,2-1_all_corrected,64,60,149,70,213,130
169592,30169_20190813175821.jpg,イオン相模原ショッピングセンター,***1,相模,803,と,2019/8/13 17:57,2-1_all_corrected,89,66,125,282,214,348
169796,30105_20190813192207.jpg,カスミフードスクエア春日部武里,*827,春日部,533,な,2019/8/13 19:21,2-1_all_corrected,58,44,295,196,353,240
169908,30110_20190813203458.jpg,イオン金沢八景,*193,横浜,480,そ,2019/8/13 20:34,2-1_all_corrected,76,71,14,367,90,438
170026,30091_20190813224851.jpg,イトーヨーカドー木場 立体,5000,横浜,370,ち,2019/8/13 22:48,2-1_all_corrected,82,67,93,302,175,369
169557,30144_20190813174152.jpg,イオン幕張,1120,千葉,535,と,2019/8/13 17:41,2-1_all_corrected,44,44,89,185,133,229
169301,30110_20190813154514.jpg,イオン金沢八景,*100,大宮,432,な,2019/8/13 15:44,2-1_all_corrected,66,65,27,189,93,254
169568,30091_20190813174753.jpg,イトーヨーカドー木場 立体,3968,足立,57,ろ,2019/8/13 17:47,2-1_all_corrected,67,57,297,130,364,187
168990,30167_20190813130653.jpg,イオン東雲店,1133,練馬,580,け,2019/8/13 13:06,2-1_all_corrected,42,35,212,209,254,244
169617,30144_20190813181039.jpg,イオン幕張,4354,習志野,501,ゆ,2019/8/13 18:10,2-1_all_corrected,62,44,259,165,321,209
168997,30169_20190813130902.jpg,イオン相模原ショッピングセンター,2455,八王子,501,ふ,2019/8/13 13:08,2-1_all_corrected,55,42,189,125,244,167
169873,30144_20190813201241.jpg,イオン幕張,*358,習志野,430,ひ,2019/8/13 20:12,2-1_all_corrected,62,43,181,197,243,240
169874,30157_20190813201256.jpg,関西スーパー中央,8080,なにわ,584,の,2019/8/13 20:12,2-1_all_corrected,45,65,460,181,505,246
169083,30066_20190813135054.jpg,ジョーシン和泉中央,***3,和泉,30,せ,2019/8/13 13:50,2-1_all_corrected,71,55,193,233,264,288
169413,30111_20190813162230.jpg,イオン稲毛,**28,千葉,339,ち,2019/8/13 16:22,2-1_all_corrected,58,44,362,129,420,173
169077,30144_20190813134656.jpg,イオン幕張,6168,千葉,330,な,2019/8/13 13:46,2-1_all_corrected,62,43,198,202,260,245
169023,30045_20190813132115.jpg,マックスバリュー徳川明倫,**33,名古屋,31,も,2019/8/13 13:20,2-1_all_corrected,54,44,244,204,298,248
169211,30144_20190813150224.jpg,イオン幕張,4444,土浦,337,り,2019/8/13 15:01,2-1_all_corrected,55,39,202,140,257,179
168798,30169_20190813114636.jpg,イオン相模原ショッピングセンター,1446,相模,530,な,2019/8/13 11:46,2-1_all_corrected,45,37,291,150,336,187
169672,30078_20190813182530.jpg,イオンスタイル仙台卸町店,7245,仙台,580,の,2019/8/13 18:25,2-1_all_corrected,73,59,176,169,249,228
169686,30078_20190813183510.jpg,イオンスタイル仙台卸町店,*429,仙台,331,と,2019/8/13 18:34,2-1_all_corrected,85,61,215,242,300,303
169220,30144_20190813150625.jpg,イオン幕張,*629,千葉,533,な,2019/8/13 15:05,2-1_all_corrected,71,50,227,213,298,263
169811,30169_20190813192855.jpg,イオン相模原ショッピングセンター,1212,多摩,341,は,2019/8/13 19:28,2-1_all_corrected,71,56,368,159,439,215
168765,30105_20190813113257.jpg,カスミフードスクエア春日部武里,3311,野田,480,い,2019/8/13 11:32,2-1_all_corrected,52,39,144,163,196,202
169829,30169_20190813193851.jpg,イオン相模原ショッピングセンター,**17,練馬,536,そ,2019/8/13 19:38,2-1_all_corrected,50,45,207,102,257,147
169049,30001_20190813133324.jpg,関西スーパー高石駅前,***8,和泉,30,ふ,2019/8/13 13:33,2-1_all_corrected,69,54,425,121,494,175
169618,30045_20190813181047.jpg,マックスバリュー徳川明倫,*358,名古屋,32,さ,2019/8/13 18:10,2-1_all_corrected,81,68,35,340,116,408
168708,30060_20190813110523.jpg,関西スーパー小野原,4835,大阪,581,ま,2019/8/13 11:05,2-1_all_corrected,90,63,280,387,370,450
169844,30169_20190813194819.jpg,イオン相模原ショッピングセンター,5277,相模,502,に,2019/8/13 19:47,2-1_all_corrected,91,72,364,317,455,389
169423,30144_20190813162846.jpg,イオン幕張,2594,習志野,301,む,2019/8/13 16:28,2-1_all_corrected,77,48,163,232,240,280
169470,30111_20190813165836.jpg,イオン稲毛,3605,袖ヶ浦,100,さ,2019/8/13 16:58,2-1_all_corrected,67,55,259,164,326,219
168931,30167_20190813124046.jpg,イオン東雲店,6724,足立,502,の,2019/8/13 12:40,2-1_all_corrected,80,59,210,253,290,312
169689,30045_20190813183545.jpg,マックスバリュー徳川明倫,***8,名古屋,30,め,2019/8/13 18:35,2-1_all_corrected,54,38,236,138,290,176
169645,30078_20190813181848.jpg,イオンスタイル仙台卸町店,**25,仙台,330,る,2019/8/13 18:18,2-1_all_corrected,86,61,352,349,438,410
169826,30132_20190813193752.jpg,イオンスタイル東神奈川,***8,横浜,30,に,2019/8/13 19:37,2-1_all_corrected,67,56,422,279,489,335
169446,30078_20190813164237.jpg,イオンスタイル仙台卸町店,6688,仙台,583,え,2019/8/13 16:42,2-1_all_corrected,82,57,244,249,326,306
168716,30062_20190813110916.jpg,ミスミモール,**18,神戸,31,ち,2019/8/13 11:08,2-1_all_corrected,55,45,333,139,388,184
169630,30144_20190813181503.jpg,イオン幕張,6384,千葉,330,せ,2019/8/13 18:14,2-1_all_corrected,58,44,169,143,227,187
169637,30090_20190813181659.jpg,イトーヨーカドー木場 西棟,9898,足立,330,も,2019/8/13 18:15,2-1_all_corrected,50,36,247,145,297,181
169433,30110_20190813163636.jpg,イオン金沢八景,*523,横浜,545,す,2019/8/13 16:36,2-1_all_corrected,53,42,363,78,416,120
168727,30072_20190813111325.jpg,関西スーパー京阪大和田１F,3366,大阪,500,い,2019/8/13 11:12,2-1_all_corrected,43,36,377,36,420,72
169291,30078_20190813153854.jpg,イオンスタイル仙台卸町店,**55,仙台,346,ち,2019/8/13 15:38,2-1_all_corrected,70,54,321,179,391,233
168972,30078_20190813125713.jpg,イオンスタイル仙台卸町店,8182,仙台,500,む,2019/8/13 12:56,2-1_all_corrected,56,45,212,83,268,128
169606,30167_20190813180625.jpg,イオン東雲店,*673,春日部,880,り,2019/8/13 18:06,2-1_all_corrected,44,40,134,198,178,238
169853,30062_20190813195549.jpg,ミスミモール,***3,神戸,30,ふ,2019/8/13 19:55,2-1_all_corrected,71,63,135,213,206,276
169494,30045_20190813170903.jpg,マックスバリュー徳川明倫,*358,名古屋,32,ひ,2019/8/13 17:08,2-1_all_corrected,71,61,116,302,187,363
169652,30072_20190813181941.jpg,関西スーパー京阪大和田１F,7829,大阪,581,け,2019/8/13 18:19,2-1_all_corrected,74,56,257,154,331,210
169458,30169_20190813165021.jpg,イオン相模原ショッピングセンター,8888,相模,306,も,2019/8/13 16:49,2-1_all_corrected,87,59,222,92,309,151
169231,30111_20190813151201.jpg,イオン稲毛,1655,千葉,301,ま,2019/8/13 15:11,2-1_all_corrected,57,45,346,141,403,186
169207,30062_20190813150013.jpg,ミスミモール,8008,神戸,31,み,2019/8/13 14:57,2-1_all_corrected,55,44,382,139,437,183
169831,30169_20190813193856.jpg,イオン相模原ショッピングセンター,**17,相模,536,そ,2019/8/13 19:38,2-1_all_corrected,75,66,429,280,504,346
169200,30110_20190813145400.jpg,イオン金沢八景,***3,横浜,30,ぬ,2019/8/13 14:53,2-1_all_corrected,70,61,132,173,202,234
169664,30144_20190813182354.jpg,イオン幕張,1979,千葉,331,ほ,2019/8/13 18:23,2-1_all_corrected,75,56,272,264,347,320
169435,30001_20190813163731.jpg,関西スーパー高石駅前,2024,大阪,400,み,2019/8/13 16:37,2-1_all_corrected,86,61,290,146,376,207
169852,30169_20190813195528.jpg,イオン相模原ショッピングセンター,9624,多摩,503,み,2019/8/13 19:55,2-1_all_corrected,89,76,429,330,518,406
168974,30072_20190813125801.jpg,関西スーパー京阪大和田１F,**11,大阪,31,ま,2019/8/13 12:57,2-1_all_corrected,69,57,271,239,340,296
169299,30062_20190813154326.jpg,ミスミモール,**18,神戸,31,ち,2019/8/13 15:41,2-1_all_corrected,50,39,412,122,462,161
169609,30078_20190813180745.jpg,イオンスタイル仙台卸町店,4527,仙台,580,と,2019/8/13 18:07,2-1_all_corrected,70,61,176,122,246,183
169631,30167_20190813181519.jpg,イオン東雲店,1192,足立,536,は,2019/8/13 18:14,2-1_all_corrected,46,36,261,212,307,248
169468,30144_20190813165706.jpg,イオン幕張,1988,千葉,584,き,2019/8/13 16:56,2-1_all_corrected,78,53,288,298,366,351
169457,30169_20190813165015.jpg,イオン相模原ショッピングセンター,8888,相模,306,も,2019/8/13 16:49,2-1_all_corrected,61,41,140,9,201,50
168743,30110_20190813111954.jpg,イオン金沢八景,1617,横浜,533,み,2019/8/13 11:19,2-1_all_corrected,93,70,29,380,122,450
168549,30078_20190813093205.jpg,イオンスタイル仙台卸町店,2023,仙台,330,に,2019/8/13 9:31,2-1_all_corrected,89,64,205,281,294,345
169808,30001_20190813192724.jpg,関西スーパー高石駅前,**50,和泉,340,と,2019/8/13 19:27,2-1_all_corrected,76,54,375,170,451,224
168918,30144_20190813123429.jpg,イオン幕張,*387,千葉,502,ぬ,2019/8/13 12:34,2-1_all_corrected,48,41,178,137,226,178
168578,30139_20190813100012.jpg,イオン板橋ショッピングセンター,***1,練馬,30,ね,2019/8/13 9:59,2-1_all_corrected,48,36,343,142,391,178
168920,30045_20190813123535.jpg,マックスバリュー徳川明倫,*358,名古屋,32,と,2019/8/13 12:35,2-1_all_corrected,56,42,314,132,370,174
169839,30157_20190813194444.jpg,関西スーパー中央,8366,神戸,400,は,2019/8/13 19:44,2-1_all_corrected,60,42,95,405,155,447
169380,30022_20190813160813.jpg,業務スーパー平野駅前,***8,大阪,30,も,2019/8/13 16:07,2-1_all_corrected,78,65,304,286,382,351
168609,30091_20190813101415.jpg,イトーヨーカドー木場 立体,7222,足立,302,ぬ,2019/8/13 10:13,2-1_all_corrected,56,43,262,68,318,111
169318,30062_20190813155637.jpg,ミスミモール,**11,神戸,31,ぬ,2019/8/13 15:53,2-1_all_corrected,74,60,274,174,348,234
170007,30167_20190813221239.jpg,イオン東雲店,6658,富士山,303,そ,2019/8/13 22:12,2-1_all_corrected,74,52,328,376,402,428
169743,30078_20190813190255.jpg,イオンスタイル仙台卸町店,2815,仙台,580,い,2019/8/13 19:02,2-1_all_corrected,79,57,291,158,370,215
169320,30078_20190813155730.jpg,イオンスタイル仙台卸町店,5059,宮城,580,け,2019/8/13 15:56,2-1_all_corrected,82,57,376,261,458,318
169744,30123_20190813190256.jpg,イオン長浦（第５）,8888,袖ヶ浦,585,よ,2019/8/13 19:02,2-1_all_corrected,97,87,479,220,576,307
168808,30144_20190813115110.jpg,イオン幕張,5362,千葉,53,に,2019/8/13 11:50,2-1_all_corrected,53,35,125,232,178,267
169786,30144_20190813191843.jpg,イオン幕張,*376,千葉,581,さ,2019/8/13 19:18,2-1_all_corrected,79,56,193,270,272,326
169140,30078_20190813142457.jpg,イオンスタイル仙台卸町店,1199,仙台,330,た,2019/8/13 14:24,2-1_all_corrected,89,64,397,360,486,424
169711,30169_20190813184209.jpg,イオン相模原ショッピングセンター,3047,多摩,583,か,2019/8/13 18:41,2-1_all_corrected,85,72,387,368,472,440
168608,30045_20190813101349.jpg,マックスバリュー徳川明倫,8008,名古屋,31,の,2019/8/13 10:13,2-1_all_corrected,78,68,19,264,97,332
169718,30111_20190813184651.jpg,イオン稲毛,1020,千葉,588,を,2019/8/13 18:46,2-1_all_corrected,57,42,153,164,210,206
169720,30169_20190813184726.jpg,イオン相模原ショッピングセンター,3672,相模,331,ぬ,2019/8/13 18:47,2-1_all_corrected,88,76,424,351,512,427
170030,30169_20190813225121.jpg,イオン相模原ショッピングセンター,**77,相模,131,た,2019/8/13 22:50,2-1_all_corrected,75,76,479,355,554,431
169122,30001_20190813141319.jpg,関西スーパー高石駅前,5869,名古屋,303,ひ,2019/8/13 14:13,2-1_all_corrected,60,41,463,13,523,54
169546,30078_20190813173534.jpg,イオンスタイル仙台卸町店,5858,仙台,580,け,2019/8/13 17:35,2-1_all_corrected,82,59,204,200,286,259
169787,30110_20190813191903.jpg,イオン金沢八景,*501,横浜,352,ゆ,2019/8/13 19:18,2-1_all_corrected,71,57,346,94,417,151
169541,30078_20190813173436.jpg,イオンスタイル仙台卸町店,1518,札幌,580,か,2019/8/13 17:34,2-1_all_corrected,51,46,180,60,231,106
168663,30110_20190813103800.jpg,イオン金沢八景,3230,横浜,530,や,2019/8/13 10:37,2-1_all_corrected,48,35,221,18,269,53
169321,30091_20190813155747.jpg,イトーヨーカドー木場 立体,6815,足立,330,せ,2019/8/13 15:57,2-1_all_corrected,78,57,200,205,278,262
169745,30098_20190813190403.jpg,BRANCH仙台（東棟）,1151,福島,531,ひ,2019/8/13 19:03,2-1_all_corrected,74,52,189,192,263,244
169789,30001_20190813191911.jpg,関西スーパー高石駅前,2222,和泉,593,ら,2019/8/13 19:18,2-1_all_corrected,88,66,350,220,438,286
169584,30144_20190813175535.jpg,イオン幕張,8787,千葉,547,ね,2019/8/13 17:55,2-1_all_corrected,48,34,205,87,253,121
169794,30169_20190813192050.jpg,イオン相模原ショッピングセンター,4910,相模,580,む,2019/8/13 19:20,2-1_all_corrected,56,43,345,137,401,180
168677,30045_20190813104814.jpg,マックスバリュー徳川明倫,1122,名古屋,31,せ,2019/8/13 10:47,2-1_all_corrected,56,45,243,149,299,194
169107,30060_20190813140141.jpg,関西スーパー小野原,8888,滋賀,378,ひ,2019/8/13 14:01,2-1_all_corrected,52,43,370,43,422,86
169751,30080_20190813190628.jpg,フォーレストモール新前橋,**16,前橋,110,さ,2019/8/13 19:05,2-1_all_corrected,68,53,158,132,226,185
168683,30060_20190813105116.jpg,関西スーパー小野原,1124,大阪,342,ち,2019/8/13 10:50,2-1_all_corrected,46,36,179,199,225,235
168849,30078_20190813120255.jpg,イオンスタイル仙台卸町店,3706,仙台,580,と,2019/8/13 12:02,2-1_all_corrected,64,59,204,78,268,137
168615,30009_20190813101636.jpg,西友新北習志野,3094,習志野,300,や,2019/8/13 10:16,2-1_all_corrected,165,104,251,0,416,104
169506,30144_20190813171708.jpg,イオン幕張,1010,千葉,355,て,2019/8/13 17:16,2-1_all_corrected,38,32,282,78,320,110
169591,30167_20190813175817.jpg,イオン東雲店,4505,足立,481,り,2019/8/13 17:57,2-1_all_corrected,81,65,182,291,263,356
169757,30144_20190813190854.jpg,イオン幕張,6608,仙台,300,や,2019/8/13 19:08,2-1_all_corrected,90,64,189,333,279,397
169750,30144_20190813190517.jpg,イオン幕張,1321,川崎,300,わ,2019/8/13 19:04,2-1_all_corrected,62,43,229,162,291,205
169139,30045_20190813142457.jpg,マックスバリュー徳川明倫,8008,名古屋,31,の,2019/8/13 14:24,2-1_all_corrected,78,65,94,293,172,358
168640,30045_20190813102622.jpg,マックスバリュー徳川明倫,1001,名古屋,31,せ,2019/8/13 10:25,2-1_all_corrected,51,44,426,158,477,202
169795,30001_20190813192156.jpg,関西スーパー高石駅前,**50,和泉,340,と,2019/8/13 19:21,2-1_all_corrected,107,55,187,192,294,247
169671,30078_20190813182525.jpg,イオンスタイル仙台卸町店,2807,仙台,580,ゆ,2019/8/13 18:24,2-1_all_corrected,74,55,339,169,413,224
168596,30009_20190813100902.jpg,西友新北習志野,1318,習志野,331,な,2019/8/13 10:08,2-1_all_corrected,167,105,261,0,428,105
169212,30114_20190813150243.jpg,イオン南行徳（立体）,6255,礼,59,ち,2019/8/13 15:02,2-1_all_corrected,81,53,244,299,325,352
169823,30110_20190813193722.jpg,イオン金沢八景,1353,横浜,480,て,2019/8/13 19:36,2-1_all_corrected,46,34,364,105,410,139
169472,30144_20190813165919.jpg,イオン幕張,*381,品川,501,ら,2019/8/13 16:58,2-1_all_corrected,72,50,273,197,345,247
169011,30078_20190813131305.jpg,イオンスタイル仙台卸町店,***8,仙台,327,た,2019/8/13 13:12,2-1_all_corrected,85,64,427,320,512,384
168994,30072_20190813130832.jpg,関西スーパー京阪大和田１F,1461,堺,800,あ,2019/8/13 13:07,2-1_all_corrected,82,70,124,299,206,369
169841,30169_20190813194723.jpg,イオン相模原ショッピングセンター,1637,多摩,503,め,2019/8/13 19:47,2-1_all_corrected,94,75,311,315,405,390
168732,30110_20190813111602.jpg,イオン金沢八景,2543,横浜,580,こ,2019/8/13 11:15,2-1_all_corrected,40,34,262,113,302,147
168958,30078_20190813125129.jpg,イオンスタイル仙台卸町店,6553,宮城,330,す,2019/8/13 12:51,2-1_all_corrected,66,52,298,86,364,138
168951,30135_20190813124714.jpg,イオン西新井,8888,足立,383,ま,2019/8/13 12:46,2-1_all_corrected,59,41,237,149,296,190
168536,30138_20190813091952.jpg,イオンスタイル湘南茅ヶ崎,1173,湘南,374,さ,2019/8/13 9:19,2-1_all_corrected,59,41,226,107,285,148
168509,30045_20190813084605.jpg,マックスバリュー徳川明倫,9097,三河,400,と,2019/8/13 8:45,2-1_all_corrected,57,42,284,141,341,183
169848,30072_20190813195053.jpg,関西スーパー京阪大和田１F,2431,堺,330,も,2019/8/13 19:50,2-1_all_corrected,42,34,386,52,428,86
169246,30110_20190813151801.jpg,イオン金沢八景,1125,横浜,556,つ,2019/8/13 15:17,2-1_all_corrected,43,35,487,82,530,117
169474,30144_20190813165939.jpg,イオン幕張,3484,千葉,502,ら,2019/8/13 16:59,2-1_all_corrected,60,42,302,167,362,209
168935,30090_20190813124225.jpg,イトーヨーカドー木場 西棟,*516,足立,530,あ,2019/8/13 12:41,2-1_all_corrected,95,70,404,354,499,424
169213,30132_20190813150250.jpg,イオンスタイル東神奈川,***8,横浜,30,に,2019/8/13 15:02,2-1_all_corrected,49,35,196,99,245,134
169683,30086_20190813183118.jpg,テックランド大阪りんくう,8008,大阪,31,ろ,2019/8/13 18:30,2-1_all_corrected,49,38,238,70,287,108
168563,30111_20190813094524.jpg,イオン稲毛,***5,千葉,30,ふ,2019/8/13 9:44,2-1_all_corrected,79,53,280,231,359,284
169822,30169_20190813193654.jpg,イオン相模原ショッピングセンター,2564,相模,500,ろ,2019/8/13 19:36,2-1_all_corrected,82,73,502,367,584,440
168769,30110_20190813113453.jpg,イオン金沢八景,7788,横浜,555,つ,2019/8/13 11:34,2-1_all_corrected,94,71,80,379,174,450
169624,30144_20190813181256.jpg,イオン幕張,1995,千葉,531,そ,2019/8/13 18:12,2-1_all_corrected,59,44,290,206,349,250
169849,30001_20190813195154.jpg,関西スーパー高石駅前,*525,和泉,536,ろ,2019/8/13 19:51,2-1_all_corrected,80,55,425,186,505,241
169081,30039_20190813134925.jpg,イトーヨーカドー大井町,*836,多摩,481,り,2019/8/13 13:48,2-1_all_corrected,55,71,150,254,205,325
169285,30111_20190813153637.jpg,イオン稲毛,8809,千葉,580,ほ,2019/8/13 15:36,2-1_all_corrected,66,54,261,172,327,226
169847,30039_20190813195026.jpg,イトーヨーカドー大井町,*830,品川,344,ひ,2019/8/13 19:49,2-1_all_corrected,70,64,162,185,232,249
169282,30091_20190813153613.jpg,イトーヨーカドー木場 立体,1010,伊豆,336,に,2019/8/13 15:35,2-1_all_corrected,49,38,347,118,396,156
169612,30144_20190813180832.jpg,イオン幕張,*444,千葉,301,む,2019/8/13 18:08,2-1_all_corrected,60,43,193,207,253,250
171665,30144_20190814190246.jpg,イオン幕張,1926,習志野,502,す,2019/8/14 19:02,2-1_all_corrected,80,59,332,308,412,367
171005,30078_20190814140802.jpg,イオンスタイル仙台卸町店,6925,仙台,330,す,2019/8/14 14:07,2-1_all_corrected,86,60,313,228,399,288
171264,30090_20190814160750.jpg,イトーヨーカドー木場 西棟,*382,千葉,502,ふ,2019/8/14 16:07,2-1_all_corrected,54,40,213,169,267,209
171638,30157_20190814185118.jpg,関西スーパー中央,9999,神戸,381,の,2019/8/14 18:50,2-1_all_corrected,53,45,225,385,278,430
171297,30144_20190814162425.jpg,イオン幕張,3208,千葉,480,そ,2019/8/14 16:24,2-1_all_corrected,51,37,176,112,227,149
170345,30072_20190814094134.jpg,関西スーパー京阪大和田１F,**11,大阪,31,ま,2019/8/14 9:41,2-1_all_corrected,69,55,286,232,355,287
170728,30167_20190814122217.jpg,イオン東雲店,***7,とちぎ,338,む,2019/8/14 12:21,2-1_all_corrected,51,41,357,283,408,324
171467,30078_20190814173640.jpg,イオンスタイル仙台卸町店,8322,宮城,581,か,2019/8/14 17:36,2-1_all_corrected,74,56,221,200,295,256
170182,30073_20190814083211.jpg,関西スーパー京阪大和田２F,*762,京都,800,せ,2019/8/14 8:31,2-1_all_corrected,47,42,373,125,420,167
170328,30144_20190814092850.jpg,イオン幕張,7950,千葉,580,と,2019/8/14 9:28,2-1_all_corrected,55,40,187,160,242,200
171652,30001_20190814185822.jpg,関西スーパー高石駅前,2438,神戸,335,も,2019/8/14 18:58,2-1_all_corrected,86,63,272,186,358,249
171699,30169_20190814191732.jpg,イオン相模原ショッピングセンター,8000,多摩,343,ぬ,2019/8/14 19:16,2-1_all_corrected,64,62,357,189,421,251
170928,30060_20190814132820.jpg,関西スーパー小野原,2009,大阪,580,め,2019/8/14 13:27,2-1_all_corrected,71,60,419,232,490,292
170570,30167_20190814112732.jpg,イオン東雲店,*673,春日部,880,り,2019/8/14 11:27,2-1_all_corrected,69,60,144,260,213,320
171664,30144_20190814190224.jpg,イオン幕張,3120,千葉,581,せ,2019/8/14 19:02,2-1_all_corrected,53,45,122,197,175,242
171663,30045_20190814190211.jpg,マックスバリュー徳川明倫,*358,名古屋,32,さ,2019/8/14 19:01,2-1_all_corrected,53,46,144,211,197,257
171697,30062_20190814191653.jpg,ミスミモール,1188,神戸,31,さ,2019/8/14 19:16,2-1_all_corrected,65,57,205,155,270,212
171253,30144_20190814160256.jpg,イオン幕張,4222,柏,500,て,2019/8/14 16:02,2-1_all_corrected,57,42,175,117,232,159
171405,30045_20190814171216.jpg,マックスバリュー徳川明倫,***1,名古屋,30,む,2019/8/14 17:11,2-1_all_corrected,67,52,186,189,253,241
170711,30136_20190814121444.jpg,イオンスタイル新百合ヶ丘,7793,多摩,580,む,2019/8/14 12:14,2-1_all_corrected,55,44,274,156,329,200
170729,30001_20190814122220.jpg,関西スーパー高石駅前,9281,姫路,501,の,2019/8/14 12:21,2-1_all_corrected,84,58,456,113,540,171
171865,30098_20190814210802.jpg,BRANCH仙台（東棟）,***5,仙台,585,ま,2019/8/14 21:07,2-1_all_corrected,97,62,177,324,274,386
171092,30045_20190814145517.jpg,マックスバリュー徳川明倫,*358,名古屋,32,ね,2019/8/14 14:54,2-1_all_corrected,52,41,280,148,332,189
170524,30072_20190814110737.jpg,関西スーパー京阪大和田１F,9416,大阪,480,て,2019/8/14 11:07,2-1_all_corrected,75,58,177,204,252,262
171066,30110_20190814143631.jpg,イオン金沢八景,2506,横浜,480,さ,2019/8/14 14:36,2-1_all_corrected,67,69,3,315,70,384
170975,30060_20190814135125.jpg,関西スーパー小野原,*697,姫路,800,わ,2019/8/14 13:51,2-1_all_corrected,76,67,518,383,594,450
171296,30144_20190814162254.jpg,イオン幕張,2577,千葉,331,ふ,2019/8/14 16:22,2-1_all_corrected,74,54,242,242,316,296
171434,30110_20190814172619.jpg,イオン金沢八景,***1,横浜,30,せ,2019/8/14 17:25,2-1_all_corrected,68,54,390,139,458,193
170986,30062_20190814135444.jpg,ミスミモール,8888,神戸,30,さ,2019/8/14 13:54,2-1_all_corrected,53,46,391,138,444,184
170467,30167_20190814103959.jpg,イオン東雲店,1813,足立,331,す,2019/8/14 10:39,2-1_all_corrected,79,72,15,202,94,274
171919,30169_20190814213911.jpg,イオン相模原ショッピングセンター,5884,横浜,341,す,2019/8/14 21:38,2-1_all_corrected,74,50,120,124,194,174
171773,30111_20190814195509.jpg,イオン稲毛,8888,千葉,386,て,2019/8/14 19:54,2-1_all_corrected,67,54,350,212,417,266
171579,30144_20190814182411.jpg,イオン幕張,1098,千葉,301,ら,2019/8/14 18:23,2-1_all_corrected,77,56,337,351,414,407
171114,30144_20190814150849.jpg,イオン幕張,2125,千葉,331,ね,2019/8/14 15:08,2-1_all_corrected,57,43,186,149,243,192
171742,30144_20190814193644.jpg,イオン幕張,3804,千葉,301,ふ,2019/8/14 19:35,2-1_all_corrected,71,52,139,213,210,265
171917,30063_20190814213746.jpg,コーナン相模原小山モール,1101,相模,342,ぬ,2019/8/14 21:37,2-1_all_corrected,72,66,519,166,591,232
171147,30076_20190814152335.jpg,ヤマダ電機なんば,3000,なにわ,400,る,2019/8/14 15:22,2-1_all_corrected,47,41,266,68,313,109
171388,30078_20190814170125.jpg,イオンスタイル仙台卸町店,5565,仙台,580,な,2019/8/14 17:01,2-1_all_corrected,95,61,285,360,380,421
170601,30078_20190814113918.jpg,イオンスタイル仙台卸町店,*312,柏,332,め,2019/8/14 11:38,2-1_all_corrected,70,56,163,73,233,129
171515,30098_20190814175902.jpg,BRANCH仙台（東棟）,1001,仙台,347,つ,2019/8/14 17:58,2-1_all_corrected,71,53,124,194,195,247
170450,30062_20190814103138.jpg,ミスミモール,1010,神戸,31,ゆ,2019/8/14 10:31,2-1_all_corrected,69,58,230,166,299,224
171585,30078_20190814182703.jpg,イオンスタイル仙台卸町店,***8,仙台,333,み,2019/8/14 18:26,2-1_all_corrected,51,41,353,102,404,143
170457,30060_20190814103337.jpg,関西スーパー小野原,4187,大阪,530,の,2019/8/14 10:33,2-1_all_corrected,65,59,355,227,420,286
171540,30009_20190814180929.jpg,西友新北習志野,7720,相模,301,む,2019/8/14 18:09,2-1_all_corrected,156,102,296,0,452,102
171514,30144_20190814175807.jpg,イオン幕張,2951,千葉,335,ね,2019/8/14 17:57,2-1_all_corrected,57,40,250,148,307,188
171184,30078_20190814153855.jpg,イオンスタイル仙台卸町店,1618,宮城,502,む,2019/8/14 15:38,2-1_all_corrected,70,52,286,120,356,172
170435,30072_20190814102536.jpg,関西スーパー京阪大和田１F,6889,京都,330,ち,2019/8/14 10:24,2-1_all_corrected,87,63,12,211,99,274
171513,30078_20190814175728.jpg,イオンスタイル仙台卸町店,7477,仙台,580,ひ,2019/8/14 17:57,2-1_all_corrected,73,53,231,150,304,203
170899,30085_20190814131147.jpg,業務スーパー南津守,***8,なにわ,30,も,2019/8/14 13:11,2-1_all_corrected,53,42,339,283,392,325
170609,30072_20190814114203.jpg,関西スーパー京阪大和田１F,*115,大阪,355,せ,2019/8/14 11:41,2-1_all_corrected,54,43,200,113,254,156
171522,30072_20190814180232.jpg,関西スーパー京阪大和田１F,**12,大阪,586,る,2019/8/14 18:02,2-1_all_corrected,67,55,48,115,115,170
171380,30110_20190814165814.jpg,イオン金沢八景,2000,横浜,515,ぬ,2019/8/14 16:57,2-1_all_corrected,65,55,216,240,281,295
171732,30136_20190814193152.jpg,イオンスタイル新百合ヶ丘,1000,熊谷,323,ね,2019/8/14 19:31,2-1_all_corrected,57,46,370,131,427,177
171393,30078_20190814170332.jpg,イオンスタイル仙台卸町店,*629,仙台,583,き,2019/8/14 17:03,2-1_all_corrected,52,47,197,78,249,125
171703,30072_20190814191802.jpg,関西スーパー京阪大和田１F,3072,大阪,78,つ,2019/8/14 19:17,2-1_all_corrected,70,58,373,214,443,272
171562,30103_20190814181902.jpg,八尾老原１丁目,**88,大阪,31,ら,2019/8/14 18:18,2-1_all_corrected,85,66,195,240,280,306
171750,30110_20190814194126.jpg,イオン金沢八景,1001,横浜,31,あ,2019/8/14 19:40,2-1_all_corrected,57,43,301,177,358,220
171596,30111_20190814183232.jpg,イオン稲毛,**11,千葉,31,ひ,2019/8/14 18:32,2-1_all_corrected,51,38,356,126,407,164
171768,30045_20190814195037.jpg,マックスバリュー徳川明倫,**22,名古屋,31,る,2019/8/14 19:50,2-1_all_corrected,66,60,76,216,142,276
171591,30144_20190814183018.jpg,イオン幕張,*691,習志野,580,わ,2019/8/14 18:29,2-1_all_corrected,76,51,232,230,308,281
171598,30167_20190814183332.jpg,イオン東雲店,*711,足立,344,ぬ,2019/8/14 18:33,2-1_all_corrected,56,45,429,325,485,370
170812,30078_20190814125029.jpg,イオンスタイル仙台卸町店,*510,宮城,332,は,2019/8/14 12:50,2-1_all_corrected,52,43,415,190,467,233
171130,30072_20190814151346.jpg,関西スーパー京阪大和田１F,*414,大阪,584,せ,2019/8/14 15:13,2-1_all_corrected,70,59,274,122,344,181
171766,30091_20190814194927.jpg,イトーヨーカドー木場 立体,*727,足立,347,み,2019/8/14 19:49,2-1_all_corrected,43,41,304,29,347,70
171361,30060_20190814165031.jpg,関西スーパー小野原,3406,大阪,480,な,2019/8/14 16:50,2-1_all_corrected,76,67,427,355,503,422
170624,30045_20190814114729.jpg,マックスバリュー徳川明倫,7527,名古屋,70,ふ,2019/8/14 11:46,2-1_all_corrected,55,46,300,212,355,258
170885,30060_20190814125958.jpg,関西スーパー小野原,*159,大阪,330,り,2019/8/14 12:59,2-1_all_corrected,71,72,512,363,583,435
171350,30009_20190814164613.jpg,西友新北習志野,9520,習志野,301,ふ,2019/8/14 16:46,2-1_all_corrected,184,111,218,0,402,111
171539,30111_20190814180844.jpg,イオン稲毛,7032,千葉,530,つ,2019/8/14 18:08,2-1_all_corrected,72,50,312,157,384,207
171733,30078_20190814193235.jpg,イオンスタイル仙台卸町店,9999,仙台,583,を,2019/8/14 19:32,2-1_all_corrected,92,69,146,275,238,344
171131,30144_20190814151521.jpg,イオン幕張,*321,足立,352,て,2019/8/14 15:14,2-1_all_corrected,82,64,408,327,490,391
170679,30045_20190814120628.jpg,マックスバリュー徳川明倫,**23,名古屋,31,み,2019/8/14 12:05,2-1_all_corrected,66,64,49,217,115,281
170813,30078_20190814125036.jpg,イオンスタイル仙台卸町店,7532,宮城,581,ね,2019/8/14 12:50,2-1_all_corrected,102,63,186,371,288,434
170480,30144_20190814104717.jpg,イオン幕張,1201,千葉,345,つ,2019/8/14 10:46,2-1_all_corrected,47,34,170,85,217,119
171760,30169_20190814194642.jpg,イオン相模原ショッピングセンター,7592,相模,300,ろ,2019/8/14 19:46,2-1_all_corrected,56,46,400,12,456,58
170474,30060_20190814104202.jpg,関西スーパー小野原,*512,大阪,541,ほ,2019/8/14 10:41,2-1_all_corrected,80,65,426,228,506,293
170648,30111_20190814115610.jpg,イオン稲毛,8893,千葉,302,せ,2019/8/14 11:55,2-1_all_corrected,56,45,233,163,289,208
170445,30062_20190814103043.jpg,ミスミモール,**18,神戸,31,ふ,2019/8/14 10:30,2-1_all_corrected,74,56,312,185,386,241
171411,30090_20190814171545.jpg,イトーヨーカドー木場 西棟,6000,足立,302,と,2019/8/14 17:15,2-1_all_corrected,86,66,160,332,246,398
171882,30167_20190814212513.jpg,イオン東雲店,1000,滋賀,359,む,2019/8/14 21:24,2-1_all_corrected,68,56,202,154,270,210
170392,30001_20190814100358.jpg,関西スーパー高石駅前,*523,堺,400,す,2019/8/14 10:03,2-1_all_corrected,95,68,173,358,268,426
171072,30168_20190814144055.jpg,イオン東雲店（屋上）,*235,足立,580,ち,2019/8/14 14:40,2-1_all_corrected,89,75,447,316,536,391
171276,30169_20190814161540.jpg,イオン相模原ショッピングセンター,8429,相模,301,み,2019/8/14 16:15,2-1_all_corrected,74,64,375,253,449,317
171847,30078_20190814204249.jpg,イオンスタイル仙台卸町店,***4,宮城,338,ぬ,2019/8/14 20:42,2-1_all_corrected,83,53,276,235,359,288
171088,30072_20190814145100.jpg,関西スーパー京阪大和田１F,**10,大阪,31,さ,2019/8/14 14:50,2-1_all_corrected,45,41,415,93,460,134
170758,30157_20190814123245.jpg,関西スーパー中央,**10,神戸,31,つ,2019/8/14 12:32,2-1_all_corrected,44,60,99,191,143,251
171641,30144_20190814185205.jpg,イオン幕張,3194,千葉,560,ほ,2019/8/14 18:51,2-1_all_corrected,40,32,275,89,315,121
170555,30072_20190814112028.jpg,関西スーパー京阪大和田１F,1001,大阪,31,ち,2019/8/14 11:20,2-1_all_corrected,56,42,223,79,279,121
171679,30078_20190814190706.jpg,イオンスタイル仙台卸町店,***2,宮城,588,た,2019/8/14 19:06,2-1_all_corrected,54,41,263,151,317,192
170564,30072_20190814112416.jpg,関西スーパー京阪大和田１F,4805,なにわ,580,ま,2019/8/14 11:23,2-1_all_corrected,69,61,0,313,69,374
171677,30091_20190814190639.jpg,イトーヨーカドー木場 立体,2726,横浜,303,ひ,2019/8/14 19:06,2-1_all_corrected,66,55,233,181,299,236
171683,30111_20190814190900.jpg,イオン稲毛,1119,千葉,334,ふ,2019/8/14 19:08,2-1_all_corrected,56,41,221,118,277,159
171841,30072_20190814204136.jpg,関西スーパー京阪大和田１F,7138,なにわ,501,や,2019/8/14 20:40,2-1_all_corrected,79,65,0,202,79,267
171421,30110_20190814172117.jpg,イオン金沢八景,3650,横浜,504,も,2019/8/14 17:20,2-1_all_corrected,68,54,346,167,414,221
170531,30072_20190814111108.jpg,関西スーパー京阪大和田１F,1001,大阪,31,ち,2019/8/14 11:10,2-1_all_corrected,70,58,215,306,285,364
171428,30078_20190814172457.jpg,イオンスタイル仙台卸町店,**18,福島,339,え,2019/8/14 17:24,2-1_all_corrected,91,68,187,309,278,377
171074,30085_20190814144202.jpg,業務スーパー南津守,***1,なにわ,30,は,2019/8/14 14:41,2-1_all_corrected,44,34,257,175,301,209
171279,30078_20190814161627.jpg,イオンスタイル仙台卸町店,8800,宮城,334,そ,2019/8/14 16:16,2-1_all_corrected,55,42,306,57,361,99
171018,30091_20190814141304.jpg,イトーヨーカドー木場 立体,**33,足立,548,ね,2019/8/14 14:12,2-1_all_corrected,68,55,279,84,347,139
171475,30078_20190814174125.jpg,イオンスタイル仙台卸町店,6796,仙台,380,て,2019/8/14 17:40,2-1_all_corrected,60,42,283,117,343,159
170759,30144_20190814123309.jpg,イオン幕張,9980,千葉,530,そ,2019/8/14 12:32,2-1_all_corrected,47,35,204,133,251,168
171029,30072_20190814141740.jpg,関西スーパー京阪大和田１F,**10,大阪,31,さ,2019/8/14 14:17,2-1_all_corrected,72,63,269,236,341,299
171099,30078_20190814145818.jpg,イオンスタイル仙台卸町店,1116,宮城,583,を,2019/8/14 14:57,2-1_all_corrected,73,54,284,188,357,242
170948,30006_20190814133912.jpg,スギ薬局南千里,8534,大阪,581,ひ,2019/8/14 13:39,2-1_all_corrected,128,121,1,112,129,233
171294,30078_20190814162239.jpg,イオンスタイル仙台卸町店,4125,仙台,580,て,2019/8/14 16:22,2-1_all_corrected,81,59,311,229,392,288
170984,30144_20190814135252.jpg,イオン幕張,2284,千葉,501,ね,2019/8/14 13:52,2-1_all_corrected,48,32,194,123,242,155
171603,30063_20190814183602.jpg,コーナン相模原小山モール,***3,多摩,30,ゆ,2019/8/14 18:35,2-1_all_corrected,49,42,198,137,247,179
170348,30073_20190814094154.jpg,関西スーパー京阪大和田２F,**11,大阪,31,ま,2019/8/14 9:41,2-1_all_corrected,54,46,322,180,376,226
170713,30169_20190814121539.jpg,イオン相模原ショッピングセンター,8345,多摩,580,ひ,2019/8/14 12:15,2-1_all_corrected,87,75,413,357,500,432
171063,30167_20190814143355.jpg,イオン東雲店,5037,足立,502,な,2019/8/14 14:33,2-1_all_corrected,84,62,217,252,301,314
171407,30078_20190814171239.jpg,イオンスタイル仙台卸町店,***9,仙台,346,と,2019/8/14 17:12,2-1_all_corrected,82,55,347,298,429,353
171635,30078_20190814184936.jpg,イオンスタイル仙台卸町店,6748,宮城,300,ろ,2019/8/14 18:49,2-1_all_corrected,79,60,355,296,434,356
171893,30172_20190814213247.jpg,ピットデザインすわの町,*916,久留米,332,と,2019/8/14 21:32,2-1_all_corrected,74,53,282,177,356,230
171632,30078_20190814184842.jpg,イオンスタイル仙台卸町店,*414,宮城,332,ま,2019/8/14 18:48,2-1_all_corrected,61,43,266,78,327,121
171400,30078_20190814171032.jpg,イオンスタイル仙台卸町店,6897,福島,501,ね,2019/8/14 17:10,2-1_all_corrected,51,45,166,92,217,137
171833,30169_20190814202821.jpg,イオン相模原ショッピングセンター,6826,相模,580,ゆ,2019/8/14 20:27,2-1_all_corrected,55,42,96,118,151,160
171037,30078_20190814142017.jpg,イオンスタイル仙台卸町店,*111,仙台,585,の,2019/8/14 14:19,2-1_all_corrected,87,59,298,317,385,376
170581,30167_20190814113240.jpg,イオン東雲店,*921,足立,533,ふ,2019/8/14 11:32,2-1_all_corrected,54,43,367,268,421,311
171498,30144_20190814174911.jpg,イオン幕張,4346,千葉,301,て,2019/8/14 17:48,2-1_all_corrected,57,43,150,156,207,199
170315,30153_20190814092006.jpg,万代桃谷駅前,5308,和泉,800,す,2019/8/14 9:19,2-1_all_corrected,87,62,383,306,470,368
170771,30110_20190814123825.jpg,イオン金沢八景,4686,横浜,581,け,2019/8/14 12:38,2-1_all_corrected,85,85,1,271,86,356
171491,30066_20190814174737.jpg,ジョーシン和泉中央,***8,和泉,30,つ,2019/8/14 17:46,2-1_all_corrected,71,58,186,234,257,292
171657,30001_20190814190021.jpg,関西スーパー高石駅前,*719,堺,331,き,2019/8/14 19:00,2-1_all_corrected,67,54,491,49,558,103
171650,30111_20190814185700.jpg,イオン稲毛,1013,千葉,539,そ,2019/8/14 18:56,2-1_all_corrected,68,55,371,223,439,278
170776,30167_20190814123918.jpg,イオン東雲店,*358,横浜,356,や,2019/8/14 12:38,2-1_all_corrected,88,69,176,311,264,380
171039,30167_20190814142154.jpg,イオン東雲店,3188,足立,503,わ,2019/8/14 14:21,2-1_all_corrected,52,43,399,292,451,335
170940,30091_20190814133405.jpg,イトーヨーカドー木場 立体,*353,習志野,580,ぬ,2019/8/14 13:33,2-1_all_corrected,76,56,301,113,377,169
171091,30111_20190814145511.jpg,イオン稲毛,5035,千葉,583,い,2019/8/14 14:54,2-1_all_corrected,70,53,324,135,394,188
171062,30110_20190814143352.jpg,イオン金沢八景,**51,横浜,332,ま,2019/8/14 14:33,2-1_all_corrected,69,64,100,212,169,276
171634,30111_20190814184929.jpg,イオン稲毛,7150,千葉,530,は,2019/8/14 18:49,2-1_all_corrected,52,39,140,123,192,162
170985,30060_20190814135343.jpg,関西スーパー小野原,5689,大阪,480,の,2019/8/14 13:53,2-1_all_corrected,74,62,299,302,373,364
171602,30076_20190814183556.jpg,ヤマダ電機なんば,**13,なにわ,331,と,2019/8/14 18:35,2-1_all_corrected,86,64,317,203,403,267
171054,30078_20190814143021.jpg,イオンスタイル仙台卸町店,1355,仙台,330,つ,2019/8/14 14:29,2-1_all_corrected,70,52,314,113,384,165
171292,30144_20190814162218.jpg,イオン幕張,*617,千葉,539,す,2019/8/14 16:21,2-1_all_corrected,59,42,182,174,241,216
171098,30045_20190814145815.jpg,マックスバリュー徳川明倫,1103,名古屋,31,つ,2019/8/14 14:57,2-1_all_corrected,68,60,154,169,222,229
171408,30078_20190814171252.jpg,イオンスタイル仙台卸町店,**54,宮城,581,あ,2019/8/14 17:12,2-1_all_corrected,68,52,304,133,372,185
171295,30169_20190814162242.jpg,イオン相模原ショッピングセンター,9110,相模,300,や,2019/8/14 16:22,2-1_all_corrected,73,59,188,174,261,233
171463,30144_20190814173611.jpg,イオン幕張,5316,千葉,330,み,2019/8/14 17:35,2-1_all_corrected,54,42,220,117,274,159
171669,30110_20190814190347.jpg,イオン金沢八景,9519,横浜,330,そ,2019/8/14 19:03,2-1_all_corrected,75,63,155,191,230,254
170925,30072_20190814132720.jpg,関西スーパー京阪大和田１F,7246,大阪,502,せ,2019/8/14 13:26,2-1_all_corrected,47,35,223,51,270,86
170746,30076_20190814122906.jpg,ヤマダ電機なんば,*222,なにわ,334,つ,2019/8/14 12:28,2-1_all_corrected,78,57,431,212,509,269
171694,30062_20190814191422.jpg,ミスミモール,***1,神戸,30,え,2019/8/14 19:13,2-1_all_corrected,67,71,40,272,107,343
171031,30072_20190814141746.jpg,関西スーパー京阪大和田１F,5185,神戸,800,あ,2019/8/14 14:17,2-1_all_corrected,49,42,353,159,402,201
170892,30169_20190814130532.jpg,イオン相模原ショッピングセンター,*408,相模,332,え,2019/8/14 13:04,2-1_all_corrected,64,43,369,140,433,183
171188,30045_20190814154034.jpg,マックスバリュー徳川明倫,*358,名古屋,32,と,2019/8/14 15:40,2-1_all_corrected,70,56,206,202,276,258
171382,30110_20190814165900.jpg,イオン金沢八景,*299,横浜,530,ら,2019/8/14 16:58,2-1_all_corrected,52,40,419,144,471,184
171712,30169_20190814192254.jpg,イオン相模原ショッピングセンター,9693,多摩,71,え,2019/8/14 19:22,2-1_all_corrected,76,36,300,159,376,195
171172,30144_20190814153344.jpg,イオン幕張,1218,千葉,503,さ,2019/8/14 15:33,2-1_all_corrected,49,36,145,97,194,133
170463,30072_20190814103902.jpg,関西スーパー京阪大和田１F,8973,大阪,581,ひ,2019/8/14 10:38,2-1_all_corrected,71,55,131,115,202,170
171748,30163_20190814193942.jpg,コープ葛飾白鳥店(地上),*810,足立,347,ち,2019/8/14 19:39,2-1_all_corrected,41,62,4,213,45,275
171126,30072_20190814151227.jpg,関西スーパー京阪大和田１F,*626,大阪,585,こ,2019/8/14 15:11,2-1_all_corrected,104,91,0,323,104,414
171770,30144_20190814195300.jpg,イオン幕張,3777,千葉,331,ひ,2019/8/14 19:52,2-1_all_corrected,71,54,202,181,273,235
171580,30157_20190814182541.jpg,関西スーパー中央,**55,神戸,31,め,2019/8/14 18:25,2-1_all_corrected,57,42,124,405,181,447
171573,30169_20190814182329.jpg,イオン相模原ショッピングセンター,*112,相模,335,か,2019/8/14 18:23,2-1_all_corrected,42,36,525,0,567,36
171587,30078_20190814182747.jpg,イオンスタイル仙台卸町店,7120,宮城,583,い,2019/8/14 18:27,2-1_all_corrected,100,68,270,362,370,430
170667,30076_20190814120337.jpg,ヤマダ電機なんば,3939,京都,338,み,2019/8/14 12:03,2-1_all_corrected,88,64,264,222,352,286
170436,30072_20190814102644.jpg,関西スーパー京阪大和田１F,7182,奈良,400,た,2019/8/14 10:26,2-1_all_corrected,46,31,153,54,199,85
171517,30157_20190814175914.jpg,関西スーパー中央,**55,神戸,31,め,2019/8/14 17:58,2-1_all_corrected,42,43,433,195,475,238
171521,30144_20190814180208.jpg,イオン幕張,5571,習志野,580,つ,2019/8/14 18:01,2-1_all_corrected,61,42,207,167,268,209
171740,30072_20190814193537.jpg,関西スーパー京阪大和田１F,8877,大阪,333,ゆ,2019/8/14 19:35,2-1_all_corrected,72,59,393,167,465,226
171129,30144_20190814151324.jpg,イオン幕張,2381,千葉,503,つ,2019/8/14 15:13,2-1_all_corrected,62,40,138,167,200,207
171747,30063_20190814193854.jpg,コーナン相模原小山モール,9776,富士山,303,せ,2019/8/14 19:38,2-1_all_corrected,53,46,519,160,572,206
171778,30169_20190814195656.jpg,イオン相模原ショッピングセンター,7733,相模,532,の,2019/8/14 19:55,2-1_all_corrected,54,42,115,103,169,145
171315,30110_20190814163123.jpg,イオン金沢八景,1772,横浜,583,え,2019/8/14 16:30,2-1_all_corrected,86,64,321,200,407,264
171543,30073_20190814181106.jpg,関西スーパー京阪大和田２F,6970,神戸,303,ひ,2019/8/14 18:10,2-1_all_corrected,92,70,320,302,412,372
171559,30110_20190814181741.jpg,イオン金沢八景,9463,横浜,504,ゆ,2019/8/14 18:17,2-1_all_corrected,71,60,298,180,369,240
171592,30144_20190814183026.jpg,イオン幕張,7070,千葉,338,ひ,2019/8/14 18:30,2-1_all_corrected,69,49,270,203,339,252
171566,30103_20190814182014.jpg,八尾老原１丁目,**88,大阪,31,ら,2019/8/14 18:19,2-1_all_corrected,53,42,248,117,301,159
171308,30167_20190814162854.jpg,イオン東雲店,1212,熊本,348,す,2019/8/14 16:28,2-1_all_corrected,76,82,16,233,92,315
171337,30144_20190814164156.jpg,イオン幕張,7583,千葉,530,ひ,2019/8/14 16:41,2-1_all_corrected,54,38,175,107,229,145
171568,30078_20190814182121.jpg,イオンスタイル仙台卸町店,*874,仙台,580,の,2019/8/14 18:21,2-1_all_corrected,79,57,250,217,329,274
171930,30078_20190814215512.jpg,イオンスタイル仙台卸町店,***8,宮城,335,ね,2019/8/14 21:54,2-1_all_corrected,78,57,163,230,241,287
171765,30091_20190814194846.jpg,イトーヨーカドー木場 立体,7000,足立,325,ま,2019/8/14 19:48,2-1_all_corrected,85,61,438,245,523,306
171557,30144_20190814181726.jpg,イオン幕張,2836,熊谷,580,む,2019/8/14 18:16,2-1_all_corrected,91,61,222,343,313,404
171791,30169_20190814200446.jpg,イオン相模原ショッピングセンター,1001,相模,534,そ,2019/8/14 20:04,2-1_all_corrected,56,46,173,130,229,176
170471,30072_20190814104128.jpg,関西スーパー京阪大和田１F,1747,大阪,481,り,2019/8/14 10:41,2-1_all_corrected,69,58,108,236,177,294
171550,30110_20190814181348.jpg,イオン金沢八景,*620,横浜,346,ひ,2019/8/14 18:13,2-1_all_corrected,66,66,511,130,577,196
170482,30144_20190814104742.jpg,イオン幕張,*714,多摩,337,め,2019/8/14 10:47,2-1_all_corrected,80,62,343,325,423,387
171194,30144_20190814154544.jpg,イオン幕張,2378,千葉,332,ち,2019/8/14 15:45,2-1_all_corrected,53,37,159,116,212,153
171963,30079_20190814223713.jpg,ピットデザイン仙台卸町駅前駐車場,5910,仙台,330,て,2019/8/14 22:36,2-1_all_corrected,71,51,280,172,351,223
171167,30110_20190814153107.jpg,イオン金沢八景,6486,横浜,504,ね,2019/8/14 15:30,2-1_all_corrected,64,59,9,197,73,256
171193,30014_20190814154522.jpg,フォルテ蘇我ベルク棟,**11,千葉,31,さ,2019/8/14 15:45,2-1_all_corrected,49,75,25,101,74,176
171158,30072_20190814152840.jpg,関西スーパー京阪大和田１F,8956,奈良,580,や,2019/8/14 15:27,2-1_all_corrected,82,63,92,186,174,249
171535,30157_20190814180635.jpg,関西スーパー中央,5123,神戸,504,す,2019/8/14 18:06,2-1_all_corrected,47,66,340,196,387,262
170413,30072_20190814101350.jpg,関西スーパー京阪大和田１F,*135,大阪,584,ふ,2019/8/14 10:13,2-1_all_corrected,82,62,325,175,407,237
170887,30157_20190814130101.jpg,関西スーパー中央,**10,神戸,31,つ,2019/8/14 13:00,2-1_all_corrected,65,56,73,375,138,431
170448,30157_20190814103109.jpg,関西スーパー中央,*878,神戸,584,さ,2019/8/14 10:30,2-1_all_corrected,67,57,126,323,193,380
171135,30078_20190814151645.jpg,イオンスタイル仙台卸町店,3118,新潟,300,ろ,2019/8/14 15:16,2-1_all_corrected,57,42,337,82,394,124
170470,30167_20190814104034.jpg,イオン東雲店,1813,足立,331,す,2019/8/14 10:40,2-1_all_corrected,69,62,186,158,255,220
171556,30091_20190814181623.jpg,イトーヨーカドー木場 立体,3968,足立,57,ろ,2019/8/14 18:15,2-1_all_corrected,73,60,335,169,408,229
170479,30078_20190814104601.jpg,イオンスタイル仙台卸町店,2755,仙台,583,い,2019/8/14 10:45,2-1_all_corrected,75,50,266,133,341,183
171157,30144_20190814152831.jpg,イオン幕張,6711,千葉,501,は,2019/8/14 15:28,2-1_all_corrected,73,49,211,221,284,270
171396,30078_20190814170523.jpg,イオンスタイル仙台卸町店,8944,仙台,580,も,2019/8/14 17:04,2-1_all_corrected,68,55,176,117,244,172
171739,30072_20190814193531.jpg,関西スーパー京阪大和田１F,9216,奈良,330,あ,2019/8/14 19:35,2-1_all_corrected,46,37,195,27,241,64
170790,30144_20190814124516.jpg,イオン幕張,1026,千葉,544,ぬ,2019/8/14 12:44,2-1_all_corrected,59,39,254,158,313,197
171828,30079_20190814202628.jpg,ピットデザイン仙台卸町駅前駐車場,2031,仙台,330,て,2019/8/14 20:26,2-1_all_corrected,76,75,249,266,325,341
171484,30167_20190814174559.jpg,イオン東雲店,4505,足立,481,り,2019/8/14 17:45,2-1_all_corrected,49,39,273,172,322,211
171479,30144_20190814174329.jpg,イオン幕張,1188,足立,585,あ,2019/8/14 17:42,2-1_all_corrected,58,40,138,143,196,183
170594,30110_20190814113559.jpg,イオン金沢八景,4914,横浜,583,き,2019/8/14 11:35,2-1_all_corrected,68,54,396,147,464,201
170567,30072_20190814112643.jpg,関西スーパー京阪大和田１F,6814,なにわ,800,あ,2019/8/14 11:26,2-1_all_corrected,55,47,47,164,102,211
170593,30110_20190814113525.jpg,イオン金沢八景,***1,横浜,368,や,2019/8/14 11:35,2-1_all_corrected,75,65,107,241,182,306
170533,30169_20190814111207.jpg,イオン相模原ショッピングセンター,6157,多摩,330,さ,2019/8/14 11:11,2-1_all_corrected,53,42,240,176,293,218
171627,30169_20190814184704.jpg,イオン相模原ショッピングセンター,**44,相模,583,に,2019/8/14 18:46,2-1_all_corrected,98,75,317,354,415,429
170391,30072_20190814100350.jpg,関西スーパー京阪大和田１F,8572,なにわ,800,す,2019/8/14 10:03,2-1_all_corrected,56,45,325,137,381,182
171288,30110_20190814161948.jpg,イオン金沢八景,*235,横浜,533,ほ,2019/8/14 16:19,2-1_all_corrected,72,56,351,167,423,223
171618,30078_20190814184125.jpg,イオンスタイル仙台卸町店,***2,仙台,341,と,2019/8/14 18:41,2-1_all_corrected,95,64,261,319,356,383
170502,30078_20190814105707.jpg,イオンスタイル仙台卸町店,*827,宮城,583,を,2019/8/14 10:56,2-1_all_corrected,97,72,133,358,230,430
170737,30167_20190814122453.jpg,イオン東雲店,8201,足立,430,す,2019/8/14 12:24,2-1_all_corrected,51,38,318,147,369,185
170398,30001_20190814100712.jpg,関西スーパー高石駅前,5454,和泉,530,み,2019/8/14 10:06,2-1_all_corrected,81,58,392,160,473,218
171681,30091_20190814190759.jpg,イトーヨーカドー木場 立体,**23,足立,366,ろ,2019/8/14 19:07,2-1_all_corrected,63,57,104,215,167,272
171211,30144_20190814154951.jpg,イオン幕張,3143,千葉,302,ね,2019/8/14 15:49,2-1_all_corrected,63,44,191,199,254,243
171447,30001_20190814172928.jpg,関西スーパー高石駅前,***8,和泉,30,ふ,2019/8/14 17:29,2-1_all_corrected,95,68,222,274,317,342
171675,30167_20190814190554.jpg,イオン東雲店,7378,足立,330,ち,2019/8/14 19:05,2-1_all_corrected,53,41,336,255,389,296
170791,30085_20190814124530.jpg,業務スーパー南津守,1000,なにわ,30,む,2019/8/14 12:45,2-1_all_corrected,41,48,98,274,139,322
171449,30169_20190814173010.jpg,イオン相模原ショッピングセンター,7007,相模,344,と,2019/8/14 17:29,2-1_all_corrected,74,52,344,168,418,220
171610,30062_20190814183840.jpg,ミスミモール,**55,和泉,31,ほ,2019/8/14 18:38,2-1_all_corrected,70,60,221,150,291,210
170352,30073_20190814094336.jpg,関西スーパー京阪大和田２F,**11,大阪,31,ま,2019/8/14 9:43,2-1_all_corrected,77,57,350,88,427,145
170709,30169_20190814121336.jpg,イオン相模原ショッピングセンター,*202,相模,532,め,2019/8/14 12:13,2-1_all_corrected,83,65,285,230,368,295
170964,30111_20190814134658.jpg,イオン稲毛,*222,千葉,591,か,2019/8/14 13:46,2-1_all_corrected,53,41,340,137,393,178
171413,30090_20190814171635.jpg,イトーヨーカドー木場 西棟,6000,足立,302,と,2019/8/14 17:16,2-1_all_corrected,78,61,383,267,461,328
171880,30167_20190814212354.jpg,イオン東雲店,1000,滋賀,359,む,2019/8/14 21:23,2-1_all_corrected,56,47,371,315,427,362
170952,30167_20190814134121.jpg,イオン東雲店,1517,世田谷,480,り,2019/8/14 13:40,2-1_all_corrected,84,69,114,368,198,437
151601,30110_20190804124811.jpg,イオン金沢八景,7186,川崎,300,さ,2019/8/4 12:47,2-1_all_corrected,48,37,407,60,455,97
151265,30110_20190804111342.jpg,イオン金沢八景,3104,横浜,505,す,2019/8/4 11:12,2-1_all_corrected,43,35,81,111,124,146
153158,30078_20190804182955.jpg,イオンスタイル仙台卸町店,6072,仙台,300,よ,2019/8/4 18:29,2-1_all_corrected,73,57,199,64,272,121
151836,30110_20190804135651.jpg,イオン金沢八景,3687,横浜,581,う,2019/8/4 13:55,2-1_all_corrected,54,46,75,215,129,261
151809,30085_20190804134959.jpg,業務スーパー南津守,***1,和泉,30,る,2019/8/4 13:49,2-1_all_corrected,66,59,118,384,184,443
152829,30078_20190804175129.jpg,イオンスタイル仙台卸町店,*303,仙台,330,け,2019/8/4 17:49,2-1_all_corrected,77,64,171,150,248,214
152820,30078_20190804175043.jpg,イオンスタイル仙台卸町店,2021,奄美,330,の,2019/8/4 17:47,2-1_all_corrected,54,47,205,90,259,137
152827,30078_20190804175114.jpg,イオンスタイル仙台卸町店,3998,仙台,501,え,2019/8/4 17:48,2-1_all_corrected,73,53,307,133,380,186
152686,30078_20190804172816.jpg,イオンスタイル仙台卸町店,8184,仙台,588,と,2019/8/4 17:26,2-1_all_corrected,72,51,244,98,316,149
153195,30110_20190804183923.jpg,イオン金沢八景,*727,横浜,360,す,2019/8/4 18:38,2-1_all_corrected,48,41,501,61,549,102
152888,30078_20190804180132.jpg,イオンスタイル仙台卸町店,8888,仙台,317,む,2019/8/4 17:58,2-1_all_corrected,72,54,350,164,422,218
152286,30078_20190804155533.jpg,イオンスタイル仙台卸町店,8980,宮城,501,つ,2019/8/4 15:49,2-1_all_corrected,77,57,194,185,271,242
150984,30072_20190804083313.jpg,関西スーパー京阪大和田１F,*762,京都,800,せ,2019/8/4 8:32,2-1_all_corrected,70,56,200,229,270,285
151638,30167_20190804125912.jpg,イオン東雲店,*226,品川,300,る,2019/8/4 12:58,2-1_all_corrected,71,53,250,226,321,279
151290,30060_20190804112005.jpg,関西スーパー小野原,4277,大阪,302,に,2019/8/4 11:19,2-1_all_corrected,71,70,521,285,592,355
152886,30078_20190804180123.jpg,イオンスタイル仙台卸町店,*125,湘南,532,そ,2019/8/4 17:57,2-1_all_corrected,67,57,169,96,236,153
152817,30078_20190804175027.jpg,イオンスタイル仙台卸町店,1413,福島,300,に,2019/8/4 17:47,2-1_all_corrected,90,65,365,323,455,388
153338,30169_20190804192553.jpg,イオン相模原ショッピングセンター,1113,相模,583,て,2019/8/4 19:25,2-1_all_corrected,74,63,399,266,473,329
151837,30157_20190804135714.jpg,関西スーパー中央,1791,神戸,581,の,2019/8/4 13:56,2-1_all_corrected,49,72,310,320,359,392
152353,30111_20190804161225.jpg,イオン稲毛,*417,千葉,536,つ,2019/8/4 16:12,2-1_all_corrected,55,46,254,163,309,209
151389,30110_20190804114713.jpg,イオン金沢八景,5409,横浜,303,も,2019/8/4 11:46,2-1_all_corrected,49,34,190,59,239,93
153288,30072_20190804191101.jpg,関西スーパー京阪大和田１F,1001,奈良,383,る,2019/8/4 19:10,2-1_all_corrected,59,45,76,143,135,188
151719,30110_20190804132143.jpg,イオン金沢八景,1995,横浜,581,き,2019/8/4 13:21,2-1_all_corrected,75,56,302,232,377,288
152755,30078_20190804174235.jpg,イオンスタイル仙台卸町店,*634,仙台,530,め,2019/8/4 17:41,2-1_all_corrected,97,74,207,319,304,393
153210,30066_20190804184418.jpg,ジョーシン和泉中央,**11,和泉,31,み,2019/8/4 18:43,2-1_all_corrected,74,57,196,198,270,255
153446,30110_20190804201228.jpg,イオン金沢八景,8088,横浜,50,も,2019/8/4 20:12,2-1_all_corrected,83,65,354,180,437,245
153219,30110_20190804184928.jpg,イオン金沢八景,2783,横浜,330,え,2019/8/4 18:48,2-1_all_corrected,84,71,48,260,132,331
153470,30169_20190804202410.jpg,イオン相模原ショッピングセンター,3862,相模,300,の,2019/8/4 20:23,2-1_all_corrected,88,69,389,336,477,405
153014,30060_20190804181351.jpg,関西スーパー小野原,5491,大阪,580,な,2019/8/4 18:12,2-1_all_corrected,88,65,282,359,370,424
151585,30110_20190804124312.jpg,イオン金沢八景,1698,横浜,580,は,2019/8/4 12:42,2-1_all_corrected,50,42,111,208,161,250
152338,30083_20190804160815.jpg,フォーエルナゴヤドーム駅前,2525,名古屋,31,ふ,2019/8/4 16:07,2-1_all_corrected,52,39,376,177,428,216
152307,30060_20190804160205.jpg,関西スーパー小野原,4098,大阪,300,せ,2019/8/4 16:01,2-1_all_corrected,37,38,398,13,435,51
153414,30110_20190804200035.jpg,イオン金沢八景,7535,横浜,589,つ,2019/8/4 19:59,2-1_all_corrected,45,35,472,56,517,91
153077,30078_20190804182022.jpg,イオンスタイル仙台卸町店,5508,仙台,500,て,2019/8/4 18:19,2-1_all_corrected,72,54,173,109,245,163
151512,30078_20190804122235.jpg,イオンスタイル仙台卸町店,2103,仙台,330,ぬ,2019/8/4 12:22,2-1_all_corrected,53,44,310,68,363,112
153287,30072_20190804191058.jpg,関西スーパー京阪大和田１F,1001,奈良,383,る,2019/8/4 19:10,2-1_all_corrected,80,61,173,228,253,289
152193,30169_20190804152844.jpg,イオン相模原ショッピングセンター,*111,相模,356,ひ,2019/8/4 15:28,2-1_all_corrected,75,57,314,163,389,220
151375,30110_20190804114431.jpg,イオン金沢八景,*213,横浜,347,ま,2019/8/4 11:44,2-1_all_corrected,45,40,428,58,473,98
152963,30078_20190804180811.jpg,イオンスタイル仙台卸町店,4138,仙台,500,え,2019/8/4 18:07,2-1_all_corrected,70,56,319,102,389,158
152796,30078_20190804174558.jpg,イオンスタイル仙台卸町店,*238,仙台,530,ぬ,2019/8/4 17:45,2-1_all_corrected,83,61,230,227,313,288
152550,30085_20190804170404.jpg,業務スーパー南津守,1001,なにわ,31,す,2019/8/4 17:03,2-1_all_corrected,69,54,475,239,544,293
151583,30060_20190804124226.jpg,関西スーパー小野原,**88,大阪,31,ね,2019/8/4 12:41,2-1_all_corrected,65,57,379,282,444,339
151319,30110_20190804113007.jpg,イオン金沢八景,1458,横浜,530,ひ,2019/8/4 11:29,2-1_all_corrected,95,77,311,201,406,278
153227,30111_20190804185213.jpg,イオン稲毛,***1,千葉,30,ぬ,2019/8/4 18:51,2-1_all_corrected,69,53,313,180,382,233
152561,30078_20190804170611.jpg,イオンスタイル仙台卸町店,9384,宮城,550,そ,2019/8/4 17:05,2-1_all_corrected,60,41,285,127,345,168
151774,30085_20190804133613.jpg,業務スーパー南津守,***8,なにわ,304,も,2019/8/4 13:35,2-1_all_corrected,41,32,470,182,511,214
153440,30169_20190804201134.jpg,イオン相模原ショッピングセンター,5220,多摩,590,て,2019/8/4 20:11,2-1_all_corrected,93,76,365,330,458,406
152544,30169_20190804170232.jpg,イオン相模原ショッピングセンター,*937,相模,502,の,2019/8/4 17:02,2-1_all_corrected,89,76,431,367,520,443
153001,30110_20190804181249.jpg,イオン金沢八景,3822,横浜,580,よ,2019/8/4 18:11,2-1_all_corrected,76,58,356,237,432,295
151769,30110_20190804133354.jpg,イオン金沢八景,5590,横浜,583,た,2019/8/4 13:33,2-1_all_corrected,76,55,318,226,394,281
152572,30078_20190804170808.jpg,イオンスタイル仙台卸町店,7103,秋田,589,か,2019/8/4 17:07,2-1_all_corrected,85,61,134,261,219,322
152348,30023_20190804161154.jpg,ピットデザイン山科東野,7777,京都,522,み,2019/8/4 16:11,2-1_all_corrected,78,60,281,73,359,133
153251,30063_20190804185951.jpg,コーナン相模原小山モール,*689,八王子,533,す,2019/8/4 18:59,2-1_all_corrected,70,61,503,272,573,333
151734,30169_20190804132421.jpg,イオン相模原ショッピングセンター,9041,野田,300,さ,2019/8/4 13:23,2-1_all_corrected,58,29,181,208,239,237
153407,30169_20190804195911.jpg,イオン相模原ショッピングセンター,*999,相模,589,さ,2019/8/4 19:58,2-1_all_corrected,74,60,260,110,334,170
153267,30078_20190804190436.jpg,イオンスタイル仙台卸町店,8888,仙台,336,み,2019/8/4 19:04,2-1_all_corrected,75,57,313,194,388,251
152722,30078_20190804173706.jpg,イオンスタイル仙台卸町店,*962,仙台,302,ほ,2019/8/4 17:36,2-1_all_corrected,72,55,346,166,418,221
152580,30078_20190804171000.jpg,イオンスタイル仙台卸町店,*555,仙台,580,て,2019/8/4 17:09,2-1_all_corrected,77,58,277,212,354,270
153232,30111_20190804185320.jpg,イオン稲毛,5698,千葉,330,す,2019/8/4 18:53,2-1_all_corrected,69,55,257,195,326,250
152313,30078_20190804160324.jpg,イオンスタイル仙台卸町店,***8,品川,397,や,2019/8/4 16:02,2-1_all_corrected,79,56,262,211,341,267
152748,30078_20190804174119.jpg,イオンスタイル仙台卸町店,*636,仙台,501,ち,2019/8/4 17:40,2-1_all_corrected,82,62,301,235,383,297
152378,30169_20190804161919.jpg,イオン相模原ショッピングセンター,*619,相模,532,ま,2019/8/4 16:18,2-1_all_corrected,85,64,301,126,386,190
152723,30078_20190804173711.jpg,イオンスタイル仙台卸町店,*962,仙台,300,ほ,2019/8/4 17:36,2-1_all_corrected,92,61,360,372,452,433
153261,30078_20190804190252.jpg,イオンスタイル仙台卸町店,1001,仙台,348,ら,2019/8/4 19:02,2-1_all_corrected,77,58,357,233,434,291
151538,30078_20190804123022.jpg,イオンスタイル仙台卸町店,1010,仙台,347,に,2019/8/4 12:29,2-1_all_corrected,92,65,283,324,375,389
152712,30072_20190804173423.jpg,関西スーパー京阪大和田１F,8803,大阪,583,い,2019/8/4 17:33,2-1_all_corrected,76,59,257,151,333,210
151993,30169_20190804144221.jpg,イオン相模原ショッピングセンター,7475,相模,580,め,2019/8/4 14:41,2-1_all_corrected,83,67,244,245,327,312
152371,30169_20190804161546.jpg,イオン相模原ショッピングセンター,9709,相模,502,ぬ,2019/8/4 16:15,2-1_all_corrected,80,62,313,111,393,173
153257,30041_20190804190053.jpg,ライフ宮内,2887,三重,58,め,2019/8/4 19:00,2-1_all_corrected,70,60,478,272,548,332
151640,30078_20190804125954.jpg,イオンスタイル仙台卸町店,5359,尾張小牧,480,か,2019/8/4 12:59,2-1_all_corrected,41,36,169,1,210,37
151224,30110_20190804105720.jpg,イオン金沢八景,2340,横浜,330,る,2019/8/4 10:56,2-1_all_corrected,91,71,296,203,387,274
153128,30078_20190804182601.jpg,イオンスタイル仙台卸町店,7685,仙台,500,ち,2019/8/4 18:25,2-1_all_corrected,72,52,247,87,319,139
152658,30078_20190804172204.jpg,イオンスタイル仙台卸町店,8882,仙台,500,な,2019/8/4 17:21,2-1_all_corrected,77,54,304,202,381,256
151647,30169_20190804130112.jpg,イオン相模原ショッピングセンター,**72,相模,580,と,2019/8/4 13:00,2-1_all_corrected,74,60,326,85,400,145
153126,30110_20190804182552.jpg,イオン金沢八景,1203,横浜,541,ゆ,2019/8/4 18:24,2-1_all_corrected,51,49,545,167,596,216
151488,30110_20190804121244.jpg,イオン金沢八景,1022,横浜,539,め,2019/8/4 12:11,2-1_all_corrected,51,39,331,117,382,156
153313,30081_20190804191839.jpg,サニー福重,*825,福岡,345,に,2019/8/4 19:17,2-1_all_corrected,87,64,239,316,326,380
151649,30111_20190804130116.jpg,イオン稲毛,8000,袖ヶ浦,364,ろ,2019/8/4 13:00,2-1_all_corrected,67,58,310,197,377,255
152857,30110_20190804175801.jpg,イオン金沢八景,2525,横浜,519,ろ,2019/8/4 17:57,2-1_all_corrected,86,60,321,200,407,260
153529,30169_20190804210824.jpg,イオン相模原ショッピングセンター,8008,相模,361,ら,2019/8/4 21:07,2-1_all_corrected,73,62,316,67,389,129
152861,30078_20190804175920.jpg,イオンスタイル仙台卸町店,8839,仙台,330,て,2019/8/4 17:52,2-1_all_corrected,80,63,180,197,260,260
152895,30078_20190804180156.jpg,イオンスタイル仙台卸町店,1001,仙台,540,に,2019/8/4 17:58,2-1_all_corrected,74,52,244,122,318,174
152250,30110_20190804154235.jpg,イオン金沢八景,4038,練馬,330,む,2019/8/4 15:41,2-1_all_corrected,51,40,443,114,494,154
153376,30169_20190804194529.jpg,イオン相模原ショッピングセンター,1113,相模,583,も,2019/8/4 19:45,2-1_all_corrected,52,43,53,95,105,138
152866,30078_20190804180001.jpg,イオンスタイル仙台卸町店,4447,仙台,300,く,2019/8/4 17:53,2-1_all_corrected,68,56,224,85,292,141
152006,30169_20190804144523.jpg,イオン相模原ショッピングセンター,***8,湘南,368,ほ,2019/8/4 14:44,2-1_all_corrected,72,61,291,223,363,284
153127,30078_20190804182555.jpg,イオンスタイル仙台卸町店,7685,仙台,500,ら,2019/8/4 18:25,2-1_all_corrected,72,52,247,87,319,139
152657,30078_20190804172159.jpg,イオンスタイル仙台卸町店,8882,豊橋,580,な,2019/8/4 17:21,2-1_all_corrected,72,53,301,154,373,207
151825,30110_20190804135359.jpg,イオン金沢八景,*996,横浜,304,の,2019/8/4 13:53,2-1_all_corrected,92,74,103,252,195,326
152666,30111_20190804172336.jpg,イオン稲毛,8888,千葉,386,て,2019/8/4 17:23,2-1_all_corrected,65,54,385,200,450,254
153586,30078_20190804220331.jpg,イオンスタイル仙台卸町店,6000,仙台,332,の,2019/8/4 22:03,2-1_all_corrected,79,56,349,320,428,376
152030,30169_20190804145103.jpg,イオン相模原ショッピングセンター,**23,相模,580,ゆ,2019/8/4 14:50,2-1_all_corrected,87,69,189,157,276,226
152867,30078_20190804180007.jpg,イオンスタイル仙台卸町店,4447,仙台,300,も,2019/8/4 17:53,2-1_all_corrected,75,61,245,133,320,194
151088,30078_20190804100900.jpg,イオンスタイル仙台卸町店,*212,宮城,584,を,2019/8/4 10:08,2-1_all_corrected,77,62,177,189,254,251
152064,30110_20190804145759.jpg,イオン金沢八景,9990,横浜,303,み,2019/8/4 14:57,2-1_all_corrected,48,40,221,69,269,109
153377,30169_20190804194533.jpg,イオン相模原ショッピングセンター,1113,相模,583,や,2019/8/4 19:45,2-1_all_corrected,53,42,74,114,127,156
152407,30078_20190804162308.jpg,イオンスタイル仙台卸町店,7325,仙台,590,い,2019/8/4 16:22,2-1_all_corrected,84,59,356,340,440,399
153528,30110_20190804210753.jpg,イオン金沢八景,2684,前橋,400,さ,2019/8/4 21:07,2-1_all_corrected,66,53,416,99,482,152
151411,30001_20190804115408.jpg,関西スーパー高石駅前,7788,和泉,556,む,2019/8/4 11:53,2-1_all_corrected,91,66,289,179,380,245
151660,30062_20190804130348.jpg,ミスミモール,1010,神戸,31,み,2019/8/4 13:03,2-1_all_corrected,54,47,373,130,427,177
152823,30078_20190804175053.jpg,イオンスタイル仙台卸町店,2487,山形,500,な,2019/8/4 17:47,2-1_all_corrected,68,55,205,99,273,154
151850,30169_20190804135943.jpg,イオン相模原ショッピングセンター,*205,横浜,504,ゆ,2019/8/4 13:59,2-1_all_corrected,79,63,258,203,337,266
152613,30079_20190804171533.jpg,ピットデザイン仙台卸町駅前駐車場,3696,仙台,300,ふ,2019/8/4 17:14,2-1_all_corrected,58,42,354,139,412,181
152846,30078_20190804175232.jpg,イオンスタイル仙台卸町店,2669,仙台,500,ま,2019/8/4 17:51,2-1_all_corrected,58,45,336,134,394,179
151439,30110_20190804120027.jpg,イオン金沢八景,8756,横浜,304,に,2019/8/4 11:59,2-1_all_corrected,90,63,269,272,359,335
153597,30111_20190804221506.jpg,イオン稲毛,9389,習志野,330,そ,2019/8/4 22:14,2-1_all_corrected,53,45,187,147,240,192
151659,30169_20190804130307.jpg,イオン相模原ショッピングセンター,5888,湘南,301,め,2019/8/4 13:02,2-1_all_corrected,87,64,266,107,353,171
153357,30111_20190804193607.jpg,イオン稲毛,8015,習志野,503,そ,2019/8/4 19:35,2-1_all_corrected,69,55,421,224,490,279
151635,30001_20190804125849.jpg,関西スーパー高石駅前,1228,和泉,584,こ,2019/8/4 12:58,2-1_all_corrected,88,65,391,161,479,226
153361,30062_20190804193730.jpg,ミスミモール,**18,神戸,31,う,2019/8/4 19:36,2-1_all_corrected,54,43,375,135,429,178
151099,30169_20190804101515.jpg,イオン相模原ショッピングセンター,9041,野田,300,さ,2019/8/4 10:14,2-1_all_corrected,63,33,402,54,465,87
152278,30001_20190804155037.jpg,関西スーパー高石駅前,5223,堺,500,と,2019/8/4 15:50,2-1_all_corrected,75,53,461,98,536,151
153019,30078_20190804181426.jpg,イオンスタイル仙台卸町店,7261,仙台,300,や,2019/8/4 18:13,2-1_all_corrected,78,59,230,179,308,238
151785,30060_20190804134152.jpg,関西スーパー小野原,**88,大阪,31,ね,2019/8/4 13:41,2-1_all_corrected,74,61,368,203,442,264
151111,30169_20190804101814.jpg,イオン相模原ショッピングセンター,4863,奈良,580,も,2019/8/4 10:17,2-1_all_corrected,53,36,156,78,209,114
151323,30163_20190804113036.jpg,コープ葛飾白鳥店(地上),3683,足立,501,す,2019/8/4 11:30,2-1_all_corrected,67,41,316,224,383,265
153285,30078_20190804191034.jpg,イオンスタイル仙台卸町店,*505,宮城,334,ろ,2019/8/4 19:10,2-1_all_corrected,94,67,334,363,428,430
153282,30072_20190804191020.jpg,関西スーパー京阪大和田１F,1211,大阪,480,ち,2019/8/4 19:09,2-1_all_corrected,85,71,225,307,310,378
152702,30078_20190804173145.jpg,イオンスタイル仙台卸町店,5301,仙台,503,あ,2019/8/4 17:30,2-1_all_corrected,98,60,245,365,343,425
151725,30078_20190804132253.jpg,イオンスタイル仙台卸町店,1489,仙台,500,さ,2019/8/4 13:22,2-1_all_corrected,71,50,294,138,365,188
152950,30078_20190804180709.jpg,イオンスタイル仙台卸町店,1002,仙台,539,ぬ,2019/8/4 18:06,2-1_all_corrected,78,59,208,182,286,241
153472,30110_20190804202600.jpg,イオン金沢八景,3805,横浜,330,は,2019/8/4 20:25,2-1_all_corrected,49,37,412,53,461,90
151779,30078_20190804133723.jpg,イオンスタイル仙台卸町店,5359,尾張小牧,480,か,2019/8/4 13:36,2-1_all_corrected,84,55,260,298,344,353
151746,30078_20190804132823.jpg,イオンスタイル仙台卸町店,2525,大阪,702,な,2019/8/4 13:27,2-1_all_corrected,92,59,235,284,327,343
153475,30110_20190804202633.jpg,イオン金沢八景,*411,横浜,343,て,2019/8/4 20:25,2-1_all_corrected,50,43,245,68,295,111
153488,30098_20190804203442.jpg,BRANCH仙台（東棟）,*211,仙台,333,ぬ,2019/8/4 20:34,2-1_all_corrected,101,71,219,308,320,379
152333,30169_20190804160743.jpg,イオン相模原ショッピングセンター,7005,相模,501,す,2019/8/4 16:07,2-1_all_corrected,86,64,277,120,363,184
152360,30169_20190804161341.jpg,イオン相模原ショッピングセンター,4694,伊豆,500,す,2019/8/4 16:13,2-1_all_corrected,83,65,276,134,359,199
151949,30060_20190804143013.jpg,関西スーパー小野原,2233,大阪,584,と,2019/8/4 14:29,2-1_all_corrected,40,31,427,132,467,163
152951,30060_20190804180715.jpg,関西スーパー小野原,5504,大阪,481,り,2019/8/4 18:06,2-1_all_corrected,36,33,168,211,204,244
153279,30079_20190804190913.jpg,ピットデザイン仙台卸町駅前駐車場,***9,仙台,530,は,2019/8/4 19:08,2-1_all_corrected,47,38,418,187,465,225
153045,30078_20190804181638.jpg,イオンスタイル仙台卸町店,8005,仙台,300,て,2019/8/4 18:16,2-1_all_corrected,75,55,271,102,346,157
151520,30169_20190804122507.jpg,イオン相模原ショッピングセンター,4120,相模,501,さ,2019/8/4 12:24,2-1_all_corrected,82,67,254,124,336,191
153283,30001_20190804191021.jpg,関西スーパー高石駅前,1122,和泉,31,ち,2019/8/4 19:09,2-1_all_corrected,100,75,244,284,344,359
152190,30169_20190804152616.jpg,イオン相模原ショッピングセンター,1679,多摩,302,ふ,2019/8/4 15:25,2-1_all_corrected,88,65,307,151,395,216
152513,30110_20190804165108.jpg,イオン金沢八景,1210,横浜,584,ひ,2019/8/4 16:50,2-1_all_corrected,68,59,442,246,510,305
153069,30078_20190804181957.jpg,イオンスタイル仙台卸町店,8218,仙台,501,そ,2019/8/4 18:19,2-1_all_corrected,100,72,160,343,260,415
153492,30072_20190804203644.jpg,関西スーパー京阪大和田１F,*313,大阪,342,の,2019/8/4 20:35,2-1_all_corrected,66,56,324,66,390,122
151752,30078_20190804132944.jpg,イオンスタイル仙台卸町店,8228,仙台,331,ひ,2019/8/4 13:29,2-1_all_corrected,57,41,274,114,331,155
152781,30078_20190804174513.jpg,イオンスタイル仙台卸町店,1230,仙台,333,も,2019/8/4 17:43,2-1_all_corrected,72,57,249,134,321,191
152585,30078_20190804171058.jpg,イオンスタイル仙台卸町店,8472,仙台,550,ふ,2019/8/4 17:10,2-1_all_corrected,76,56,196,141,272,197
153468,30111_20190804202156.jpg,イオン稲毛,**18,千葉,344,ら,2019/8/4 20:21,2-1_all_corrected,56,44,264,183,320,227
152911,30078_20190804180307.jpg,イオンスタイル仙台卸町店,1604,富山,501,む,2019/8/4 18:01,2-1_all_corrected,53,43,298,96,351,139
153291,30157_20190804191134.jpg,関西スーパー中央,**55,神戸,31,め,2019/8/4 19:11,2-1_all_corrected,52,45,133,361,185,406
152716,30070_20190804173448.jpg,カナートモール住道第一,2277,大坂,303,ち,2019/8/4 17:33,2-1_all_corrected,81,69,38,280,119,349
151503,30110_20190804121753.jpg,イオン金沢八景,*321,横浜,358,む,2019/8/4 12:17,2-1_all_corrected,47,33,88,53,135,86
151160,30110_20190804103740.jpg,イオン金沢八景,8084,横浜,560,ひ,2019/8/4 10:36,2-1_all_corrected,80,56,322,229,402,285
152375,30157_20190804161737.jpg,関西スーパー中央,***5,神戸,30,ふ,2019/8/4 16:16,2-1_all_corrected,61,62,119,225,180,287
151762,30157_20190804133119.jpg,関西スーパー中央,***1,神戸,30,や,2019/8/4 13:30,2-1_all_corrected,54,40,154,312,208,352
151550,30169_20190804123350.jpg,イオン相模原ショッピングセンター,9221,相模,580,め,2019/8/4 12:33,2-1_all_corrected,57,43,290,137,347,180
152745,30078_20190804174035.jpg,イオンスタイル仙台卸町店,*121,仙台,330,も,2019/8/4 17:39,2-1_all_corrected,70,53,331,192,401,245
152319,30071_20190804160518.jpg,カナートモール住道第二,***2,大阪,30,ね,2019/8/4 16:04,2-1_all_corrected,43,43,431,120,474,163
151568,30110_20190804124010.jpg,イオン金沢八景,*176,横浜,583,い,2019/8/4 12:39,2-1_all_corrected,82,59,233,251,315,310
152865,30078_20190804175956.jpg,イオンスタイル仙台卸町店,8546,宮城,501,も,2019/8/4 17:53,2-1_all_corrected,70,57,153,133,223,190
151482,30110_20190804121042.jpg,イオン金沢八景,1396,横浜,505,ぬ,2019/8/4 12:10,2-1_all_corrected,53,44,93,107,146,151
152207,30169_20190804153248.jpg,イオン相模原ショッピングセンター,4162,札幌,501,ゆ,2019/8/4 15:32,2-1_all_corrected,87,66,225,61,312,127
152655,30110_20190804172129.jpg,イオン金沢八景,1181,横浜,334,は,2019/8/4 17:20,2-1_all_corrected,52,37,326,64,378,101
152863,30078_20190804175932.jpg,イオンスタイル仙台卸町店,6201,宮城,301,は,2019/8/4 17:52,2-1_all_corrected,95,66,213,289,308,355
152864,30078_20190804175950.jpg,イオンスタイル仙台卸町店,8546,宮城,58,む,2019/8/4 17:53,2-1_all_corrected,53,46,163,70,216,116
153141,30078_20190804182729.jpg,イオンスタイル仙台卸町店,2007,豊橋,532,さ,2019/8/4 18:26,2-1_all_corrected,73,57,173,100,246,157
152230,30066_20190804153840.jpg,ジョーシン和泉中央,**33,和泉,31,と,2019/8/4 15:37,2-1_all_corrected,55,42,343,173,398,215
152839,30110_20190804175204.jpg,イオン金沢八景,5432,横浜,304,な,2019/8/4 17:51,2-1_all_corrected,88,75,90,374,178,449
152461,30066_20190804163654.jpg,ジョーシン和泉中央,8008,和泉,-1,ま,2019/8/4 16:35,2-1_all_corrected,68,54,239,191,307,245
153311,30169_20190804191829.jpg,イオン相模原ショッピングセンター,2046,多摩,330,と,2019/8/4 19:18,2-1_all_corrected,81,65,291,118,372,183
151674,30072_20190804131013.jpg,関西スーパー京阪大和田１F,5712,大阪,502,わ,2019/8/4 13:09,2-1_all_corrected,52,43,276,114,328,157
151470,30110_20190804120825.jpg,イオン金沢八景,1104,横浜,352,さ,2019/8/4 12:07,2-1_all_corrected,51,44,47,178,98,222
153115,30078_20190804182442.jpg,イオンスタイル仙台卸町店,*413,札幌,504,く,2019/8/4 18:24,2-1_all_corrected,69,53,337,108,406,161
152206,30078_20190804153247.jpg,イオンスタイル仙台卸町店,1022,仙台,335,ま,2019/8/4 15:32,2-1_all_corrected,85,59,244,252,329,311
153582,30169_20190804220040.jpg,イオン相模原ショッピングセンター,9156,相模,483,あ,2019/8/4 22:00,2-1_all_corrected,100,68,393,344,493,412
149860,30078_20190803160446.jpg,イオンスタイル仙台卸町店,6089,仙台,580,に,2019/8/3 16:04,2-1_all_corrected,77,51,282,157,359,208
150515,30111_20190803191633.jpg,イオン稲毛,8111,千葉,531,と,2019/8/3 19:16,2-1_all_corrected,62,42,313,164,375,206
150718,30080_20190803205758.jpg,フォーレストモール新前橋,*383,群馬,580,る,2019/8/3 20:56,2-1_all_corrected,71,56,179,154,250,210
149063,30167_20190803113950.jpg,イオン東雲店,*364,品川,580,す,2019/8/3 11:38,2-1_all_corrected,46,36,287,110,333,146
150149,30111_20190803171606.jpg,イオン稲毛,3605,袖ヶ浦,100,さ,2019/8/3 17:15,2-1_all_corrected,51,41,238,136,289,177
150140,30066_20190803171519.jpg,ジョーシン和泉中央,**55,和泉,31,ち,2019/8/3 17:14,2-1_all_corrected,65,56,212,201,277,257
150524,30072_20190803192139.jpg,関西スーパー京阪大和田１F,*101,大阪,536,に,2019/8/3 19:20,2-1_all_corrected,45,36,394,61,439,97
150716,30169_20190803205744.jpg,イオン相模原ショッピングセンター,*308,相模,334,あ,2019/8/3 20:57,2-1_all_corrected,53,46,166,108,219,154
149294,30072_20190803125035.jpg,関西スーパー京阪大和田１F,3434,大阪,303,す,2019/8/3 12:50,2-1_all_corrected,56,43,160,93,216,136
150729,30156_20190803210331.jpg,万代 西神中央店,***3,神戸,403,め,2019/8/3 21:02,2-1_all_corrected,52,40,294,245,346,285
149001,30072_20190803112522.jpg,関西スーパー京阪大和田１F,**11,大阪,31,ま,2019/8/3 11:24,2-1_all_corrected,73,58,322,68,395,126
149650,30078_20190803145205.jpg,イオンスタイル仙台卸町店,**38,仙台,583,を,2019/8/3 14:50,2-1_all_corrected,77,53,277,179,354,232
148740,30085_20190803100130.jpg,業務スーパー南津守,8888,なにわ,30,ほ,2019/8/3 10:00,2-1_all_corrected,78,53,219,325,297,378
149030,30167_20190803113108.jpg,イオン東雲店,*364,品川,580,す,2019/8/3 11:30,2-1_all_corrected,72,51,175,225,247,276
150774,30078_20190803214158.jpg,イオンスタイル仙台卸町店,9981,仙台,300,は,2019/8/3 21:41,2-1_all_corrected,83,68,157,219,240,287
150546,30009_20190803192710.jpg,西友新北習志野,**11,習志野,337,も,2019/8/3 19:26,2-1_all_corrected,176,107,263,0,439,107
148912,30073_20190803110230.jpg,関西スーパー京阪大和田２F,**11,大阪,31,ま,2019/8/3 11:01,2-1_all_corrected,80,71,110,297,190,368
150141,30111_20190803171527.jpg,イオン稲毛,*406,千葉,500,そ,2019/8/3 17:15,2-1_all_corrected,38,33,80,80,118,113
150717,30169_20190803205754.jpg,イオン相模原ショッピングセンター,*308,相模,334,あ,2019/8/3 20:57,2-1_all_corrected,76,63,375,271,451,334
149257,30072_20190803124041.jpg,関西スーパー京阪大和田１F,3960,神戸,480,ふ,2019/8/3 12:40,2-1_all_corrected,72,56,123,222,195,278
150170,30066_20190803172405.jpg,ジョーシン和泉中央,1001,和泉,31,そ,2019/8/3 17:22,2-1_all_corrected,65,53,202,227,267,280
148779,30072_20190803101815.jpg,関西スーパー京阪大和田１F,*718,大阪,349,む,2019/8/3 10:17,2-1_all_corrected,42,28,139,30,181,58
148783,30072_20190803101941.jpg,関西スーパー京阪大和田１F,8172,大阪,530,に,2019/8/3 10:18,2-1_all_corrected,97,69,99,381,196,450
149007,30157_20190803112653.jpg,関西スーパー中央,***1,神戸,30,や,2019/8/3 11:26,2-1_all_corrected,57,46,106,383,163,429
149656,30110_20190803145300.jpg,イオン金沢八景,2888,横浜,331,る,2019/8/3 14:52,2-1_all_corrected,99,71,287,168,386,239
150744,30072_20190803211458.jpg,関西スーパー京阪大和田１F,2659,大阪,581,ぬ,2019/8/3 21:14,2-1_all_corrected,50,38,143,115,193,153
150112,30111_20190803171132.jpg,イオン稲毛,*419,千葉,531,ゆ,2019/8/3 17:11,2-1_all_corrected,69,54,341,138,410,192
148859,30072_20190803104706.jpg,関西スーパー京阪大和田１F,***8,奈良,30,ひ,2019/8/3 10:46,2-1_all_corrected,70,55,166,283,236,338
150432,30103_20190803184550.jpg,八尾老原１丁目,8008,大阪,31,み,2019/8/3 18:45,2-1_all_corrected,89,66,288,250,377,316
150466,30133_20190803185740.jpg,イトーヨーカドー食品館厚木第1,*703,湘南,341,つ,2019/8/3 18:57,2-1_all_corrected,73,63,203,149,276,212
150654,30157_20190803201540.jpg,関西スーパー中央,**16,大阪,365,て,2019/8/3 20:15,2-1_all_corrected,47,40,53,399,100,439
149573,30045_20190803142339.jpg,マックスバリュー徳川明倫,*358,名古屋,32,ひ,2019/8/3 14:22,2-1_all_corrected,78,65,47,339,125,404
150665,30063_20190803202155.jpg,コーナン相模原小山モール,2727,相模,301,ほ,2019/8/3 20:21,2-1_all_corrected,69,53,475,178,544,231
149348,30111_20190803131259.jpg,イオン稲毛,2525,千葉,587,み,2019/8/3 13:12,2-1_all_corrected,55,45,292,163,347,208
149180,30072_20190803121616.jpg,関西スーパー京阪大和田１F,3156,大阪,400,ま,2019/8/3 12:15,2-1_all_corrected,43,32,261,43,304,75
150095,30169_20190803170825.jpg,イオン相模原ショッピングセンター,8883,仙台,300,は,2019/8/3 17:08,2-1_all_corrected,71,58,244,152,315,210
149118,30072_20190803120055.jpg,関西スーパー京阪大和田１F,***8,奈良,30,ひ,2019/8/3 12:00,2-1_all_corrected,73,54,209,168,282,222
150809,30071_20190803221401.jpg,カナートモール住道第二,9303,堺,-1,え,2019/8/3 22:13,2-1_all_corrected,57,43,233,125,290,168
148666,30123_20190803090524.jpg,イオン長浦（第５）,2079,袖ヶ浦,500,ら,2019/8/3 9:04,2-1_all_corrected,92,74,314,213,406,287
149575,30169_20190803142435.jpg,イオン相模原ショッピングセンター,4976,相模,502,ね,2019/8/3 14:24,2-1_all_corrected,79,62,290,97,369,159
149778,30111_20190803153659.jpg,イオン稲毛,5296,千葉,532,ぬ,2019/8/3 15:36,2-1_all_corrected,55,45,177,157,232,202
150683,30169_20190803203922.jpg,イオン相模原ショッピングセンター,7388,相模,331,ほ,2019/8/3 20:38,2-1_all_corrected,40,37,109,46,149,83
148643,30145_20190803083321.jpg,イオン高根木戸,*565,練馬,501,む,2019/8/3 8:32,2-1_all_corrected,54,43,270,71,324,114
149791,30078_20190803153906.jpg,イオンスタイル仙台卸町店,1002,仙台,583,を,2019/8/3 15:38,2-1_all_corrected,100,64,192,384,292,448
149557,30078_20190803141659.jpg,イオンスタイル仙台卸町店,***3,宮城,590,の,2019/8/3 14:16,2-1_all_corrected,76,49,282,236,358,285
150822,30157_20190803223007.jpg,関西スーパー中央,**16,大阪,368,て,2019/8/3 22:29,2-1_all_corrected,71,54,88,396,159,450
150684,30090_20190803204020.jpg,イトーヨーカドー木場 西棟,*911,足立,350,り,2019/8/3 20:39,2-1_all_corrected,85,64,151,273,236,337
150019,30072_20190803164607.jpg,関西スーパー京阪大和田１F,4753,大阪,581,こ,2019/8/3 16:45,2-1_all_corrected,75,52,396,186,471,238
150222,30111_20190803173516.jpg,イオン稲毛,*259,千葉,530,と,2019/8/3 17:34,2-1_all_corrected,55,44,235,165,290,209
150474,30085_20190803185924.jpg,業務スーパー南津守,**88,なにわ,31,ら,2019/8/3 18:58,2-1_all_corrected,69,53,301,257,370,310
149330,30111_20190803130633.jpg,イオン稲毛,8165,千葉,330,て,2019/8/3 13:06,2-1_all_corrected,78,56,304,180,382,236
149798,30091_20190803154047.jpg,イトーヨーカドー木場 立体,3968,足立,57,ろ,2019/8/3 15:40,2-1_all_corrected,52,42,241,183,293,225
150641,30014_20190803201123.jpg,フォルテ蘇我ベルク棟,2569,千葉,-1,ろ,2019/8/3 20:10,2-1_all_corrected,43,44,227,55,270,99
149308,30078_20190803125528.jpg,イオンスタイル仙台卸町店,2271,宮城,580,ひ,2019/8/3 12:54,2-1_all_corrected,75,51,295,167,370,218
150225,30111_20190803173555.jpg,イオン稲毛,7908,千葉,501,ほ,2019/8/3 17:35,2-1_all_corrected,55,43,218,150,273,193
149906,30001_20190803161436.jpg,関西スーパー高石駅前,***8,和泉,30,ひ,2019/8/3 16:13,2-1_all_corrected,96,70,382,295,478,365
149337,30110_20190803130820.jpg,イオン金沢八景,**88,横浜,31,そ,2019/8/3 13:07,2-1_all_corrected,71,59,459,227,530,286
149364,30110_20190803131710.jpg,イオン金沢八景,1230,横浜,355,な,2019/8/3 13:16,2-1_all_corrected,44,39,79,71,123,110
149390,30110_20190803132118.jpg,イオン金沢八景,*720,横浜,548,ね,2019/8/3 13:20,2-1_all_corrected,45,39,503,76,548,115
149160,30072_20190803121137.jpg,関西スーパー京阪大和田１F,*119,大阪,346,ろ,2019/8/3 12:11,2-1_all_corrected,82,57,45,170,127,227
149736,30045_20190803152203.jpg,マックスバリュー徳川明倫,2525,名古屋,31,そ,2019/8/3 15:20,2-1_all_corrected,66,63,4,304,70,367
150624,30066_20190803200233.jpg,ジョーシン和泉中央,***5,和泉,-1,も,2019/8/3 20:01,2-1_all_corrected,76,60,136,282,212,342
150247,30078_20190803174043.jpg,イオンスタイル仙台卸町店,*877,仙台,330,め,2019/8/3 17:40,2-1_all_corrected,82,61,415,340,497,401
149938,30085_20190803162136.jpg,業務スーパー南津守,1001,なにわ,31,ね,2019/8/3 16:20,2-1_all_corrected,92,51,479,397,571,448
150812,30062_20190803221640.jpg,ミスミモール,**10,神戸,-1,や,2019/8/3 22:16,2-1_all_corrected,89,65,281,247,370,312
148810,30167_20190803102758.jpg,イオン東雲店,*226,品川,300,も,2019/8/3 10:27,2-1_all_corrected,60,42,275,178,335,220
150671,30139_20190803202912.jpg,イオン板橋ショッピングセンター,7000,所沢,506,す,2019/8/3 20:28,2-1_all_corrected,56,42,127,179,183,221
148645,30111_20190803084114.jpg,イオン稲毛,5367,土浦,300,ろ,2019/8/3 8:40,2-1_all_corrected,52,42,324,180,376,222
149551,30110_20190803141557.jpg,イオン金沢八景,8636,横浜,504,せ,2019/8/3 14:15,2-1_all_corrected,37,28,193,6,230,34
149159,30111_20190803121126.jpg,イオン稲毛,3108,千葉,531,ま,2019/8/3 12:11,2-1_all_corrected,69,56,293,147,362,203
150622,30103_20190803200142.jpg,八尾老原１丁目,2863,なにわ,301,ろ,2019/8/3 20:00,2-1_all_corrected,54,47,185,140,239,187
150841,30169_20190803225205.jpg,イオン相模原ショッピングセンター,**77,相模,131,た,2019/8/3 22:51,2-1_all_corrected,79,58,331,99,410,157
149362,30169_20190803131559.jpg,イオン相模原ショッピングセンター,1064,多摩,830,せ,2019/8/3 13:15,2-1_all_corrected,90,69,296,119,386,188
149706,30111_20190803151244.jpg,イオン稲毛,*527,千葉,334,る,2019/8/3 15:12,2-1_all_corrected,56,46,305,157,361,203
148907,30072_20190803110158.jpg,関西スーパー京阪大和田１F,**11,大阪,31,ま,2019/8/3 11:01,2-1_all_corrected,48,38,335,175,383,213
150554,30169_20190803192949.jpg,イオン相模原ショッピングセンター,*721,多摩,344,そ,2019/8/3 19:29,2-1_all_corrected,70,61,293,121,363,182
149479,30091_20190803135614.jpg,イトーヨーカドー木場 立体,3968,足立,57,ろ,2019/8/3 13:55,2-1_all_corrected,54,42,271,184,325,226
149446,30045_20190803134331.jpg,マックスバリュー徳川明倫,**77,名古屋,31,つ,2019/8/3 13:43,2-1_all_corrected,70,60,96,212,166,272
150562,30063_20190803193231.jpg,コーナン相模原小山モール,***5,多摩,30,は,2019/8/3 19:31,2-1_all_corrected,80,65,104,265,184,330
149226,30103_20190803122853.jpg,八尾老原１丁目,***7,大阪,30,ち,2019/8/3 12:28,2-1_all_corrected,104,77,449,344,553,421
149843,30052_20190803155956.jpg,西友市ヶ尾,1010,横浜,31,る,2019/8/3 15:59,2-1_all_corrected,80,60,232,274,312,334
150360,30070_20190803182628.jpg,カナートモール住道第一,***8,大阪,30,ま,2019/8/3 18:26,2-1_all_corrected,82,63,476,277,558,340
149611,30045_20190803143624.jpg,マックスバリュー徳川明倫,**10,名古屋,31,ぬ,2019/8/3 14:35,2-1_all_corrected,69,52,258,123,327,175
150531,30045_20190803192352.jpg,マックスバリュー徳川明倫,*358,名古屋,32,と,2019/8/3 19:23,2-1_all_corrected,66,59,159,197,225,256
148962,30157_20190803111814.jpg,関西スーパー中央,**55,神戸,31,ひ,2019/8/3 11:17,2-1_all_corrected,54,41,185,311,239,352
149618,30078_20190803143950.jpg,イオンスタイル仙台卸町店,**55,宮城,345,せ,2019/8/3 14:39,2-1_all_corrected,82,60,336,255,418,315
149288,30167_20190803124908.jpg,イオン東雲店,*125,品川,345,む,2019/8/3 12:47,2-1_all_corrected,100,56,128,394,228,450
148706,30157_20190803093451.jpg,関西スーパー中央,**18,神戸,31,ま,2019/8/3 9:34,2-1_all_corrected,50,43,99,305,149,348
149076,30111_20190803114504.jpg,イオン稲毛,*420,水戸,533,ぬ,2019/8/3 11:44,2-1_all_corrected,78,126,287,306,365,432
149218,30072_20190803122734.jpg,関西スーパー京阪大和田１F,7425,大阪,503,ふ,2019/8/3 12:26,2-1_all_corrected,83,72,0,308,83,380
150138,30111_20190803171457.jpg,イオン稲毛,2119,千葉,530,の,2019/8/3 17:14,2-1_all_corrected,57,44,211,162,268,206
150100,30110_20190803170913.jpg,イオン金沢八景,4109,横浜,504,な,2019/8/3 17:08,2-1_all_corrected,45,35,308,64,353,99
148634,30072_20190803082636.jpg,関西スーパー京阪大和田１F,*762,京都,800,せ,2019/8/3 8:25,2-1_all_corrected,80,60,147,285,227,345
149482,30111_20190803135730.jpg,イオン稲毛,*927,千葉,535,ろ,2019/8/3 13:56,2-1_all_corrected,54,42,360,114,414,156
150304,30006_20190803175911.jpg,スギ薬局南千里,6556,大阪,504,さ,2019/8/3 17:58,2-1_all_corrected,103,83,5,120,108,203
149672,30045_20190803145813.jpg,マックスバリュー徳川明倫,**33,名古屋,31,も,2019/8/3 14:57,2-1_all_corrected,44,35,276,142,320,177
150733,30074_20190803210612.jpg,マックスバリュ北1条東,***3,札幌,-1,む,2019/8/3 21:04,2-1_all_corrected,32,40,350,137,382,177
148700,30167_20190803093156.jpg,イオン東雲店,7039,品川,301,て,2019/8/3 9:30,2-1_all_corrected,94,56,111,394,205,450
149070,30072_20190803114228.jpg,関西スーパー京阪大和田１F,**11,大阪,31,ま,2019/8/3 11:41,2-1_all_corrected,57,46,131,84,188,130
149414,30111_20190803133055.jpg,イオン稲毛,*263,袖ヶ浦,530,ぬ,2019/8/3 13:30,2-1_all_corrected,70,55,262,184,332,239
150734,30169_20190803210715.jpg,イオン相模原ショッピングセンター,1128,多摩,586,を,2019/8/3 21:06,2-1_all_corrected,54,46,125,131,179,177
150508,30169_20190803191130.jpg,イオン相模原ショッピングセンター,6064,相模,580,な,2019/8/3 19:11,2-1_all_corrected,82,73,469,367,551,440
150705,30104_20190803205106.jpg,カスミフードスクエア咲が丘,5517,習志野,330,と,2019/8/3 20:50,2-1_all_corrected,57,43,242,170,299,213
149005,30110_20190803112629.jpg,イオン金沢八景,*903,横浜,536,み,2019/8/3 11:25,2-1_all_corrected,85,61,299,201,384,262
149698,30078_20190803150811.jpg,イオンスタイル仙台卸町店,6768,宮城,580,ね,2019/8/3 15:07,2-1_all_corrected,84,55,271,271,355,326
150779,30143_20190803214503.jpg,イオン久里浜,8000,横浜,-1,ひ,2019/8/3 21:44,2-1_all_corrected,48,39,416,107,464,146
149801,30110_20190803154100.jpg,イオン金沢八景,*126,横浜,533,め,2019/8/3 15:40,2-1_all_corrected,51,46,36,143,87,189
149034,30111_20190803113242.jpg,イオン稲毛,7905,千葉,330,す,2019/8/3 11:32,2-1_all_corrected,67,57,225,160,292,217
149837,30110_20190803155759.jpg,イオン金沢八景,*111,横浜,30,て,2019/8/3 15:57,2-1_all_corrected,73,60,7,180,80,240
150748,30045_20190803212314.jpg,マックスバリュー徳川明倫,**23,名古屋,-1,ほ,2019/8/3 21:22,2-1_all_corrected,76,61,128,181,204,242
150511,30169_20190803191342.jpg,イオン相模原ショッピングセンター,1629,相模,480,れ,2019/8/3 19:13,2-1_all_corrected,82,63,161,121,243,184
148989,30167_20190803112343.jpg,イオン東雲店,*364,品川,580,す,2019/8/3 11:23,2-1_all_corrected,49,38,306,116,355,154
149060,30045_20190803113923.jpg,マックスバリュー徳川明倫,**77,名古屋,31,ほ,2019/8/3 11:39,2-1_all_corrected,52,45,232,119,284,164
150376,30157_20190803183034.jpg,関西スーパー中央,5555,神戸,481,た,2019/8/3 18:29,2-1_all_corrected,55,44,142,398,197,442
148974,30079_20190803112002.jpg,ピットデザイン仙台卸町駅前駐車場,9674,宮城,583,う,2019/8/3 11:19,2-1_all_corrected,45,34,377,62,422,96
150143,30014_20190803171532.jpg,フォルテ蘇我ベルク棟,***5,千葉,30,る,2019/8/3 17:15,2-1_all_corrected,52,46,86,70,138,116
150715,30070_20190803205537.jpg,カナートモール住道第一,***2,大阪,-1,も,2019/8/3 20:55,2-1_all_corrected,73,53,232,143,305,196
148721,30137_20190803094939.jpg,イオンスタイル品川シーサイド,1289,品川,500,ろ,2019/8/3 9:49,2-1_all_corrected,56,41,349,47,405,88
149607,30110_20190803143502.jpg,イオン金沢八景,6727,横浜,505,た,2019/8/3 14:34,2-1_all_corrected,67,70,533,203,600,273
150312,30111_20190803180250.jpg,イオン稲毛,*823,千葉,532,そ,2019/8/3 18:02,2-1_all_corrected,73,56,318,160,391,216
149663,30060_20190803145530.jpg,関西スーパー小野原,**37,大阪,361,そ,2019/8/3 14:54,2-1_all_corrected,81,69,473,293,554,362
150315,30110_20190803180410.jpg,イオン金沢八景,3746,横浜,580,ゆ,2019/8/3 18:03,2-1_all_corrected,75,60,310,232,385,292
148773,30085_20190803101722.jpg,業務スーパー南津守,***8,なにわ,30,つ,2019/8/3 10:16,2-1_all_corrected,72,51,142,288,214,339
149004,30167_20190803112619.jpg,イオン東雲店,*364,品川,580,す,2019/8/3 11:25,2-1_all_corrected,76,59,190,245,266,304
150740,30123_20190803210848.jpg,イオン長浦（第５）,***8,袖ヶ浦,590,も,2019/8/3 21:07,2-1_all_corrected,80,72,411,91,491,163
148921,30001_20190803110611.jpg,関西スーパー高石駅前,3848,堺,480,き,2019/8/3 11:05,2-1_all_corrected,85,63,429,178,514,241
150519,30078_20190803191830.jpg,イオンスタイル仙台卸町店,***8,仙台,328,す,2019/8/3 19:18,2-1_all_corrected,83,60,399,354,482,414
150377,30085_20190803183043.jpg,業務スーパー南津守,8888,なにわ,30,ち,2019/8/3 18:30,2-1_all_corrected,69,55,466,258,535,313
149433,30169_20190803133845.jpg,イオン相模原ショッピングセンター,*715,相模,583,て,2019/8/3 13:38,2-1_all_corrected,81,67,290,106,371,173
150173,30110_20190803172435.jpg,イオン金沢八景,5922,横浜,503,む,2019/8/3 17:23,2-1_all_corrected,84,64,278,291,362,355
149789,30111_20190803153854.jpg,イオン稲毛,4499,千葉,330,ひ,2019/8/3 15:38,2-1_all_corrected,56,45,333,159,389,204
150006,30045_20190803164121.jpg,マックスバリュー徳川明倫,***5,名古屋,30,み,2019/8/3 16:40,2-1_all_corrected,77,64,32,283,109,347
149321,30072_20190803130145.jpg,関西スーパー京阪大和田１F,1215,大阪,586,い,2019/8/3 13:01,2-1_all_corrected,56,45,427,80,483,125
148809,30111_20190803102738.jpg,イオン稲毛,5387,土浦,300,ろ,2019/8/3 10:27,2-1_all_corrected,52,42,406,93,458,135
150657,30169_20190803201752.jpg,イオン相模原ショッピングセンター,*721,多摩,344,そ,2019/8/3 20:17,2-1_all_corrected,90,74,151,274,241,348
149773,30110_20190803153441.jpg,イオン金沢八景,*552,横浜,504,ふ,2019/8/3 15:34,2-1_all_corrected,50,43,93,197,143,240
150834,30103_20190803224839.jpg,八尾老原１丁目,9999,大阪,-1,ふ,2019/8/3 22:48,2-1_all_corrected,84,58,333,237,417,295
150400,30110_20190803183813.jpg,イオン金沢八景,3918,横浜,531,ち,2019/8/3 18:37,2-1_all_corrected,83,62,342,179,425,241
149178,30111_20190803121530.jpg,イオン稲毛,7562,千葉,503,す,2019/8/3 12:15,2-1_all_corrected,97,57,164,392,261,449
150052,30110_20190803165541.jpg,イオン金沢八景,3365,横浜,330,ら,2019/8/3 16:54,2-1_all_corrected,54,39,300,62,354,101
148698,30068_20190803093115.jpg,ケーヨーデイツー唐木田,***5,多摩,30,も,2019/8/3 9:30,2-1_all_corrected,45,33,333,136,378,169
150031,30072_20190803164809.jpg,関西スーパー京阪大和田１F,8906,大阪,50,を,2019/8/3 16:47,2-1_all_corrected,82,62,264,255,346,317
149124,30157_20190803120259.jpg,関西スーパー中央,1010,神戸,31,ね,2019/8/3 12:02,2-1_all_corrected,63,67,87,247,150,314
150669,30105_20190803202541.jpg,カスミフードスクエア春日部武里,6689,春日部,301,ふ,2019/8/3 20:25,2-1_all_corrected,52,28,214,181,266,209
148837,30111_20190803103728.jpg,イオン稲毛,1531,千葉,580,ひ,2019/8/3 10:37,2-1_all_corrected,39,33,40,63,79,96
150490,30057_20190803190656.jpg,ライフ東府中,***5,多摩,30,せ,2019/8/3 19:06,2-1_all_corrected,65,55,390,227,455,282
150232,30111_20190803173644.jpg,イオン稲毛,7347,千葉,530,せ,2019/8/3 17:36,2-1_all_corrected,68,56,264,158,332,214
150651,30103_20190803201449.jpg,八尾老原１丁目,8387,和泉,330,た,2019/8/3 20:14,2-1_all_corrected,53,46,211,180,264,226
150602,30111_20190803195217.jpg,イオン稲毛,8570,足立,330,て,2019/8/3 19:51,2-1_all_corrected,69,57,349,224,418,281
149380,30110_20190803131912.jpg,イオン金沢八景,2305,横浜,331,ろ,2019/8/3 13:18,2-1_all_corrected,46,41,470,88,516,129
150078,30111_20190803170048.jpg,イオン稲毛,2317,千葉,583,せ,2019/8/3 17:00,2-1_all_corrected,50,40,117,100,167,140
150082,30045_20190803170204.jpg,マックスバリュー徳川明倫,***3,名古屋,30,は,2019/8/3 17:01,2-1_all_corrected,56,46,148,197,204,243
150620,30111_20190803200121.jpg,イオン稲毛,8196,大阪,500,ま,2019/8/3 20:00,2-1_all_corrected,44,33,131,92,175,125
149163,30157_20190803121203.jpg,関西スーパー中央,1010,神戸,31,ね,2019/8/3 12:11,2-1_all_corrected,56,46,158,319,214,365
149507,30078_20190803140432.jpg,イオンスタイル仙台卸町店,*815,仙台,430,せ,2019/8/3 14:04,2-1_all_corrected,81,56,336,273,417,329
150415,30169_20190803184144.jpg,イオン相模原ショッピングセンター,3135,相模,530,な,2019/8/3 18:41,2-1_all_corrected,77,76,518,353,595,429
149994,30169_20190803164005.jpg,イオン相模原ショッピングセンター,6125,相模,501,さ,2019/8/3 16:39,2-1_all_corrected,78,60,245,209,323,269
150217,30111_20190803173451.jpg,イオン稲毛,*259,千葉,530,と,2019/8/3 17:34,2-1_all_corrected,45,36,141,107,186,143
150819,30045_20190803222648.jpg,マックスバリュー徳川明倫,**22,名古屋,-1,む,2019/8/3 22:26,2-1_all_corrected,70,57,121,180,191,237
150025,30072_20190803164727.jpg,関西スーパー京阪大和田１F,*883,大阪,332,り,2019/8/3 16:46,2-1_all_corrected,104,83,52,367,156,450
149305,30072_20190803125348.jpg,関西スーパー京阪大和田１F,*701,神戸,830,か,2019/8/3 12:51,2-1_all_corrected,65,63,0,212,65,275
150228,30110_20190803173620.jpg,イオン金沢八景,*508,横浜,584,こ,2019/8/3 17:35,2-1_all_corrected,56,44,304,91,360,135
150821,30074_20190803223001.jpg,マックスバリュ北1条東,6083,札幌,100,つ,2019/8/3 22:29,2-1_all_corrected,53,44,73,183,126,227
148676,30157_20190803091111.jpg,関西スーパー中央,**18,神戸,31,ま,2019/8/3 9:10,2-1_all_corrected,54,41,455,197,509,238
149334,30078_20190803130748.jpg,イオンスタイル仙台卸町店,*830,仙台,584,を,2019/8/3 13:07,2-1_all_corrected,88,59,236,256,324,315
150013,30072_20190803164326.jpg,関西スーパー京阪大和田１F,*801,大阪,341,も,2019/8/3 16:42,2-1_all_corrected,58,45,304,67,362,112
150483,30169_20190803190322.jpg,イオン相模原ショッピングセンター,9664,相模,580,か,2019/8/3 19:02,2-1_all_corrected,56,42,430,27,486,69
150810,30063_20190803221427.jpg,コーナン相模原小山モール,1025,湘南,-1,あ,2019/8/3 22:13,2-1_all_corrected,64,57,496,117,560,174
149350,30157_20190803131313.jpg,関西スーパー中央,5555,神戸,337,に,2019/8/3 13:12,2-1_all_corrected,54,41,199,298,253,339
149733,30110_20190803152112.jpg,イオン金沢八景,*515,横浜,505,て,2019/8/3 15:20,2-1_all_corrected,76,60,357,168,433,228
149959,30110_20190803162658.jpg,イオン金沢八景,7385,横浜,580,む,2019/8/3 16:26,2-1_all_corrected,45,36,79,99,124,135
149966,30083_20190803162902.jpg,フォーエルナゴヤドーム駅前,2525,名古屋,31,つ,2019/8/3 16:28,2-1_all_corrected,60,42,222,195,282,237
150842,30067_20190803225438.jpg,ピットデザイン茨木宮島,2525,堺,-1,き,2019/8/3 22:53,2-1_all_corrected,49,39,158,202,207,241
149366,30111_20190803131721.jpg,イオン稲毛,**31,千葉,537,に,2019/8/3 13:16,2-1_all_corrected,51,40,363,123,414,163
150274,30103_20190803175156.jpg,八尾老原１丁目,**33,大阪,31,り,2019/8/3 17:51,2-1_all_corrected,40,40,226,108,266,148
148822,30072_20190803103214.jpg,関西スーパー京阪大和田１F,*563,京都,800,せ,2019/8/3 10:31,2-1_all_corrected,86,61,22,293,108,354
150447,30169_20190803185147.jpg,イオン相模原ショッピングセンター,5500,相模,335,り,2019/8/3 18:51,2-1_all_corrected,84,70,437,371,521,441
150675,30111_20190803203324.jpg,イオン稲毛,6123,千葉,583,ち,2019/8/3 20:33,2-1_all_corrected,58,43,322,151,380,194
148961,30110_20190803111813.jpg,イオン金沢八景,*289,横浜,580,つ,2019/8/3 11:17,2-1_all_corrected,54,44,72,240,126,284
148733,30139_20190803095626.jpg,イオン板橋ショッピングセンター,***1,練馬,30,ね,2019/8/3 9:55,2-1_all_corrected,52,38,247,187,299,225
148966,30169_20190803111853.jpg,イオン相模原ショッピングセンター,4545,相模,580,み,2019/8/3 11:18,2-1_all_corrected,80,69,268,100,348,169
150158,30169_20190803171808.jpg,イオン相模原ショッピングセンター,*541,春日部,583,い,2019/8/3 17:17,2-1_all_corrected,93,70,169,71,262,141
150731,30104_20190803210506.jpg,カスミフードスクエア咲が丘,*430,習志野,300,ろ,2019/8/3 21:04,2-1_all_corrected,59,41,194,167,253,208
149026,30006_20190803113022.jpg,スギ薬局南千里,7466,大阪,302,に,2019/8/3 11:29,2-1_all_corrected,88,54,423,16,511,70
149814,30060_20190803154918.jpg,関西スーパー小野原,2853,大阪,581,ふ,2019/8/3 15:48,2-1_all_corrected,93,84,496,309,589,393
150798,30169_20190803220337.jpg,イオン相模原ショッピングセンター,***8,豊橋,373,や,2019/8/3 22:03,2-1_all_corrected,48,44,165,89,213,133
148794,30072_20190803102418.jpg,関西スーパー京阪大和田１F,3168,大阪,102,あ,2019/8/3 10:22,2-1_all_corrected,93,75,125,352,218,427
148760,30001_20190803100958.jpg,関西スーパー高石駅前,1115,大阪,585,の,2019/8/3 10:09,2-1_all_corrected,54,40,470,33,524,73
150195,30110_20190803173004.jpg,イオン金沢八景,1592,横浜,330,り,2019/8/3 17:29,2-1_all_corrected,39,34,105,33,144,67
150706,30104_20190803205112.jpg,カスミフードスクエア咲が丘,5517,習志野,330,と,2019/8/3 20:50,2-1_all_corrected,89,61,206,386,295,447
148994,30073_20190803112500.jpg,関西スーパー京阪大和田２F,**11,大阪,31,ま,2019/8/3 11:24,2-1_all_corrected,73,59,322,68,395,127
150755,30078_20190803212932.jpg,イオンスタイル仙台卸町店,7524,仙台,580,は,2019/8/3 21:29,2-1_all_corrected,86,63,113,305,199,368
150309,30063_20190803180227.jpg,コーナン相模原小山モール,*521,多摩,430,な,2019/8/3 18:01,2-1_all_corrected,62,39,81,244,143,283
150797,30169_20190803220328.jpg,イオン相模原ショッピングセンター,*127,横浜,532,の,2019/8/3 22:03,2-1_all_corrected,93,75,387,374,480,449
149215,30072_20190803122651.jpg,関西スーパー京阪大和田１F,4097,大阪,581,に,2019/8/3 12:26,2-1_all_corrected,77,59,127,234,204,293
165434,30078_20190811151817.jpg,イオンスタイル仙台卸町店,*778,仙台,330,ね,2019/8/11 15:17,2-1_all_corrected,53,41,316,48,369,89
165291,30144_20190811141731.jpg,イオン幕張,*319,習志野,331,り,2019/8/11 14:17,2-1_all_corrected,55,43,223,158,278,201
165068,30110_20190811122910.jpg,イオン金沢八景,*214,横浜,355,て,2019/8/11 12:28,2-1_all_corrected,46,35,281,60,327,95
165253,30039_20190811135734.jpg,イトーヨーカドー大井町,*811,品川,33,そ,2019/8/11 13:57,2-1_all_corrected,69,60,274,207,343,267
165095,30147_20190811124114.jpg,三井のリパーク 厚木文化会館,2525,横浜,31,り,2019/8/11 12:40,2-1_all_corrected,77,63,28,280,105,343
165059,30172_20190811122438.jpg,ピットデザインすわの町,*224,久留米,333,つ,2019/8/11 12:24,2-1_all_corrected,33,49,154,191,187,240
165200,30006_20190811133728.jpg,スギ薬局南千里,7110,松本,331,さ,2019/8/11 13:37,2-1_all_corrected,92,57,444,0,536,57
164910,30144_20190811105952.jpg,イオン幕張,9328,習志野,301,ろ,2019/8/11 10:59,2-1_all_corrected,60,44,213,132,273,176
164926,30144_20190811110919.jpg,イオン幕張,6911,習志野,580,ぬ,2019/8/11 11:08,2-1_all_corrected,57,43,218,141,275,184
166229,30039_20190811210917.jpg,イトーヨーカドー大井町,5809,品川,301,そ,2019/8/11 21:08,2-1_all_corrected,54,43,256,190,310,233
165231,30110_20190811134717.jpg,イオン金沢八景,5734,川口,583,い,2019/8/11 13:46,2-1_all_corrected,47,35,258,171,305,206
165003,30072_20190811115457.jpg,関西スーパー京阪大和田１F,4585,豊橋,501,に,2019/8/11 11:54,2-1_all_corrected,45,35,424,27,469,62
165236,30168_20190811134957.jpg,イオン東雲店（屋上）,**13,横浜,345,る,2019/8/11 13:49,2-1_all_corrected,79,57,285,129,364,186
165255,30167_20190811135831.jpg,イオン東雲店,6298,品川,58,り,2019/8/11 13:57,2-1_all_corrected,48,32,291,268,339,300
165631,30110_20190811164007.jpg,イオン金沢八景,*118,横浜,365,む,2019/8/11 16:39,2-1_all_corrected,50,38,473,85,523,123
166047,30144_20190811191744.jpg,イオン幕張,***8,足立,30,せ,2019/8/11 19:17,2-1_all_corrected,44,37,207,127,251,164
165252,30039_20190811135725.jpg,イトーヨーカドー大井町,*811,品川,83,そ,2019/8/11 13:56,2-1_all_corrected,68,56,293,191,361,247
164945,30139_20190811112202.jpg,イオン板橋ショッピングセンター,***1,練馬,-1,ね,2019/8/11 11:21,2-1_all_corrected,56,46,205,227,261,273
165069,30062_20190811122948.jpg,ミスミモール,1010,神戸,31,の,2019/8/11 12:29,2-1_all_corrected,55,46,343,134,398,180
164980,30001_20190811113955.jpg,関西スーパー高石駅前,***4,和泉,358,て,2019/8/11 11:39,2-1_all_corrected,105,80,242,358,347,438
165638,30110_20190811164258.jpg,イオン金沢八景,7474,横浜,530,な,2019/8/11 16:42,2-1_all_corrected,52,40,338,57,390,97
165698,30144_20190811170244.jpg,イオン幕張,1518,野田,531,の,2019/8/11 17:02,2-1_all_corrected,84,49,278,250,362,299
165237,30144_20190811135008.jpg,イオン幕張,5296,習志野,332,む,2019/8/11 13:49,2-1_all_corrected,71,54,202,182,273,236
165801,30144_20190811174615.jpg,イオン幕張,7888,千葉,580,て,2019/8/11 17:45,2-1_all_corrected,58,42,152,152,210,194
165696,30078_20190811170220.jpg,イオンスタイル仙台卸町店,4769,仙台,480,り,2019/8/11 17:01,2-1_all_corrected,57,46,316,142,373,188
166221,30091_20190811210221.jpg,イトーヨーカドー木場 立体,2757,品川,530,あ,2019/8/11 21:01,2-1_all_corrected,70,66,468,218,538,284
165830,30072_20190811175632.jpg,関西スーパー京阪大和田１F,4324,大阪,500,ぬ,2019/8/11 17:56,2-1_all_corrected,75,52,120,123,195,175
165457,30078_20190811152717.jpg,イオンスタイル仙台卸町店,3283,宮城,581,は,2019/8/11 15:26,2-1_all_corrected,57,43,285,104,342,147
166226,30078_20190811210843.jpg,イオンスタイル仙台卸町店,*721,仙台,332,つ,2019/8/11 21:08,2-1_all_corrected,91,63,257,315,348,378
164929,30079_20190811111120.jpg,ピットデザイン仙台卸町駅前駐車場,7697,仙台,580,つ,2019/8/11 11:10,2-1_all_corrected,49,38,443,174,492,212
165141,30111_20190811130745.jpg,イオン稲毛,1125,千葉,336,そ,2019/8/11 13:07,2-1_all_corrected,73,52,284,160,357,212
165380,30110_20190811145602.jpg,イオン金沢八景,6931,横浜,504,め,2019/8/11 14:55,2-1_all_corrected,73,57,203,214,276,271
165726,30072_20190811171430.jpg,関西スーパー京阪大和田１F,7192,なにわ,480,さ,2019/8/11 17:14,2-1_all_corrected,74,62,15,242,89,304
165514,30078_20190811154802.jpg,イオンスタイル仙台卸町店,3482,仙台,500,ぬ,2019/8/11 15:47,2-1_all_corrected,78,54,322,161,400,215
165184,30006_20190811133129.jpg,スギ薬局南千里,7110,松本,331,さ,2019/8/11 13:31,2-1_all_corrected,132,115,152,198,284,313
165345,30167_20190811143738.jpg,イオン東雲店,6324,足立,502,ね,2019/8/11 14:36,2-1_all_corrected,69,57,251,52,320,109
165721,30072_20190811171312.jpg,関西スーパー京阪大和田１F,1888,尾張小牧,531,て,2019/8/11 17:11,2-1_all_corrected,94,71,8,345,102,416
165980,30144_20190811185046.jpg,イオン幕張,1527,千葉,302,に,2019/8/11 18:50,2-1_all_corrected,88,61,336,343,424,404
164788,30157_20190811095715.jpg,関西スーパー中央,6151,神戸,581,あ,2019/8/11 9:56,2-1_all_corrected,66,58,264,377,330,435
165786,30111_20190811174042.jpg,イオン稲毛,1101,千葉,347,さ,2019/8/11 17:40,2-1_all_corrected,57,43,392,113,449,156
165549,30110_20190811160343.jpg,イオン金沢八景,8641,横浜,504,す,2019/8/11 16:03,2-1_all_corrected,66,54,398,86,464,140
166132,30169_20190811200409.jpg,イオン相模原ショッピングセンター,6331,相模,480,す,2019/8/11 20:03,2-1_all_corrected,76,60,232,106,308,166
165344,30167_20190811143734.jpg,イオン東雲店,6324,足立,502,ね,2019/8/11 14:37,2-1_all_corrected,87,69,185,309,272,378
166151,30167_20190811201601.jpg,イオン東雲店,6507,足立,301,る,2019/8/11 20:14,2-1_all_corrected,84,65,82,310,166,375
166169,30169_20190811203108.jpg,イオン相模原ショッピングセンター,**56,相模,332,も,2019/8/11 20:30,2-1_all_corrected,75,59,333,43,408,102
165986,30078_20190811185317.jpg,イオンスタイル仙台卸町店,7171,仙台,583,え,2019/8/11 18:52,2-1_all_corrected,70,54,258,122,328,176
165711,30078_20190811170953.jpg,イオンスタイル仙台卸町店,9627,宮城,581,の,2019/8/11 17:09,2-1_all_corrected,53,41,259,73,312,114
165944,30168_20190811183652.jpg,イオン東雲店（屋上）,*117,足立,367,と,2019/8/11 18:36,2-1_all_corrected,83,70,460,205,543,275
165140,30098_20190811130715.jpg,BRANCH仙台（東棟）,1555,仙台,500,に,2019/8/11 13:06,2-1_all_corrected,85,53,435,300,520,353
165917,30078_20190811182858.jpg,イオンスタイル仙台卸町店,5822,仙台,400,た,2019/8/11 18:28,2-1_all_corrected,54,46,351,108,405,154
165742,30169_20190811172030.jpg,イオン相模原ショッピングセンター,8085,相模,580,と,2019/8/11 17:19,2-1_all_corrected,68,58,210,108,278,166
165114,30169_20190811125523.jpg,イオン相模原ショッピングセンター,2201,相模,530,ま,2019/8/11 12:55,2-1_all_corrected,85,65,278,113,363,178
165910,30078_20190811182645.jpg,イオンスタイル仙台卸町店,3785,仙台,501,つ,2019/8/11 18:26,2-1_all_corrected,56,45,328,113,384,158
164809,30006_20190811100701.jpg,スギ薬局南千里,3758,仙台,501,た,2019/8/11 10:06,2-1_all_corrected,131,114,170,123,301,237
165745,30078_20190811172152.jpg,イオンスタイル仙台卸町店,8772,仙台,580,め,2019/8/11 17:21,2-1_all_corrected,92,69,135,377,227,446
165926,30103_20190811183333.jpg,八尾老原１丁目,1000,大阪,30,ゆ,2019/8/11 18:33,2-1_all_corrected,72,54,232,162,304,216
165773,30167_20190811173439.jpg,イオン東雲店,**33,品川,313,ぬ,2019/8/11 17:34,2-1_all_corrected,79,54,171,375,250,429
164807,30001_20190811100624.jpg,関西スーパー高石駅前,7358,大阪,504,せ,2019/8/11 10:06,2-1_all_corrected,86,62,352,219,438,281
164838,30144_20190811102233.jpg,イオン幕張,3199,千葉,580,み,2019/8/11 10:22,2-1_all_corrected,46,34,130,100,176,134
166118,30139_20190811195641.jpg,イオン板橋ショッピングセンター,**48,大宮,583,ひ,2019/8/11 19:56,2-1_all_corrected,51,37,299,216,350,253
164814,30072_20190811100914.jpg,関西スーパー京阪大和田１F,*563,京都,800,せ,2019/8/11 10:08,2-1_all_corrected,69,54,70,191,139,245
165599,30169_20190811162418.jpg,イオン相模原ショッピングセンター,*303,相模,332,は,2019/8/11 16:23,2-1_all_corrected,75,60,344,63,419,123
165961,30167_20190811184613.jpg,イオン東雲店,*106,足立,530,も,2019/8/11 18:45,2-1_all_corrected,52,42,351,272,403,314
165966,30111_20190811184740.jpg,イオン稲毛,3735,袖ヶ浦,330,ね,2019/8/11 18:47,2-1_all_corrected,47,40,104,91,151,131
165501,30169_20190811154407.jpg,イオン相模原ショッピングセンター,**55,湘南,543,け,2019/8/11 15:43,2-1_all_corrected,56,44,414,135,470,179
165165,30144_20190811132241.jpg,イオン幕張,1357,千葉,340,つ,2019/8/11 13:22,2-1_all_corrected,50,31,153,80,203,111
165705,30144_20190811170657.jpg,イオン幕張,6209,習志野,580,た,2019/8/11 17:06,2-1_all_corrected,53,39,153,126,206,165
165537,30144_20190811155822.jpg,イオン幕張,*730,千葉,340,は,2019/8/11 15:58,2-1_all_corrected,93,69,278,364,371,433
165530,30110_20190811155510.jpg,イオン金沢八景,8625,横浜,504,ゆ,2019/8/11 15:54,2-1_all_corrected,47,41,451,122,498,163
165553,30144_20190811160431.jpg,イオン幕張,6918,千葉,530,て,2019/8/11 16:03,2-1_all_corrected,55,40,162,111,217,151
165933,30169_20190811183520.jpg,イオン相模原ショッピングセンター,9693,多摩,71,ま,2019/8/11 18:34,2-1_all_corrected,67,37,304,108,371,145
165750,30144_20190811172439.jpg,イオン幕張,6293,神戸,301,ほ,2019/8/11 17:24,2-1_all_corrected,56,44,139,146,195,190
165596,30090_20190811162310.jpg,イトーヨーカドー木場 西棟,6972,越谷,300,す,2019/8/11 16:22,2-1_all_corrected,86,68,40,342,126,410
164884,30091_20190811104006.jpg,イトーヨーカドー木場 立体,1117,足立,353,ぬ,2019/8/11 10:39,2-1_all_corrected,57,44,316,56,373,100
166172,30111_20190811203137.jpg,イオン稲毛,2525,千葉,330,す,2019/8/11 20:31,2-1_all_corrected,53,41,141,121,194,162
165509,30078_20190811154638.jpg,イオンスタイル仙台卸町店,**24,仙台,532,え,2019/8/11 15:46,2-1_all_corrected,52,36,280,6,332,42
165960,30169_20190811184613.jpg,イオン相模原ショッピングセンター,9229,多摩,300,み,2019/8/11 18:45,2-1_all_corrected,87,81,444,349,531,430
165016,30110_20190811120141.jpg,イオン金沢八景,6557,横浜,504,ら,2019/8/11 12:01,2-1_all_corrected,55,43,127,69,182,112
164792,30144_20190811100013.jpg,イオン幕張,8000,千葉,510,み,2019/8/11 9:59,2-1_all_corrected,75,50,256,244,331,294
166038,30167_20190811191440.jpg,イオン東雲店,1221,足立,301,は,2019/8/11 19:14,2-1_all_corrected,40,34,415,43,455,77
165870,30110_20190811181134.jpg,イオン金沢八景,2126,横浜,583,た,2019/8/11 18:11,2-1_all_corrected,40,32,238,53,278,85
165884,30078_20190811181802.jpg,イオンスタイル仙台卸町店,6158,宮城,581,な,2019/8/11 18:17,2-1_all_corrected,57,47,276,84,333,131
165073,30157_20190811123231.jpg,関西スーパー中央,7008,神戸,332,ひ,2019/8/11 12:32,2-1_all_corrected,57,38,276,305,333,343
165883,30078_20190811181759.jpg,イオンスタイル仙台卸町店,8896,仙台,580,さ,2019/8/11 18:17,2-1_all_corrected,62,42,279,94,341,136
165877,30055_20190811181438.jpg,マミーマート東大宮（第3）,9119,川崎,400,た,2019/8/11 18:14,2-1_all_corrected,165,149,77,283,242,432
165622,30144_20190811163447.jpg,イオン幕張,9356,千葉,502,な,2019/8/11 16:34,2-1_all_corrected,62,44,172,178,234,222
165848,30168_20190811180354.jpg,イオン東雲店（屋上）,*822,神戸,349,む,2019/8/11 18:03,2-1_all_corrected,76,55,264,153,340,208
165074,30144_20190811123303.jpg,イオン幕張,9359,川崎,300,の,2019/8/11 12:32,2-1_all_corrected,55,39,222,135,277,174
165426,30144_20190811151610.jpg,イオン幕張,6175,千葉,330,そ,2019/8/11 15:15,2-1_all_corrected,73,52,215,212,288,264
164994,30001_20190811114920.jpg,関西スーパー高石駅前,2024,大阪,400,み,2019/8/11 11:49,2-1_all_corrected,73,56,329,101,402,157
164903,30001_20190811105422.jpg,関西スーパー高石駅前,5223,堺,500,と,2019/8/11 10:53,2-1_all_corrected,100,69,322,266,422,335
165021,30091_20190811120324.jpg,イトーヨーカドー木場 立体,1701,足立,333,ゆ,2019/8/11 12:02,2-1_all_corrected,51,39,308,123,359,162
165213,30167_20190811134225.jpg,イオン東雲店,*673,春日部,880,り,2019/8/11 13:41,2-1_all_corrected,50,42,163,229,213,271
165487,30144_20190811153809.jpg,イオン幕張,1937,千葉,480,れ,2019/8/11 15:37,2-1_all_corrected,66,66,505,364,571,430
165480,30072_20190811153512.jpg,関西スーパー京阪大和田１F,7751,なにわ,830,あ,2019/8/11 15:34,2-1_all_corrected,82,67,80,171,162,238
166037,30167_20190811191435.jpg,イオン東雲店,3036,足立,501,ゆ,2019/8/11 19:13,2-1_all_corrected,69,76,0,285,69,361
166251,30091_20190811213305.jpg,イトーヨーカドー木場 立体,*722,足立,339,ね,2019/8/11 21:32,2-1_all_corrected,81,66,59,322,140,388
166097,30063_20190811194244.jpg,コーナン相模原小山モール,*215,横浜,345,と,2019/8/11 19:42,2-1_all_corrected,66,58,465,147,531,205
165271,30144_20190811140632.jpg,イオン幕張,2298,千葉,301,ほ,2019/8/11 14:06,2-1_all_corrected,91,63,204,324,295,387
165882,30078_20190811181754.jpg,イオンスタイル仙台卸町店,*962,仙台,300,は,2019/8/11 18:17,2-1_all_corrected,69,52,230,76,299,128
165849,30167_20190811180403.jpg,イオン東雲店,*117,名古屋,315,ひ,2019/8/11 18:03,2-1_all_corrected,66,60,499,366,565,426
165871,30091_20190811181155.jpg,イトーヨーカドー木場 立体,***3,川崎,508,ふ,2019/8/11 18:11,2-1_all_corrected,77,70,495,333,572,403
165031,30144_20190811120917.jpg,イオン幕張,3577,千葉,331,て,2019/8/11 12:08,2-1_all_corrected,92,67,328,333,420,400
165803,30078_20190811174632.jpg,イオンスタイル仙台卸町店,*124,仙台,501,す,2019/8/11 17:46,2-1_all_corrected,56,45,282,105,338,150
166027,30060_20190811190745.jpg,関西スーパー小野原,9999,大阪,31,り,2019/8/11 19:07,2-1_all_corrected,89,68,468,271,557,339
166087,30045_20190811193517.jpg,マックスバリュー徳川明倫,**17,名古屋,31,り,2019/8/11 19:34,2-1_all_corrected,75,61,159,182,234,243
166241,30144_20190811211731.jpg,イオン幕張,7052,千葉,581,せ,2019/8/11 20:11,2-1_all_corrected,49,36,153,127,202,163
166073,30169_20190811192951.jpg,イオン相模原ショッピングセンター,8008,相模,549,と,2019/8/11 19:29,2-1_all_corrected,74,67,438,300,512,367
165857,30078_20190811180615.jpg,イオンスタイル仙台卸町店,9181,仙台,580,ち,2019/8/11 18:05,2-1_all_corrected,73,56,266,157,339,213
166042,30167_20190811191548.jpg,イオン東雲店,*620,足立,563,き,2019/8/11 19:14,2-1_all_corrected,46,34,263,232,309,266
165439,30144_20190811151957.jpg,イオン幕張,2121,習志野,332,め,2019/8/11 15:19,2-1_all_corrected,75,48,304,233,379,281
165895,30053_20190811182127.jpg,マックスバリュ小牧駅西,***1,群馬,30,ゆ,2019/8/11 18:20,2-1_all_corrected,68,52,119,81,187,133
165462,30144_20190811152910.jpg,イオン幕張,**43,習志野,501,わ,2019/8/11 15:28,2-1_all_corrected,55,40,201,142,256,182
165030,30001_20190811120804.jpg,関西スーパー高石駅前,1122,和泉,785,そ,2019/8/11 12:07,2-1_all_corrected,86,62,357,167,443,229
166225,30169_20190811210723.jpg,イオン相模原ショッピングセンター,1122,相模,586,う,2019/8/11 21:06,2-1_all_corrected,77,63,234,113,311,176
165834,30144_20190811175909.jpg,イオン幕張,2806,千葉,530,り,2019/8/11 17:58,2-1_all_corrected,80,55,270,258,350,313
165695,30078_20190811170121.jpg,イオンスタイル仙台卸町店,7436,仙台,580,せ,2019/8/11 17:00,2-1_all_corrected,58,45,239,67,297,112
165097,30169_20190811124211.jpg,イオン相模原ショッピングセンター,*319,相模,584,え,2019/8/11 12:41,2-1_all_corrected,90,70,281,159,371,229
165894,30001_20190811182123.jpg,関西スーパー高石駅前,***8,和泉,30,ね,2019/8/11 18:20,2-1_all_corrected,75,57,396,107,471,164
165858,30168_20190811180631.jpg,イオン東雲店（屋上）,1016,品川,302,ほ,2019/8/11 18:05,2-1_all_corrected,50,36,214,82,264,118
166043,30085_20190811191557.jpg,業務スーパー南津守,***3,なにわ,30,ぬ,2019/8/11 19:15,2-1_all_corrected,47,35,255,200,302,235
165867,30078_20190811181010.jpg,イオンスタイル仙台卸町店,2001,春日部,550,む,2019/8/11 18:09,2-1_all_corrected,71,59,174,122,245,181
166081,30169_20190811193346.jpg,イオン相模原ショッピングセンター,4111,八王子,580,む,2019/8/11 19:33,2-1_all_corrected,64,59,248,131,312,190
166072,30169_20190811192939.jpg,イオン相模原ショッピングセンター,8008,静岡,549,と,2019/8/11 19:29,2-1_all_corrected,49,41,202,92,251,133
166240,30144_20190811211658.jpg,イオン幕張,4397,習志野,580,そ,2019/8/11 20:05,2-1_all_corrected,71,52,316,212,387,264
165267,30144_20190811140448.jpg,イオン幕張,1025,習志野,334,ひ,2019/8/11 14:04,2-1_all_corrected,60,44,217,167,277,211
165118,30072_20190811125628.jpg,関西スーパー京阪大和田１F,**11,大阪,31,ま,2019/8/11 12:56,2-1_all_corrected,72,58,221,252,293,310
164802,30072_20190811100528.jpg,関西スーパー京阪大和田１F,1212,大阪,514,や,2019/8/11 10:05,2-1_all_corrected,80,69,3,252,83,321
165776,30110_20190811173725.jpg,イオン金沢八景,*310,横浜,539,の,2019/8/11 17:36,2-1_all_corrected,75,57,230,213,305,270
164833,30110_20190811101827.jpg,イオン金沢八景,1664,横浜,50,に,2019/8/11 10:18,2-1_all_corrected,66,53,185,235,251,288
165129,30023_20190811130159.jpg,ピットデザイン山科東野,7777,京都,522,み,2019/8/11 13:01,2-1_all_corrected,76,60,329,49,405,109
165915,30072_20190811182842.jpg,関西スーパー京阪大和田１F,7602,大阪,581,そ,2019/8/11 18:27,2-1_all_corrected,97,88,139,292,236,380
165740,30144_20190811172005.jpg,イオン幕張,**13,千葉,350,そ,2019/8/11 17:19,2-1_all_corrected,58,46,192,165,250,211
165912,30144_20190811182733.jpg,イオン幕張,8836,千葉,502,も,2019/8/11 18:27,2-1_all_corrected,55,37,251,150,306,187
165581,30078_20190811161727.jpg,イオンスタイル仙台卸町店,7930,仙台,580,さ,2019/8/11 16:16,2-1_all_corrected,57,43,246,81,303,124
165377,30110_20190811145442.jpg,イオン金沢八景,2673,練馬,301,さ,2019/8/11 14:54,2-1_all_corrected,80,61,16,389,96,450
165713,30167_20190811171020.jpg,イオン東雲店,3988,足立,331,つ,2019/8/11 17:09,2-1_all_corrected,75,56,275,218,350,274
164858,30090_20190811102910.jpg,イトーヨーカドー木場 西棟,5644,足立,531,も,2019/8/11 10:28,2-1_all_corrected,77,54,248,288,325,342
164867,30006_20190811103434.jpg,スギ薬局南千里,3758,仙台,501,た,2019/8/11 10:34,2-1_all_corrected,93,58,326,48,419,106
165722,30144_20190811171328.jpg,イオン幕張,2817,千葉,331,ら,2019/8/11 17:12,2-1_all_corrected,83,65,400,351,483,416
166198,30063_20190811204853.jpg,コーナン相模原小山モール,*483,相模,301,た,2019/8/11 20:48,2-1_all_corrected,73,63,450,189,523,252
165187,30103_20190811133231.jpg,八尾老原１丁目,***7,大阪,30,ひ,2019/8/11 13:32,2-1_all_corrected,46,39,195,115,241,154
165914,30163_20190811182840.jpg,コープ葛飾白鳥店(地上),7007,足立,534,て,2019/8/11 18:28,2-1_all_corrected,75,52,374,211,449,263
165741,30078_20190811172019.jpg,イオンスタイル仙台卸町店,3551,仙台,300,に,2019/8/11 17:19,2-1_all_corrected,48,41,377,44,425,85
165587,30110_20190811161941.jpg,イオン金沢八景,2222,横浜,313,や,2019/8/11 16:19,2-1_all_corrected,77,66,281,201,358,267
166101,30169_20190811194633.jpg,イオン相模原ショッピングセンター,9247,多摩,580,と,2019/8/11 19:45,2-1_all_corrected,88,66,220,96,308,162
165971,30157_20190811184846.jpg,関西スーパー中央,1600,神戸,535,く,2019/8/11 18:48,2-1_all_corrected,34,47,212,152,246,199
166152,30111_20190811201945.jpg,イオン稲毛,9438,千葉,530,せ,2019/8/11 20:19,2-1_all_corrected,48,43,187,137,235,180
165982,30144_20190811185120.jpg,イオン幕張,*827,品川,342,ち,2019/8/11 18:50,2-1_all_corrected,92,63,372,387,464,450
165385,30144_20190811145741.jpg,イオン幕張,**34,千葉,535,も,2019/8/11 14:57,2-1_all_corrected,49,43,55,195,104,238
165712,30110_20190811171011.jpg,イオン金沢八景,5000,横浜,347,は,2019/8/11 17:09,2-1_all_corrected,63,62,31,189,94,251
165520,30169_20190811154934.jpg,イオン相模原ショッピングセンター,*112,多摩,301,ろ,2019/8/11 15:49,2-1_all_corrected,74,53,335,173,409,226
166146,30169_20190811201510.jpg,イオン相模原ショッピングセンター,9430,相模,580,ね,2019/8/11 20:14,2-1_all_corrected,88,68,374,315,462,383
164872,30078_20190811103642.jpg,イオンスタイル仙台卸町店,2495,仙台,500,ね,2019/8/11 10:36,2-1_all_corrected,68,54,179,96,247,150
165938,30086_20190811183551.jpg,テックランド大阪りんくう,***8,和泉,30,ま,2019/8/11 18:35,2-1_all_corrected,49,39,221,117,270,156
165336,30169_20190811143226.jpg,イオン相模原ショッピングセンター,4313,相模,583,う,2019/8/11 14:31,2-1_all_corrected,98,70,170,91,268,161
164821,30144_20190811101354.jpg,イオン幕張,***1,千葉,304,み,2019/8/11 10:13,2-1_all_corrected,49,35,136,107,185,142
165907,30169_20190811182517.jpg,イオン相模原ショッピングセンター,1188,相模,354,て,2019/8/11 18:24,2-1_all_corrected,53,44,436,138,489,182
165900,30169_20190811182319.jpg,イオン相模原ショッピングセンター,**26,相模,533,の,2019/8/11 18:22,2-1_all_corrected,83,65,294,86,377,151
165952,30169_20190811184212.jpg,イオン相模原ショッピングセンター,1188,相模,354,て,2019/8/11 18:41,2-1_all_corrected,75,55,334,164,409,219
166176,30169_20190811203404.jpg,イオン相模原ショッピングセンター,*541,相模,580,み,2019/8/11 20:33,2-1_all_corrected,92,74,362,353,454,427
165390,30167_20190811145849.jpg,イオン東雲店,8529,品川,500,は,2019/8/11 14:58,2-1_all_corrected,77,56,162,230,239,286
166147,30167_20190811201515.jpg,イオン東雲店,6507,足立,301,る,2019/8/11 20:14,2-1_all_corrected,81,76,155,128,236,204
165964,30144_20190811184702.jpg,イオン幕張,*221,習志野,532,り,2019/8/11 18:46,2-1_all_corrected,58,42,187,151,245,193
165557,30144_20190811160641.jpg,イオン幕張,9705,千葉,301,は,2019/8/11 16:06,2-1_all_corrected,59,42,176,133,235,175
165765,30144_20190811173100.jpg,イオン幕張,*333,千葉,348,ね,2019/8/11 17:30,2-1_all_corrected,60,42,216,162,276,204
165133,30072_20190811130316.jpg,関西スーパー京阪大和田１F,*227,大阪,535,も,2019/8/11 13:02,2-1_all_corrected,72,57,300,125,372,182
165791,30052_20190811174208.jpg,西友市ヶ尾,4709,川崎,500,ひ,2019/8/11 17:41,2-1_all_corrected,79,51,303,274,382,325
166113,30079_20190811195458.jpg,ピットデザイン仙台卸町駅前駐車場,6071,仙台,580,ね,2019/8/11 19:54,2-1_all_corrected,57,43,377,216,434,259
165908,30045_20190811182525.jpg,マックスバリュー徳川明倫,2525,名古屋,31,そ,2019/8/11 18:24,2-1_all_corrected,63,61,39,272,102,333
165762,30169_20190811172919.jpg,イオン相模原ショッピングセンター,5195,相模,330,と,2019/8/11 17:28,2-1_all_corrected,79,58,309,107,388,165
165102,30039_20190811124745.jpg,イトーヨーカドー大井町,*812,品川,545,と,2019/8/11 12:47,2-1_all_corrected,68,70,46,255,114,325
165337,30090_20190811143310.jpg,イトーヨーカドー木場 西棟,*324,足立,337,ぬ,2019/8/11 14:32,2-1_all_corrected,69,59,332,251,401,310
165939,30167_20190811183558.jpg,イオン東雲店,4704,足立,481,り,2019/8/11 18:35,2-1_all_corrected,67,64,166,271,233,335
165308,30110_20190811142411.jpg,イオン金沢八景,4432,横浜,400,れ,2019/8/11 14:23,2-1_all_corrected,71,54,227,253,298,307
165621,30144_20190811163434.jpg,イオン幕張,*620,習志野,334,て,2019/8/11 16:33,2-1_all_corrected,83,60,243,316,326,376
166057,30144_20190811192138.jpg,イオン幕張,*615,千葉,342,は,2019/8/11 19:21,2-1_all_corrected,46,39,260,91,306,130
165425,30078_20190811151500.jpg,イオンスタイル仙台卸町店,3037,仙台,580,え,2019/8/11 15:14,2-1_all_corrected,69,59,166,142,235,201
165617,30110_20190811163127.jpg,イオン金沢八景,*815,横浜,538,は,2019/8/11 16:31,2-1_all_corrected,77,55,280,250,357,305
166200,30078_20190811204902.jpg,イオンスタイル仙台卸町店,1062,仙台,300,ろ,2019/8/11 20:48,2-1_all_corrected,103,72,259,371,362,443
164930,30001_20190811111147.jpg,関西スーパー高石駅前,6048,奈良,580,は,2019/8/11 11:11,2-1_all_corrected,78,60,309,153,387,213
165220,30144_20190811134400.jpg,イオン幕張,4654,滋賀,50,な,2019/8/11 13:43,2-1_all_corrected,48,42,78,163,126,205
165012,30078_20190811115751.jpg,イオンスタイル仙台卸町店,8700,岩手,301,そ,2019/8/11 11:57,2-1_all_corrected,58,37,269,47,327,84
165818,30078_20190811175249.jpg,イオンスタイル仙台卸町店,3893,秋田,300,ゆ,2019/8/11 17:52,2-1_all_corrected,57,47,345,94,402,141
165672,30144_20190811165538.jpg,イオン幕張,3929,習志野,502,そ,2019/8/11 16:55,2-1_all_corrected,71,54,156,168,227,222
165827,30091_20190811175539.jpg,イトーヨーカドー木場 立体,4491,足立,301,に,2019/8/11 17:55,2-1_all_corrected,46,35,308,93,354,128
165424,30078_20190811151434.jpg,イオンスタイル仙台卸町店,1635,仙台,580,か,2019/8/11 15:14,2-1_all_corrected,56,43,270,69,326,112
165888,30169_20190811182004.jpg,イオン相模原ショッピングセンター,1173,千葉,301,つ,2019/8/11 18:19,2-1_all_corrected,50,43,111,83,161,126
164996,30090_20190811115013.jpg,イトーヨーカドー木場 西棟,1539,足立,530,の,2019/8/11 11:49,2-1_all_corrected,79,57,332,305,411,362
166069,30078_20190811192821.jpg,イオンスタイル仙台卸町店,2031,仙台,330,て,2019/8/11 19:28,2-1_all_corrected,58,42,334,145,392,187
166264,30090_20190811215126.jpg,イトーヨーカドー木場 西棟,5315,浜松,581,ぬ,2019/8/11 21:51,2-1_all_corrected,53,41,213,196,266,237
166290,30167_20190811225230.jpg,イオン東雲店,8838,足立,383,な,2019/8/11 22:51,2-1_all_corrected,54,45,346,105,400,150
165049,30078_20190811122044.jpg,イオンスタイル仙台卸町店,4945,仙台,580,い,2019/8/11 12:20,2-1_all_corrected,71,57,211,117,282,174
166237,30144_20190811211530.jpg,イオン幕張,4875,大宮,530,つ,2019/8/11 19:51,2-1_all_corrected,81,54,207,319,288,373
165479,30060_20190811153444.jpg,関西スーパー小野原,1661,大阪,332,そ,2019/8/11 15:34,2-1_all_corrected,94,78,481,372,575,450
165819,30060_20190811175259.jpg,関西スーパー小野原,4333,大阪,302,ゆ,2019/8/11 17:52,2-1_all_corrected,69,71,509,302,578,373
165828,30070_20190811175543.jpg,カナートモール住道第一,***8,大阪,30,ほ,2019/8/11 17:55,2-1_all_corrected,54,41,366,142,420,183
165642,30144_20190811164344.jpg,イオン幕張,9698,千葉,301,の,2019/8/11 16:43,2-1_all_corrected,58,41,240,173,298,214
164176,30144_20190810185825.jpg,イオン幕張,5577,千葉,341,は,2019/8/10 18:57,2-1_all_corrected,77,56,171,236,248,292
163737,30144_20190810160748.jpg,イオン幕張,7359,千葉,503,た,2019/8/10 16:07,2-1_all_corrected,50,34,169,103,219,137
164149,30111_20190810184836.jpg,イオン稲毛,3507,千葉,502,わ,2019/8/10 18:48,2-1_all_corrected,48,37,123,113,171,150
163502,30110_20190810143745.jpg,イオン金沢八景,1717,横浜,571,ら,2019/8/10 14:37,2-1_all_corrected,66,54,216,80,282,134
164388,30110_20190810204210.jpg,イオン金沢八景,7871,横浜,304,な,2019/8/10 18:05,2-1_all_corrected,53,44,336,137,389,181
163965,30157_20190810173702.jpg,関西スーパー中央,8576,神戸,302,む,2019/8/10 17:36,2-1_all_corrected,64,56,88,386,152,442
163998,30167_20190810174517.jpg,イオン東雲店,4909,足立,500,え,2019/8/10 17:44,2-1_all_corrected,42,32,56,0,98,32
164381,30110_20190810203713.jpg,イオン金沢八景,2913,春日部,530,も,2019/8/10 17:46,2-1_all_corrected,70,55,177,166,247,221
163362,30144_20190810133740.jpg,イオン幕張,8173,熊谷,530,は,2019/8/10 13:37,2-1_all_corrected,80,60,262,294,342,354
163706,30078_20190810155401.jpg,イオンスタイル仙台卸町店,*311,八戸,530,め,2019/8/10 15:53,2-1_all_corrected,52,47,323,110,375,157
162875,30167_20190810103304.jpg,イオン東雲店,*226,品川,300,も,2019/8/10 10:31,2-1_all_corrected,74,52,267,238,341,290
163157,30110_20190810122600.jpg,イオン金沢八景,*134,横浜,584,ら,2019/8/10 12:25,2-1_all_corrected,70,57,273,253,343,310
164372,30110_20190810203325.jpg,イオン金沢八景,2408,横浜,331,り,2019/8/10 17:31,2-1_all_corrected,95,78,163,289,258,367
164140,30157_20190810184628.jpg,関西スーパー中央,9318,神戸,330,な,2019/8/10 18:46,2-1_all_corrected,52,44,217,247,269,291
163391,30110_20190810134618.jpg,イオン金沢八景,5835,横浜,303,ぬ,2019/8/10 13:45,2-1_all_corrected,54,39,104,119,158,158
162627,30045_20190810083140.jpg,マックスバリュー徳川明倫,**10,名古屋,31,ぬ,2019/8/10 8:31,2-1_all_corrected,70,57,201,144,271,201
163168,30110_20190810123056.jpg,イオン金沢八景,*296,横浜,504,と,2019/8/10 12:30,2-1_all_corrected,51,44,492,102,543,146
164319,30111_20190810200954.jpg,イオン稲毛,3366,千葉,330,わ,2019/8/10 20:09,2-1_all_corrected,54,44,160,128,214,172
163558,30110_20190810145553.jpg,イオン金沢八景,1257,横浜,531,や,2019/8/10 14:55,2-1_all_corrected,73,57,305,203,378,260
163103,30110_20190810120633.jpg,イオン金沢八景,6078,横浜,503,ほ,2019/8/10 12:06,2-1_all_corrected,60,42,107,80,167,122
162821,30001_20190810100427.jpg,関西スーパー高石駅前,1214,和泉,533,る,2019/8/10 10:04,2-1_all_corrected,95,67,352,225,447,292
163104,30039_20190810120634.jpg,イトーヨーカドー大井町,5777,品川,331,る,2019/8/10 12:06,2-1_all_corrected,70,64,152,167,222,231
164113,30014_20190810183550.jpg,フォルテ蘇我ベルク棟,***1,千葉,30,も,2019/8/10 18:35,2-1_all_corrected,50,44,162,46,212,90
163560,30169_20190810145715.jpg,イオン相模原ショッピングセンター,6000,相模,339,そ,2019/8/10 14:56,2-1_all_corrected,51,43,357,135,408,178
163931,30169_20190810171946.jpg,イオン相模原ショッピングセンター,*298,横浜,481,れ,2019/8/10 17:19,2-1_all_corrected,80,63,148,89,228,152
163569,30110_20190810145954.jpg,イオン金沢八景,6489,横浜,504,は,2019/8/10 14:59,2-1_all_corrected,53,44,178,135,231,179
163936,30111_20190810172211.jpg,イオン稲毛,8035,千葉,301,や,2019/8/10 17:21,2-1_all_corrected,68,54,236,177,304,231
163338,30110_20190810132808.jpg,イオン金沢八景,1717,横浜,564,ほ,2019/8/10 13:27,2-1_all_corrected,52,43,144,75,196,118
163135,30169_20190810121858.jpg,イオン相模原ショッピングセンター,8318,相模,330,に,2019/8/10 12:18,2-1_all_corrected,72,60,254,185,326,245
164387,30110_20190810204117.jpg,イオン金沢八景,6614,横浜,581,こ,2019/8/10 18:01,2-1_all_corrected,74,57,288,247,362,304
163156,30144_20190810122545.jpg,イオン幕張,9889,千葉,330,め,2019/8/10 12:25,2-1_all_corrected,53,38,178,107,231,145
163151,30110_20190810122317.jpg,イオン金沢八景,9190,横浜,504,ち,2019/8/10 12:22,2-1_all_corrected,51,46,131,240,182,286
164374,30110_20190810203430.jpg,イオン金沢八景,9102,名古屋,330,は,2019/8/10 17:35,2-1_all_corrected,53,43,364,109,417,152
163707,30110_20190810155412.jpg,イオン金沢八景,*232,長野,300,る,2019/8/10 15:53,2-1_all_corrected,92,79,159,216,251,295
164380,30072_20190810203616.jpg,関西スーパー京阪大和田１F,*313,大阪,342,め,2019/8/10 20:35,2-1_all_corrected,56,46,158,76,214,122
162874,30139_20190810103259.jpg,イオン板橋ショッピングセンター,***1,練馬,30,ね,2019/8/10 10:32,2-1_all_corrected,84,61,20,389,104,450
163167,30144_20190810123019.jpg,イオン幕張,9677,習志野,501,ぬ,2019/8/10 12:29,2-1_all_corrected,73,51,189,214,262,265
164389,30110_20190810204302.jpg,イオン金沢八景,*571,川崎,501,た,2019/8/10 18:08,2-1_all_corrected,58,44,173,89,231,133
163194,30144_20190810124326.jpg,イオン幕張,2705,横浜,502,わ,2019/8/10 12:43,2-1_all_corrected,93,64,241,342,334,406
163352,30144_20190810133319.jpg,イオン幕張,*609,千葉,531,め,2019/8/10 13:32,2-1_all_corrected,53,35,139,88,192,123
163997,30167_20190810174511.jpg,イオン東雲店,4909,足立,500,え,2019/8/10 17:44,2-1_all_corrected,49,38,317,155,366,193
163399,30062_20190810135058.jpg,ミスミモール,1010,神戸,31,ゆ,2019/8/10 13:49,2-1_all_corrected,52,42,339,128,391,170
163709,30110_20190810155629.jpg,イオン金沢八景,*311,横浜,580,に,2019/8/10 15:56,2-1_all_corrected,69,60,410,270,479,330
162811,30044_20190810095809.jpg,ココス横浜港南台,3221,横浜,800,ち,2019/8/10 9:57,2-1_all_corrected,102,76,0,0,102,76
163796,30110_20190810162925.jpg,イオン金沢八景,8301,横浜,580,め,2019/8/10 16:28,2-1_all_corrected,53,44,121,159,174,203
163134,30110_20190810121835.jpg,イオン金沢八景,1210,横浜,347,み,2019/8/10 12:18,2-1_all_corrected,69,60,235,174,304,234
164123,30111_20190810183852.jpg,イオン稲毛,1211,千葉,348,そ,2019/8/10 18:38,2-1_all_corrected,78,59,301,199,379,258
163133,30110_20190810121801.jpg,イオン金沢八景,1210,横浜,347,み,2019/8/10 12:17,2-1_all_corrected,72,86,2,313,74,399
163308,30110_20190810131920.jpg,イオン金沢八景,**11,横浜,566,て,2019/8/10 13:18,2-1_all_corrected,51,41,144,51,195,92
163798,30045_20190810163025.jpg,マックスバリュー徳川明倫,**10,名古屋,31,り,2019/8/10 16:30,2-1_all_corrected,46,35,345,102,391,137
163102,30144_20190810120619.jpg,イオン幕張,4974,千葉,300,の,2019/8/10 12:05,2-1_all_corrected,58,43,152,167,210,210
163330,30110_20190810132535.jpg,イオン金沢八景,1031,横浜,585,む,2019/8/10 13:25,2-1_all_corrected,47,44,544,93,591,137
162952,30110_20190810110214.jpg,イオン金沢八景,2200,横浜,338,は,2019/8/10 11:01,2-1_all_corrected,53,38,149,54,202,92
163874,30111_20190810165936.jpg,イオン稲毛,1563,仙台,300,ひ,2019/8/10 16:59,2-1_all_corrected,57,42,381,106,438,148
163889,30057_20190810170639.jpg,ライフ東府中,***5,多摩,30,せ,2019/8/10 17:06,2-1_all_corrected,66,56,416,258,482,314
164056,30167_20190810181221.jpg,イオン東雲店,1785,習志野,501,ら,2019/8/10 18:11,2-1_all_corrected,80,66,112,223,192,289
164432,30001_20190810210444.jpg,関西スーパー高石駅前,1173,堺,331,す,2019/8/10 21:04,2-1_all_corrected,58,44,499,72,557,116
163610,30169_20190810151555.jpg,イオン相模原ショッピングセンター,2374,相模,580,は,2019/8/10 15:15,2-1_all_corrected,89,75,215,169,304,244
163046,30111_20190810114025.jpg,イオン稲毛,**58,千葉,500,た,2019/8/10 11:39,2-1_all_corrected,44,35,78,84,122,119
163280,30169_20190810131231.jpg,イオン相模原ショッピングセンター,1025,多摩,347,せ,2019/8/10 13:11,2-1_all_corrected,69,60,211,127,280,187
164208,30111_20190810191210.jpg,イオン稲毛,1213,千葉,541,ひ,2019/8/10 19:11,2-1_all_corrected,57,45,303,157,360,202
163482,30110_20190810142631.jpg,イオン金沢八景,2816,横浜,302,ほ,2019/8/10 14:26,2-1_all_corrected,47,40,99,94,146,134
163471,30167_20190810142023.jpg,イオン東雲店,3759,品川,580,う,2019/8/10 14:19,2-1_all_corrected,55,43,275,186,330,229
164239,30041_20190810192509.jpg,ライフ宮内,2659,川崎,480,か,2019/8/10 19:24,2-1_all_corrected,193,118,1130,617,1323,735
163820,30144_20190810163618.jpg,イオン幕張,4170,千葉,330,と,2019/8/10 16:35,2-1_all_corrected,87,61,246,340,333,401
163023,30001_20190810112916.jpg,関西スーパー高石駅前,3779,和泉,580,や,2019/8/10 11:28,2-1_all_corrected,103,76,288,283,391,359
163229,30110_20190810125949.jpg,イオン金沢八景,1110,横浜,547,と,2019/8/10 12:59,2-1_all_corrected,45,40,524,103,569,143
163672,30111_20190810154247.jpg,イオン稲毛,**78,千葉,344,そ,2019/8/10 15:42,2-1_all_corrected,57,44,299,170,356,214
163275,30110_20190810131056.jpg,イオン金沢八景,8695,横浜,503,み,2019/8/10 13:10,2-1_all_corrected,83,62,332,188,415,250
163040,30110_20190810113812.jpg,イオン金沢八景,*318,横浜,349,ら,2019/8/10 11:37,2-1_all_corrected,69,59,123,197,192,256
163272,30110_20190810130951.jpg,イオン金沢八景,9876,横浜,303,た,2019/8/10 13:09,2-1_all_corrected,68,52,121,79,189,131
164433,30110_20190810210504.jpg,イオン金沢八景,1123,横浜,592,て,2019/8/10 19:42,2-1_all_corrected,51,42,371,45,422,87
163616,30066_20190810151825.jpg,ジョーシン和泉中央,**33,和泉,31,さ,2019/8/10 15:17,2-1_all_corrected,69,54,214,192,283,246
162991,30110_20190810111813.jpg,イオン金沢八景,1100,横浜,358,つ,2019/8/10 11:17,2-1_all_corrected,51,41,268,99,319,140
163620,30167_20190810152132.jpg,イオン東雲店,8668,多摩,501,わ,2019/8/10 15:20,2-1_all_corrected,97,52,126,397,223,449
163881,30072_20190810170142.jpg,関西スーパー京阪大和田１F,8675,大阪,581,あ,2019/8/10 17:01,2-1_all_corrected,86,66,469,160,555,226
163243,30110_20190810130249.jpg,イオン金沢八景,3460,品川,302,ひ,2019/8/10 13:02,2-1_all_corrected,111,88,339,308,450,396
163071,30110_20190810115141.jpg,イオン金沢八景,*115,横浜,374,ぬ,2019/8/10 11:51,2-1_all_corrected,41,31,339,65,380,96
163415,30111_20190810135706.jpg,イオン稲毛,8008,千葉,558,す,2019/8/10 13:56,2-1_all_corrected,70,58,295,192,365,250
163627,30072_20190810152353.jpg,関西スーパー京阪大和田１F,7722,なにわ,830,あ,2019/8/10 15:23,2-1_all_corrected,77,64,97,153,174,217
163228,30110_20190810125941.jpg,イオン金沢八景,2210,横浜,331,と,2019/8/10 12:59,2-1_all_corrected,68,54,155,103,223,157
163673,30110_20190810154315.jpg,イオン金沢八景,*357,横浜,341,む,2019/8/10 15:42,2-1_all_corrected,67,54,441,194,508,248
163821,30144_20190810163638.jpg,イオン幕張,7299,千葉,502,と,2019/8/10 16:36,2-1_all_corrected,86,61,274,319,360,380
163674,30110_20190810154339.jpg,イオン金沢八景,*357,横浜,341,む,2019/8/10 15:43,2-1_all_corrected,48,32,143,92,191,124
163689,30072_20190810154935.jpg,関西スーパー京阪大和田１F,4559,大阪,583,か,2019/8/10 15:49,2-1_all_corrected,70,59,232,99,302,158
164467,30169_20190810211658.jpg,イオン相模原ショッピングセンター,7546,多摩,301,は,2019/8/10 21:16,2-1_all_corrected,84,83,502,352,586,435
162936,30045_20190810105830.jpg,マックスバリュー徳川明倫,*358,名古屋,32,と,2019/8/10 10:57,2-1_all_corrected,70,52,193,179,263,231
162797,30091_20190810095236.jpg,イトーヨーカドー木場 立体,7000,会津,330,の,2019/8/10 9:52,2-1_all_corrected,53,46,275,38,328,84
163013,30072_20190810112549.jpg,関西スーパー京阪大和田１F,2525,大阪,718,と,2019/8/10 11:25,2-1_all_corrected,98,78,63,372,161,450
163221,30110_20190810125654.jpg,イオン金沢八景,6591,横浜,580,ひ,2019/8/10 12:56,2-1_all_corrected,57,45,437,141,494,186
164214,30045_20190810191354.jpg,マックスバリュー徳川明倫,*358,名古屋,32,つ,2019/8/10 19:13,2-1_all_corrected,71,51,198,180,269,231
163031,30110_20190810113500.jpg,イオン金沢八景,**21,横浜,545,す,2019/8/10 11:34,2-1_all_corrected,48,37,286,105,334,142
163667,30110_20190810154029.jpg,イオン金沢八景,9289,横浜,503,む,2019/8/10 15:40,2-1_all_corrected,83,61,308,188,391,249
163660,30111_20190810153706.jpg,イオン稲毛,*510,千葉,540,ぬ,2019/8/10 15:36,2-1_all_corrected,70,55,285,208,355,263
163669,30110_20190810154159.jpg,イオン金沢八景,3283,横浜,304,ゆ,2019/8/10 15:41,2-1_all_corrected,54,43,462,206,516,249
164028,30167_20190810175757.jpg,イオン東雲店,4983,足立,480,れ,2019/8/10 17:56,2-1_all_corrected,57,45,234,210,291,255
163463,30045_20190810141709.jpg,マックスバリュー徳川明倫,*358,名古屋,32,さ,2019/8/10 14:16,2-1_all_corrected,73,54,209,163,282,217
162783,30072_20190810094354.jpg,関西スーパー京阪大和田１F,1001,大阪,599,か,2019/8/10 9:43,2-1_all_corrected,38,29,133,7,171,36
162922,30111_20190810105434.jpg,イオン稲毛,3758,千葉,301,て,2019/8/10 10:54,2-1_all_corrected,38,33,83,71,121,104
163804,30144_20190810163138.jpg,イオン幕張,1106,春日部,301,み,2019/8/10 16:31,2-1_all_corrected,58,44,156,140,214,184
163850,30111_20190810164724.jpg,イオン稲毛,9327,千葉,503,せ,2019/8/10 16:46,2-1_all_corrected,51,42,206,127,257,169
162949,30001_20190810110154.jpg,関西スーパー高石駅前,9268,和泉,581,き,2019/8/10 11:01,2-1_all_corrected,72,59,452,82,524,141
163261,30110_20190810130805.jpg,イオン金沢八景,*845,横浜,531,そ,2019/8/10 13:07,2-1_all_corrected,67,52,139,96,206,148
164043,30144_20190810180642.jpg,イオン幕張,1003,千葉,337,な,2019/8/10 18:06,2-1_all_corrected,88,60,197,275,285,335
163430,30144_20190810140501.jpg,イオン幕張,1820,千葉,581,え,2019/8/10 14:04,2-1_all_corrected,82,61,309,322,391,383
163292,30110_20190810131549.jpg,イオン金沢八景,**15,横浜,369,ほ,2019/8/10 13:15,2-1_all_corrected,129,108,471,342,600,450
163406,30110_20190810135333.jpg,イオン金沢八景,8808,横浜,533,ら,2019/8/10 13:53,2-1_all_corrected,88,64,362,221,450,285
163634,30110_20190810152623.jpg,イオン金沢八景,**27,横浜,304,み,2019/8/10 15:25,2-1_all_corrected,85,69,217,178,302,247
163257,30110_20190810130712.jpg,イオン金沢八景,9000,横浜,371,ら,2019/8/10 13:06,2-1_all_corrected,47,41,75,110,122,151
164416,30110_20190810205914.jpg,イオン金沢八景,2048,横浜,504,そ,2019/8/10 19:17,2-1_all_corrected,72,62,191,213,263,275
164011,30072_20190810175055.jpg,関西スーパー京阪大和田１F,1307,大阪,530,め,2019/8/10 17:50,2-1_all_corrected,57,46,361,85,418,131
163234,30110_20190810130049.jpg,イオン金沢八景,*801,横浜,541,せ,2019/8/10 13:00,2-1_all_corrected,51,43,438,113,489,156
163496,30110_20190810143212.jpg,イオン金沢八景,8733,横浜,303,ら,2019/8/10 14:31,2-1_all_corrected,52,35,360,77,412,112
163039,30110_20190810113729.jpg,イオン金沢八景,4323,横浜,503,は,2019/8/10 11:36,2-1_all_corrected,56,41,293,157,349,198
163805,30111_20190810163141.jpg,イオン稲毛,2632,千葉,583,い,2019/8/10 16:31,2-1_all_corrected,71,58,186,192,257,250
163233,30110_20190810130024.jpg,イオン金沢八景,1014,横浜,343,ね,2019/8/10 12:59,2-1_all_corrected,87,71,297,249,384,320
163465,30110_20190810141824.jpg,イオン金沢八景,7777,横浜,338,み,2019/8/10 14:17,2-1_all_corrected,72,57,139,79,211,136
163668,30111_20190810154149.jpg,イオン稲毛,5537,野田,501,な,2019/8/10 15:41,2-1_all_corrected,46,38,233,131,279,169
164029,30073_20190810175839.jpg,関西スーパー京阪大和田２F,**55,大阪,31,ち,2019/8/10 17:58,2-1_all_corrected,80,67,452,136,532,203
163695,30110_20190810155107.jpg,イオン金沢八景,*617,横浜,541,ろ,2019/8/10 15:50,2-1_all_corrected,81,66,302,256,383,322
163453,30078_20190810141314.jpg,イオンスタイル仙台卸町店,1120,仙台,332,ゆ,2019/8/10 14:12,2-1_all_corrected,89,63,344,269,433,332
164020,30062_20190810175614.jpg,ミスミモール,1188,神戸,31,さ,2019/8/10 17:55,2-1_all_corrected,66,61,189,165,255,226
163666,30110_20190810153924.jpg,イオン金沢八景,4846,野田,330,す,2019/8/10 15:38,2-1_all_corrected,45,35,245,67,290,102
163454,30110_20190810141350.jpg,イオン金沢八景,1117,横浜,373,な,2019/8/10 14:13,2-1_all_corrected,75,57,187,212,262,269
164073,30111_20190810181822.jpg,イオン稲毛,7183,千葉,330,の,2019/8/10 18:17,2-1_all_corrected,58,45,344,155,402,200
163256,30110_20190810130649.jpg,イオン金沢八景,1152,横浜,480,つ,2019/8/10 13:06,2-1_all_corrected,95,64,261,386,356,450
163090,30072_20190810115952.jpg,関西スーパー京阪大和田１F,2556,大阪,583,く,2019/8/10 11:58,2-1_all_corrected,105,88,21,351,126,439
162979,30110_20190810111233.jpg,イオン金沢八景,6541,横浜,330,ほ,2019/8/10 11:12,2-1_all_corrected,72,57,245,194,317,251
164410,30110_20190810205642.jpg,イオン金沢八景,*212,横浜,539,み,2019/8/10 19:06,2-1_all_corrected,71,52,350,144,421,196
163407,30110_20190810135344.jpg,イオン金沢八景,4153,横浜,504,と,2019/8/10 13:53,2-1_all_corrected,54,44,175,89,229,133
163251,30110_20190810130439.jpg,イオン金沢八景,***7,横浜,534,に,2019/8/10 13:04,2-1_all_corrected,84,64,328,235,412,299
163856,30167_20190810164950.jpg,イオン東雲店,4704,足立,481,り,2019/8/10 16:48,2-1_all_corrected,38,38,337,116,375,154
164270,30144_20190810194510.jpg,イオン幕張,*623,野田,334,た,2019/8/10 19:44,2-1_all_corrected,72,50,244,195,316,245
164042,30111_20190810180606.jpg,イオン稲毛,3126,千葉,530,ら,2019/8/10 18:05,2-1_all_corrected,54,43,195,126,249,169
163431,30144_20190810140506.jpg,イオン幕張,5625,千葉,331,そ,2019/8/10 14:04,2-1_all_corrected,53,40,118,117,171,157
163409,30110_20190810135513.jpg,イオン金沢八景,*615,横浜,349,に,2019/8/10 13:54,2-1_all_corrected,80,61,383,198,463,259
162624,30072_20190810082537.jpg,関西スーパー京阪大和田１F,*762,京都,800,せ,2019/8/10 8:25,2-1_all_corrected,78,60,229,279,307,339
163294,30110_20190810131611.jpg,イオン金沢八景,7640,横浜,330,と,2019/8/10 13:15,2-1_all_corrected,80,61,370,238,450,299
164305,30169_20190810200330.jpg,イオン相模原ショッピングセンター,1212,多摩,561,て,2019/8/10 20:02,2-1_all_corrected,89,72,343,306,432,378
162805,30006_20190810095634.jpg,スギ薬局南千里,4333,大阪,330,と,2019/8/10 9:56,2-1_all_corrected,131,123,6,157,137,280
163543,30066_20190810145053.jpg,ジョーシン和泉中央,**22,名古屋,31,ほ,2019/8/10 14:50,2-1_all_corrected,71,58,193,215,264,273
163118,30111_20190810121209.jpg,イオン稲毛,**88,千葉,434,に,2019/8/10 12:11,2-1_all_corrected,72,57,371,247,443,304
163323,30110_20190810132218.jpg,イオン金沢八景,6271,横浜,330,ほ,2019/8/10 13:21,2-1_all_corrected,70,52,215,81,285,133
162661,30090_20190810090754.jpg,イトーヨーカドー木場 西棟,9316,品川,533,わ,2019/8/10 9:07,2-1_all_corrected,80,56,411,303,491,359
163778,30072_20190810162328.jpg,関西スーパー京阪大和田１F,7791,大阪,302,ら,2019/8/10 16:22,2-1_all_corrected,50,36,398,17,448,53
163572,30110_20190810150053.jpg,イオン金沢八景,7375,横浜,331,な,2019/8/10 15:00,2-1_all_corrected,56,44,359,117,415,161
163129,30072_20190810121718.jpg,関西スーパー京阪大和田１F,2070,大阪,480,ぬ,2019/8/10 12:16,2-1_all_corrected,70,61,0,228,70,289
163189,30110_20190810124126.jpg,イオン金沢八景,1234,横浜,586,き,2019/8/10 12:40,2-1_all_corrected,70,51,329,155,399,206
164393,30168_20190810204503.jpg,イオン東雲店（屋上）,**33,足立,321,つ,2019/8/10 20:44,2-1_all_corrected,88,77,430,222,518,299
164367,30169_20190810203004.jpg,イオン相模原ショッピングセンター,1330,静岡,583,き,2019/8/10 20:29,2-1_all_corrected,68,57,255,166,323,223
163946,30111_20190810172930.jpg,イオン稲毛,7000,柏,340,さ,2019/8/10 17:29,2-1_all_corrected,56,41,402,105,458,146
163348,30111_20190810133226.jpg,イオン稲毛,**14,千葉,537,な,2019/8/10 13:31,2-1_all_corrected,55,45,275,185,330,230
163377,30110_20190810134234.jpg,イオン金沢八景,1014,横浜,504,ら,2019/8/10 13:42,2-1_all_corrected,73,57,213,249,286,306
163145,30167_20190810122110.jpg,イオン東雲店,*803,足立,331,ふ,2019/8/10 12:20,2-1_all_corrected,55,43,263,183,318,226
163383,30110_20190810134322.jpg,イオン金沢八景,*100,横浜,386,せ,2019/8/10 13:42,2-1_all_corrected,53,48,30,153,83,201
164369,30110_20190810203141.jpg,イオン金沢八景,3082,横浜,580,ま,2019/8/10 17:25,2-1_all_corrected,50,38,144,119,194,157
163187,30110_20190810124049.jpg,イオン金沢八景,1248,横浜,334,な,2019/8/10 12:40,2-1_all_corrected,72,53,118,121,190,174
163741,30111_20190810160849.jpg,イオン稲毛,1030,千葉,584,ふ,2019/8/10 16:08,2-1_all_corrected,55,42,223,153,278,195
164100,30078_20190810182826.jpg,イオンスタイル仙台卸町店,7761,仙台,580,せ,2019/8/10 18:27,2-1_all_corrected,106,71,259,368,365,439
163325,30110_20190810132230.jpg,イオン金沢八景,7212,横浜,530,の,2019/8/10 13:22,2-1_all_corrected,85,61,377,199,462,260
163580,30091_20190810150447.jpg,イトーヨーカドー木場 立体,3968,足立,57,ろ,2019/8/10 15:04,2-1_all_corrected,68,53,285,120,353,173
164335,30079_20190810201439.jpg,ピットデザイン仙台卸町駅前駐車場,7172,仙台,330,ろ,2019/8/10 20:14,2-1_all_corrected,54,42,417,94,471,136
163913,30144_20190810171348.jpg,イオン幕張,1204,千葉,334,ふ,2019/8/10 17:13,2-1_all_corrected,75,55,158,227,233,282
163784,30157_20190810162558.jpg,関西スーパー中央,5678,神戸,30,ら,2019/8/10 16:25,2-1_all_corrected,55,44,182,319,237,363
163542,30111_20190810145026.jpg,イオン稲毛,6217,千葉,330,と,2019/8/10 14:50,2-1_all_corrected,65,55,246,161,311,216
163314,30110_20190810132043.jpg,イオン金沢八景,1281,横浜,303,て,2019/8/10 13:20,2-1_all_corrected,70,56,386,170,456,226
163126,30066_20190810121608.jpg,ジョーシン和泉中央,**11,和泉,31,ま,2019/8/10 12:15,2-1_all_corrected,53,44,283,170,336,214
163748,30066_20190810161210.jpg,ジョーシン和泉中央,**11,和泉,31,つ,2019/8/10 16:11,2-1_all_corrected,53,43,258,138,311,181
164109,30072_20190810183421.jpg,関西スーパー京阪大和田１F,4949,大阪,583,す,2019/8/10 18:33,2-1_all_corrected,48,35,216,33,264,68
162850,30072_20190810101636.jpg,関西スーパー京阪大和田１F,9779,大阪,302,ぬ,2019/8/10 10:15,2-1_all_corrected,131,114,32,315,163,429
163347,30110_20190810133121.jpg,イオン金沢八景,1103,横浜,577,ろ,2019/8/10 13:30,2-1_all_corrected,49,43,127,44,176,87
163175,30168_20190810123415.jpg,イオン東雲店（屋上）,4704,足立,481,り,2019/8/10 12:33,2-1_all_corrected,71,60,398,278,469,338
163724,30062_20190810160206.jpg,ミスミモール,**11,神戸,31,め,2019/8/10 16:01,2-1_all_corrected,56,42,379,137,435,179
164153,30011_20190810184931.jpg,西友都賀第1駐車場,6623,千葉,330,ぬ,2019/8/10 18:48,2-1_all_corrected,42,65,322,83,364,148
163520,30144_20190810144340.jpg,イオン幕張,*256,千葉,502,は,2019/8/10 14:43,2-1_all_corrected,57,42,148,140,205,182
164359,30169_20190810202540.jpg,イオン相模原ショッピングセンター,1797,相模,301,ま,2019/8/10 20:25,2-1_all_corrected,82,71,404,268,486,339
163518,30167_20190810144256.jpg,イオン東雲店,*114,品川,342,つ,2019/8/10 14:41,2-1_all_corrected,53,35,288,261,341,296
162822,30110_20190810100442.jpg,イオン金沢八景,4897,横浜,503,ら,2019/8/10 10:04,2-1_all_corrected,54,42,374,90,428,132
162648,30167_20190810085413.jpg,イオン東雲店,9105,足立,330,た,2019/8/10 8:53,2-1_all_corrected,74,63,137,182,211,245
163107,30110_20190810120819.jpg,イオン金沢八景,1760,横浜,330,り,2019/8/10 12:07,2-1_all_corrected,74,55,353,179,427,234
163903,30111_20190810171117.jpg,イオン稲毛,3605,袖ヶ浦,100,さ,2019/8/10 17:10,2-1_all_corrected,52,45,289,169,341,214
163332,30110_20190810132558.jpg,イオン金沢八景,1031,横浜,585,む,2019/8/10 13:25,2-1_all_corrected,69,51,355,146,424,197
163935,30111_20190810172100.jpg,イオン稲毛,1582,千葉,531,に,2019/8/10 17:20,2-1_all_corrected,54,46,185,143,239,189
162813,30090_20190810095915.jpg,イトーヨーカドー木場 西棟,*284,所沢,483,け,2019/8/10 9:58,2-1_all_corrected,58,44,325,200,383,244
163760,30072_20190810161609.jpg,関西スーパー京阪大和田１F,**11,大阪,31,ま,2019/8/10 16:15,2-1_all_corrected,53,39,326,188,379,227
163552,30070_20190810145335.jpg,カナートモール住道第一,***2,大阪,30,も,2019/8/10 14:53,2-1_all_corrected,74,54,382,182,456,236
164119,30111_20190810183749.jpg,イオン稲毛,9813,千葉,302,す,2019/8/10 18:37,2-1_all_corrected,55,41,200,153,255,194
163165,30110_20190810122904.jpg,イオン金沢八景,2706,横浜,330,ひ,2019/8/10 12:28,2-1_all_corrected,51,41,488,81,539,122
164347,30110_20190810202011.jpg,イオン金沢八景,9116,横浜,303,の,2019/8/10 16:46,2-1_all_corrected,73,63,167,224,240,287
163734,30157_20190810160558.jpg,関西スーパー中央,5678,神戸,30,ら,2019/8/10 16:05,2-1_all_corrected,61,59,527,233,588,292
164181,30045_20190810185917.jpg,マックスバリュー徳川明倫,**18,名古屋,31,ゆ,2019/8/10 18:58,2-1_all_corrected,52,45,461,160,513,205
163196,30022_20190810124552.jpg,業務スーパー平野駅前,***8,大阪,30,も,2019/8/10 12:45,2-1_all_corrected,84,80,62,149,146,229
163539,30111_20190810144858.jpg,イオン稲毛,7333,千葉,583,え,2019/8/10 14:48,2-1_all_corrected,75,56,233,215,308,271
163530,30110_20190810144623.jpg,イオン金沢八景,4841,横浜,504,て,2019/8/10 14:45,2-1_all_corrected,66,53,233,170,299,223
163366,30157_20190810133944.jpg,関西スーパー中央,***5,神戸,30,ふ,2019/8/10 13:39,2-1_all_corrected,51,38,215,325,266,363
163154,30110_20190810122526.jpg,イオン金沢八景,*134,横浜,584,ら,2019/8/10 12:24,2-1_all_corrected,83,69,99,381,182,450
162849,30045_20190810101514.jpg,マックスバリュー徳川明倫,***8,名古屋,30,め,2019/8/10 10:14,2-1_all_corrected,59,45,254,158,313,203
164382,30110_20190810203834.jpg,イオン金沢八景,8888,浜松,353,は,2019/8/10 17:50,2-1_all_corrected,75,61,148,177,223,238
163395,30110_20190810134806.jpg,イオン金沢八景,2388,相模,331,す,2019/8/10 13:47,2-1_all_corrected,49,39,151,17,200,56
163153,30157_20190810122432.jpg,関西スーパー中央,***1,神戸,30,や,2019/8/10 12:24,2-1_all_corrected,54,41,163,309,217,350
163705,30110_20190810155340.jpg,イオン金沢八景,***2,横浜,594,ね,2019/8/10 15:53,2-1_all_corrected,42,32,450,77,492,109
163508,30110_20190810143929.jpg,イオン金沢八景,3792,横浜,300,つ,2019/8/10 14:39,2-1_all_corrected,71,54,214,187,285,241
163759,30144_20190810161520.jpg,イオン幕張,9472,横浜,504,ま,2019/8/10 16:14,2-1_all_corrected,74,51,201,249,275,300
163766,30110_20190810161856.jpg,イオン金沢八景,3858,横浜,531,や,2019/8/10 16:18,2-1_all_corrected,71,57,200,190,271,247
164127,30045_20190810184129.jpg,マックスバリュー徳川明倫,**22,名古屋,31,つ,2019/8/10 18:41,2-1_all_corrected,52,42,334,162,386,204
163553,30110_20190810145341.jpg,イオン金沢八景,1176,横浜,530,ふ,2019/8/10 14:53,2-1_all_corrected,66,56,182,163,248,219
163768,30168_20190810161951.jpg,イオン東雲店（屋上）,8969,習志野,301,ま,2019/8/10 16:19,2-1_all_corrected,82,64,388,189,470,253
163591,30157_20190810150915.jpg,関西スーパー中央,1001,神戸,31,も,2019/8/10 15:08,2-1_all_corrected,39,39,461,99,500,138
163333,30111_20190810132647.jpg,イオン稲毛,4163,千葉,580,ふ,2019/8/10 13:26,2-1_all_corrected,58,45,356,153,414,198
162649,30045_20190810085811.jpg,マックスバリュー徳川明倫,**33,名古屋,31,む,2019/8/10 8:57,2-1_all_corrected,42,36,195,131,237,167
163106,30110_20190810120753.jpg,イオン金沢八景,8872,横浜,331,せ,2019/8/10 12:07,2-1_all_corrected,81,63,313,222,394,285
164377,30110_20190810203541.jpg,イオン金沢八景,3106,横浜,503,ま,2019/8/10 17:39,2-1_all_corrected,77,61,304,190,381,251
163704,30060_20190810155339.jpg,関西スーパー小野原,*977,大阪,302,ね,2019/8/10 15:53,2-1_all_corrected,36,34,446,10,482,44
162883,30072_20190810103722.jpg,関西スーパー京阪大和田１F,1427,大阪,330,み,2019/8/10 10:36,2-1_all_corrected,83,61,174,182,257,243
163393,30110_20190810134753.jpg,イオン金沢八景,6957,横浜,503,ゆ,2019/8/10 13:47,2-1_all_corrected,55,43,448,133,503,176
163367,30110_20190810134002.jpg,イオン金沢八景,7039,横浜,530,の,2019/8/10 13:39,2-1_all_corrected,53,41,159,64,212,105
163358,30169_20190810133506.jpg,イオン相模原ショッピングセンター,8085,相模,580,と,2019/8/10 13:34,2-1_all_corrected,72,59,209,123,281,182
163197,30110_20190810124635.jpg,イオン金沢八景,1177,横浜,362,ひ,2019/8/10 12:46,2-1_all_corrected,50,41,515,95,565,136
163351,30110_20190810133259.jpg,イオン金沢八景,8699,横浜,304,ら,2019/8/10 13:32,2-1_all_corrected,78,60,315,270,393,330
164341,30110_20190810201707.jpg,イオン金沢八景,7811,横浜,580,け,2019/8/10 16:35,2-1_all_corrected,86,76,102,282,188,358
163958,30167_20190810173418.jpg,イオン東雲店,*519,練馬,336,そ,2019/8/10 17:33,2-1_all_corrected,51,40,345,281,396,321
163164,30110_20190810122750.jpg,イオン金沢八景,*136,横浜,583,ぬ,2019/8/10 12:27,2-1_all_corrected,49,41,98,185,147,226
163369,30110_20190810134028.jpg,イオン金沢八景,*325,横浜,549,た,2019/8/10 13:40,2-1_all_corrected,53,43,472,98,525,141
164001,30169_20190810174612.jpg,イオン相模原ショッピングセンター,***8,相模,591,ほ,2019/8/10 17:45,2-1_all_corrected,75,58,316,98,391,156
163472,30144_20190810142115.jpg,イオン幕張,9502,千葉,330,た,2019/8/10 14:20,2-1_all_corrected,59,43,161,153,220,196
163678,30110_20190810154615.jpg,イオン金沢八景,8663,横浜,580,な,2019/8/10 15:45,2-1_all_corrected,104,86,161,337,265,423
163027,30110_20190810113224.jpg,イオン金沢八景,3895,横浜,504,す,2019/8/10 11:32,2-1_all_corrected,47,39,350,94,397,133
164030,30072_20190810175841.jpg,関西スーパー京阪大和田１F,**55,大阪,31,ち,2019/8/10 17:58,2-1_all_corrected,81,67,451,136,532,203
164454,30169_20190810211043.jpg,イオン相模原ショッピングセンター,*717,相模,538,さ,2019/8/10 21:10,2-1_all_corrected,84,79,496,363,580,442
163671,30110_20190810154219.jpg,イオン金沢八景,7636,横浜,303,ま,2019/8/10 15:41,2-1_all_corrected,88,63,354,302,442,365
163685,30110_20190810154830.jpg,イオン金沢八景,1001,横浜,311,ら,2019/8/10 15:48,2-1_all_corrected,41,34,428,60,469,94
164205,30144_20190810191006.jpg,イオン幕張,**77,千葉,374,と,2019/8/10 19:09,2-1_all_corrected,47,37,162,98,209,135
162951,30111_20190810110212.jpg,イオン稲毛,8051,千葉,581,つ,2019/8/10 11:01,2-1_all_corrected,44,35,426,74,470,109
164090,30022_20190810182529.jpg,業務スーパー平野駅前,*111,なにわ,30,に,2019/8/10 18:24,2-1_all_corrected,81,68,112,131,193,199
164269,30070_20190810194501.jpg,カナートモール住道第一,**55,大阪,31,に,2019/8/10 19:44,2-1_all_corrected,72,53,292,147,364,200
163283,30110_20190810131354.jpg,イオン金沢八景,8432,札幌,301,ひ,2019/8/10 13:13,2-1_all_corrected,76,57,369,250,445,307
163042,30062_20190810113852.jpg,ミスミモール,**11,神戸,31,め,2019/8/10 11:38,2-1_all_corrected,72,57,274,166,346,223
163270,30110_20190810130912.jpg,イオン金沢八景,2021,習志野,530,ぬ,2019/8/10 13:08,2-1_all_corrected,45,39,71,126,116,165
163614,30072_20190810151726.jpg,関西スーパー京阪大和田１F,5137,大阪,102,あ,2019/8/10 15:16,2-1_all_corrected,57,44,313,153,370,197
163426,30078_20190810140239.jpg,イオンスタイル仙台卸町店,5363,仙台,300,も,2019/8/10 14:02,2-1_all_corrected,56,45,301,72,357,117
163089,30169_20190810115948.jpg,イオン相模原ショッピングセンター,1129,多摩,535,の,2019/8/10 11:59,2-1_all_corrected,66,56,180,218,246,274
163021,30110_20190810112720.jpg,イオン金沢八景,*701,横浜,504,に,2019/8/10 11:26,2-1_all_corrected,54,49,219,152,273,201
164036,30144_20190810180309.jpg,イオン幕張,4954,習志野,400,た,2019/8/10 18:02,2-1_all_corrected,51,38,146,127,197,165
163825,30144_20190810163744.jpg,イオン幕張,1222,千葉,337,な,2019/8/10 16:37,2-1_all_corrected,61,43,252,194,313,237
163442,30110_20190810140903.jpg,イオン金沢八景,4391,横浜,304,ほ,2019/8/10 14:08,2-1_all_corrected,86,75,191,226,277,301
162935,30072_20190810105721.jpg,関西スーパー京阪大和田１F,4004,大阪,581,ま,2019/8/10 10:56,2-1_all_corrected,50,35,103,40,153,75
163679,30167_20190810154642.jpg,イオン東雲店,6700,足立,53,か,2019/8/10 15:45,2-1_all_corrected,41,33,396,74,437,107
164232,30072_20190810192316.jpg,関西スーパー京阪大和田１F,4881,三重,502,つ,2019/8/10 19:22,2-1_all_corrected,58,46,307,131,365,177
163225,30110_20190810125831.jpg,イオン金沢八景,1483,横浜,330,ろ,2019/8/10 12:58,2-1_all_corrected,88,60,202,179,290,239
164000,30169_20190810174552.jpg,イオン相模原ショッピングセンター,6597,相模,580,つ,2019/8/10 17:45,2-1_all_corrected,55,43,144,98,199,141
163271,30110_20190810130930.jpg,イオン金沢八景,2021,習志野,530,ぬ,2019/8/10 13:09,2-1_all_corrected,49,34,466,113,515,147
163043,30001_20190810113914.jpg,関西スーパー高石駅前,8890,和泉,502,つ,2019/8/10 11:38,2-1_all_corrected,77,55,367,110,444,165
163285,30110_20190810131409.jpg,イオン金沢八景,*522,横浜,580,も,2019/8/10 13:13,2-1_all_corrected,49,36,92,35,141,71
162992,30144_20190810111814.jpg,イオン幕張,1116,千葉,336,に,2019/8/10 11:17,2-1_all_corrected,80,51,227,248,307,299
163088,30072_20190810115926.jpg,関西スーパー京阪大和田１F,**98,大阪,303,ち,2019/8/10 11:59,2-1_all_corrected,42,32,213,78,255,110
163612,30073_20190810151659.jpg,関西スーパー京阪大和田２F,5137,大阪,102,あ,2019/8/10 15:16,2-1_all_corrected,37,31,404,69,441,100
162995,30110_20190810111923.jpg,イオン金沢八景,6208,横浜,304,て,2019/8/10 11:18,2-1_all_corrected,78,60,158,201,236,261
162968,30157_20190810110819.jpg,関西スーパー中央,8340,神戸,301,ろ,2019/8/10 11:07,2-1_all_corrected,48,43,65,297,113,340
163624,30110_20190810152250.jpg,イオン金沢八景,8865,横浜,504,み,2019/8/10 15:22,2-1_all_corrected,92,86,25,263,117,349
163247,30110_20190810130410.jpg,イオン金沢八景,4799,横浜,330,す,2019/8/10 13:03,2-1_all_corrected,109,84,171,355,280,439
164096,30085_20190810182643.jpg,業務スーパー南津守,1000,なにわ,30,む,2019/8/10 18:26,2-1_all_corrected,50,43,484,264,534,307
163081,30111_20190810115715.jpg,イオン稲毛,5515,千葉,531,ゆ,2019/8/10 11:56,2-1_all_corrected,75,59,306,224,381,283
163278,30110_20190810131136.jpg,イオン金沢八景,1214,横浜,543,み,2019/8/10 13:11,2-1_all_corrected,80,59,377,206,457,265
162972,30079_20190810111010.jpg,ピットデザイン仙台卸町駅前駐車場,8988,仙台,300,ひ,2019/8/10 11:09,2-1_all_corrected,87,76,216,295,303,371
163291,30072_20190810131542.jpg,関西スーパー京阪大和田１F,*423,大阪,336,た,2019/8/10 13:15,2-1_all_corrected,51,36,163,51,214,87
163296,30110_20190810131716.jpg,イオン金沢八景,2086,横浜,303,る,2019/8/10 13:16,2-1_all_corrected,48,40,159,69,207,109
163254,30144_20190810130558.jpg,イオン幕張,*719,千葉,583,や,2019/8/10 13:05,2-1_all_corrected,53,46,4,229,57,275
162988,30110_20190810111659.jpg,イオン金沢八景,6922,横浜,302,と,2019/8/10 11:16,2-1_all_corrected,71,52,284,86,355,138
164243,30144_20190810192953.jpg,イオン幕張,2014,習志野,531,そ,2019/8/10 19:29,2-1_all_corrected,80,59,346,327,426,386
163402,30110_20190810135200.jpg,イオン金沢八景,6647,横浜,504,ゆ,2019/8/10 13:51,2-1_all_corrected,94,73,245,199,339,272
164415,30111_20190810205838.jpg,イオン稲毛,9291,千葉,502,ね,2019/8/10 20:58,2-1_all_corrected,52,40,130,116,182,156
163451,30110_20190810141247.jpg,イオン金沢八景,1516,横浜,335,せ,2019/8/10 14:12,2-1_all_corrected,78,59,279,199,357,258
163663,30110_20190810153746.jpg,イオン金沢八景,3219,横浜,581,い,2019/8/10 15:37,2-1_all_corrected,76,57,323,143,399,200
163207,30110_20190810125041.jpg,イオン金沢八景,*764,横浜,330,ひ,2019/8/10 12:50,2-1_all_corrected,52,40,103,111,155,151
163035,30110_20190810113627.jpg,イオン金沢八景,1016,横浜,360,す,2019/8/10 11:36,2-1_all_corrected,85,66,300,189,385,255
163690,30144_20190810154944.jpg,イオン幕張,5098,千葉,330,そ,2019/8/10 15:49,2-1_all_corrected,51,38,149,94,200,132
163664,30157_20190810153849.jpg,関西スーパー中央,1001,神戸,31,も,2019/8/10 15:38,2-1_all_corrected,68,53,191,374,259,427
163004,30014_20190810112136.jpg,フォルテ蘇我ベルク棟,***3,千葉,30,ち,2019/8/10 11:21,2-1_all_corrected,51,37,39,35,90,72
162921,30001_20190810105415.jpg,関西スーパー高石駅前,8200,和泉,583,こ,2019/8/10 10:53,2-1_all_corrected,82,58,347,178,429,236
163467,30169_20190810141909.jpg,イオン相模原ショッピングセンター,6458,相模,580,ふ,2019/8/10 14:18,2-1_all_corrected,75,55,288,192,363,247
163458,30143_20190810141514.jpg,イオン久里浜,*777,横浜,328,つ,2019/8/10 14:14,2-1_all_corrected,76,61,260,243,336,304
163252,30110_20190810130448.jpg,イオン金沢八景,3135,横浜,531,さ,2019/8/10 13:04,2-1_all_corrected,79,59,320,224,399,283
163255,30110_20190810130619.jpg,イオン金沢八景,5030,横浜,500,も,2019/8/10 13:05,2-1_all_corrected,79,60,302,297,381,357
163631,30144_20190810152545.jpg,イオン幕張,2211,千葉,536,む,2019/8/10 15:25,2-1_all_corrected,70,52,158,188,228,240
163051,30066_20190810114223.jpg,ジョーシン和泉中央,***8,和泉,30,ほ,2019/8/10 11:41,2-1_all_corrected,55,47,229,171,284,218
163855,30072_20190810164940.jpg,関西スーパー京阪大和田１F,1668,奈良,581,あ,2019/8/10 16:49,2-1_all_corrected,63,63,517,228,580,291
162987,30072_20190810111632.jpg,関西スーパー京阪大和田１F,7398,大阪,580,と,2019/8/10 11:16,2-1_all_corrected,63,59,0,145,63,204
163600,30137_20190810151300.jpg,イオンスタイル品川シーサイド,1011,品川,362,の,2019/8/10 15:12,2-1_all_corrected,56,44,290,57,346,101
163492,30110_20190810143007.jpg,イオン金沢八景,3588,横浜,343,め,2019/8/10 14:29,2-1_all_corrected,48,40,335,81,383,121
164227,30090_20190810192138.jpg,イトーヨーカドー木場 西棟,**32,足立,343,ひ,2019/8/10 19:21,2-1_all_corrected,46,33,160,176,206,209
163466,30110_20190810141901.jpg,イオン金沢八景,6616,横浜,530,み,2019/8/10 14:18,2-1_all_corrected,59,45,160,88,219,133
162927,30111_20190810105518.jpg,イオン稲毛,3758,千葉,301,て,2019/8/10 10:54,2-1_all_corrected,53,46,237,153,290,199
163459,30110_20190810141556.jpg,イオン金沢八景,5922,横浜,503,む,2019/8/10 14:15,2-1_all_corrected,40,31,91,61,131,92
164218,30169_20190810191822.jpg,イオン相模原ショッピングセンター,1498,相模,580,わ,2019/8/10 19:17,2-1_all_corrected,91,70,319,311,410,381
163237,30110_20190810130130.jpg,イオン金沢八景,5640,横浜,530,す,2019/8/10 13:01,2-1_all_corrected,93,74,291,240,384,314
163005,30110_20190810112153.jpg,イオン金沢八景,1247,横浜,503,め,2019/8/10 11:21,2-1_all_corrected,76,70,198,255,274,325
164482,30110_20190810212504.jpg,イオン金沢八景,*510,横浜,348,ふ,2019/8/10 21:24,2-1_all_corrected,87,81,45,326,132,407
163696,30144_20190810155114.jpg,イオン幕張,1514,千葉,583,く,2019/8/10 15:50,2-1_all_corrected,52,37,198,117,250,154
163034,30110_20190810113540.jpg,イオン金沢八景,8465,横浜,503,も,2019/8/10 11:35,2-1_all_corrected,50,43,18,151,68,194
164023,30039_20190810175712.jpg,イトーヨーカドー大井町,*481,品川,400,な,2019/8/10 17:56,2-1_all_corrected,55,43,220,139,275,182
163837,30066_20190810164318.jpg,ジョーシン和泉中央,1000,和泉,30,ち,2019/8/10 16:42,2-1_all_corrected,74,64,133,257,207,321
163728,30157_20190810160416.jpg,関西スーパー中央,**55,神戸,31,め,2019/8/10 16:03,2-1_all_corrected,54,46,195,342,249,388
164390,30110_20190810204339.jpg,イオン金沢八景,7211,横浜,580,よ,2019/8/10 18:11,2-1_all_corrected,45,37,411,35,456,72
163989,30072_20190810174255.jpg,関西スーパー京阪大和田１F,**55,大阪,31,ち,2019/8/10 17:42,2-1_all_corrected,69,59,205,259,274,318
163373,30110_20190810134206.jpg,イオン金沢八景,3916,横浜,530,り,2019/8/10 13:41,2-1_all_corrected,72,56,259,162,331,218
164399,30110_20190810205138.jpg,イオン金沢八景,3135,横浜,330,む,2019/8/10 18:44,2-1_all_corrected,52,43,288,113,340,156
164158,30167_20190810185122.jpg,イオン東雲店,4704,足立,481,り,2019/8/10 18:50,2-1_all_corrected,35,34,26,55,61,89
163987,30060_20190810174141.jpg,関西スーパー小野原,*508,大阪,533,り,2019/8/10 17:40,2-1_all_corrected,72,55,283,215,355,270
163726,30045_20190810160355.jpg,マックスバリュー徳川明倫,**33,名古屋,31,と,2019/8/10 16:03,2-1_all_corrected,73,59,180,226,253,285
163514,30110_20190810144122.jpg,イオン金沢八景,5509,横浜,302,め,2019/8/10 14:40,2-1_all_corrected,68,60,97,220,165,280
163184,30144_20190810123921.jpg,イオン幕張,3776,千葉,536,つ,2019/8/10 12:38,2-1_all_corrected,52,48,128,202,180,250
164301,30111_20190810200016.jpg,イオン稲毛,1131,千葉,501,ひ,2019/8/10 19:59,2-1_all_corrected,47,34,275,130,322,164
163329,30110_20190810132426.jpg,イオン金沢八景,2905,横浜,504,て,2019/8/10 13:23,2-1_all_corrected,46,36,498,154,544,190
162806,30090_20190810095639.jpg,イトーヨーカドー木場 西棟,3152,足立,302,す,2019/8/10 9:56,2-1_all_corrected,81,59,325,307,406,366
163115,30169_20190810121138.jpg,イオン相模原ショッピングセンター,6000,相模,339,そ,2019/8/10 12:11,2-1_all_corrected,55,46,349,143,404,189
164330,30078_20190810201311.jpg,イオンスタイル仙台卸町店,5057,秋田,580,ほ,2019/8/10 20:12,2-1_all_corrected,85,65,100,275,185,340
163327,30110_20190810132334.jpg,イオン金沢八景,*773,横浜,338,ほ,2019/8/10 13:23,2-1_all_corrected,57,43,162,47,219,90
163320,30110_20190810132126.jpg,イオン金沢八景,1228,横浜,347,ま,2019/8/10 13:20,2-1_all_corrected,45,37,123,66,168,103
163911,30169_20190810171311.jpg,イオン相模原ショッピングセンター,*918,山梨,532,す,2019/8/10 17:10,2-1_all_corrected,53,43,448,8,501,51
163171,30110_20190810123218.jpg,イオン金沢八景,2034,足立,502,て,2019/8/10 12:31,2-1_all_corrected,48,38,132,60,180,98
163149,30110_20190810122224.jpg,イオン金沢八景,2418,横浜,302,や,2019/8/10 12:21,2-1_all_corrected,74,61,221,192,295,253
164353,30110_20190810202200.jpg,イオン金沢八景,1229,湘南,334,た,2019/8/10 16:52,2-1_all_corrected,50,42,197,122,247,164
164161,30167_20190810185205.jpg,イオン東雲店,4704,足立,481,り,2019/8/10 18:51,2-1_all_corrected,69,61,146,296,215,357
163512,30110_20190810144056.jpg,イオン金沢八景,1030,横浜,348,て,2019/8/10 14:40,2-1_all_corrected,66,62,19,213,85,275
163729,30009_20190810160428.jpg,西友新北習志野,**81,習志野,334,り,2019/8/10 16:04,2-1_all_corrected,160,100,302,0,462,100
164365,30110_20190810202901.jpg,イオン金沢八景,*111,横浜,379,す,2019/8/10 17:16,2-1_all_corrected,83,74,104,190,187,264
163988,30073_20190810174251.jpg,関西スーパー京阪大和田２F,**55,大阪,31,ち,2019/8/10 17:42,2-1_all_corrected,52,43,302,167,354,210
163944,30144_20190810172601.jpg,イオン幕張,*378,千葉,333,す,2019/8/10 17:25,2-1_all_corrected,87,60,344,338,431,398
164396,30110_20190810204634.jpg,イオン金沢八景,*510,横浜,348,ふ,2019/8/10 18:23,2-1_all_corrected,75,60,300,192,375,252
164336,30110_20190810201459.jpg,イオン金沢八景,7745,横浜,34,る,2019/8/10 16:29,2-1_all_corrected,55,44,262,100,317,144
163789,30072_20190810162739.jpg,関西スーパー京阪大和田１F,**11,大阪,31,ま,2019/8/10 16:27,2-1_all_corrected,57,42,292,57,349,99
163310,30110_20190810131941.jpg,イオン金沢八景,1201,横浜,504,ふ,2019/8/10 13:19,2-1_all_corrected,43,40,67,117,110,157
163774,30111_20190810162207.jpg,イオン稲毛,1219,千葉,339,つ,2019/8/10 16:21,2-1_all_corrected,69,51,329,145,398,196
164338,30110_20190810201541.jpg,イオン金沢八景,*354,横浜,583,そ,2019/8/10 16:32,2-1_all_corrected,55,43,236,130,291,173
164300,30111_20190810195838.jpg,イオン稲毛,*210,千葉,343,ふ,2019/8/10 19:58,2-1_all_corrected,68,57,227,162,295,219
163919,30144_20190810171535.jpg,イオン幕張,9130,千葉,580,ぬ,2019/8/10 17:15,2-1_all_corrected,82,58,256,294,338,352
163125,30110_20190810121535.jpg,イオン金沢八景,1118,横浜,587,ね,2019/8/10 12:15,2-1_all_corrected,66,57,149,230,215,287
163317,30144_20190810132116.jpg,イオン幕張,9722,習志野,530,そ,2019/8/10 13:20,2-1_all_corrected,80,57,151,283,231,340
146828,30110_20190802103104.jpg,イオン金沢八景,2755,横浜,581,こ,2019/8/2 10:30,2-1_all_corrected,54,44,385,71,439,115
146633,30045_20190802082711.jpg,マックスバリュー徳川明倫,**17,名古屋,31,り,2019/8/2 8:26,2-1_all_corrected,55,41,257,118,312,159
148383,30063_20190802213457.jpg,コーナン相模原小山モール,1038,相模,480,せ,2019/8/2 21:34,2-1_all_corrected,71,63,511,282,582,345
148145,30169_20190802192249.jpg,イオン相模原ショッピングセンター,*503,相模,330,ふ,2019/8/2 19:22,2-1_all_corrected,78,62,328,80,406,142
148379,30079_20190802213244.jpg,ピットデザイン仙台卸町駅前駐車場,***3,仙台,347,り,2019/8/2 21:31,2-1_all_corrected,70,56,256,148,326,204
147900,30110_20190802175444.jpg,イオン金沢八景,***3,横浜,597,み,2019/8/2 17:53,2-1_all_corrected,67,54,397,114,464,168
147558,30169_20190802161411.jpg,イオン相模原ショッピングセンター,*200,相模,583,ぬ,2019/8/2 16:13,2-1_all_corrected,84,76,161,190,245,266
148341,30073_20190802210801.jpg,関西スーパー京阪大和田２F,2074,なにわ,301,ろ,2019/8/2 21:07,2-1_all_corrected,73,56,312,78,385,134
148312,30022_20190802204736.jpg,業務スーパー平野駅前,5562,大阪,-1,る,2019/8/2 20:46,2-1_all_corrected,64,57,6,263,70,320
148116,30169_20190802191349.jpg,イオン相模原ショッピングセンター,9382,相模,580,は,2019/8/2 19:11,2-1_all_corrected,56,43,142,149,198,192
147991,30111_20190802183143.jpg,イオン稲毛,**35,千葉,532,む,2019/8/2 18:31,2-1_all_corrected,67,57,215,175,282,232
147939,30066_20190802180907.jpg,ジョーシン和泉中央,***5,和泉,30,ら,2019/8/2 18:08,2-1_all_corrected,52,38,298,138,350,176
147753,30060_20190802170744.jpg,関西スーパー小野原,8988,大阪,503,ち,2019/8/2 17:07,2-1_all_corrected,36,33,255,9,291,42
147798,30169_20190802172149.jpg,イオン相模原ショッピングセンター,7605,相模,580,ゆ,2019/8/2 17:21,2-1_all_corrected,80,63,253,132,333,195
148181,30169_20190802194056.jpg,イオン相模原ショッピングセンター,1531,相模,580,め,2019/8/2 19:40,2-1_all_corrected,75,61,244,85,319,146
148188,30078_20190802194257.jpg,イオンスタイル仙台卸町店,6009,仙台,330,は,2019/8/2 19:42,2-1_all_corrected,100,64,183,386,283,450
147908,30110_20190802175835.jpg,イオン金沢八景,5966,横浜,580,よ,2019/8/2 17:57,2-1_all_corrected,76,60,143,249,219,309
147762,30169_20190802171022.jpg,イオン相模原ショッピングセンター,9267,相模,580,こ,2019/8/2 17:09,2-1_all_corrected,77,69,295,216,372,285
148385,30169_20190802213724.jpg,イオン相模原ショッピングセンター,*915,足立,501,め,2019/8/2 21:34,2-1_all_corrected,87,67,340,294,427,361
147557,30062_20190802161405.jpg,ミスミモール,*111,神戸,30,の,2019/8/2 16:13,2-1_all_corrected,68,55,284,141,352,196
146829,30110_20190802103110.jpg,イオン金沢八景,2173,横浜,530,ね,2019/8/2 10:30,2-1_all_corrected,43,33,407,44,450,77
148376,30169_20190802212753.jpg,イオン相模原ショッピングセンター,**24,相模,586,ゆ,2019/8/2 21:27,2-1_all_corrected,75,65,144,208,219,273
146889,30045_20190802105853.jpg,マックスバリュー徳川明倫,*358,名古屋,32,と,2019/8/2 10:58,2-1_all_corrected,52,41,314,126,366,167
147963,30072_20190802182033.jpg,関西スーパー京阪大和田１F,1022,大阪,542,て,2019/8/2 18:20,2-1_all_corrected,55,44,82,138,137,182
147352,30110_20190802144452.jpg,イオン金沢八景,*108,横浜,543,の,2019/8/2 14:43,2-1_all_corrected,75,62,413,173,488,235
146887,30101_20190802105848.jpg,にしてつストアレガネット姪浜,**55,福岡,31,も,2019/8/2 10:58,2-1_all_corrected,57,42,240,254,297,296
147955,30169_20190802181628.jpg,イオン相模原ショッピングセンター,1920,相模,330,の,2019/8/2 18:16,2-1_all_corrected,86,76,434,284,520,360
146753,30169_20190802100539.jpg,イオン相模原ショッピングセンター,8085,相模,580,と,2019/8/2 10:05,2-1_all_corrected,68,55,284,98,352,153
148266,30090_20190802202343.jpg,イトーヨーカドー木場 西棟,*708,足立,50,せ,2019/8/2 20:23,2-1_all_corrected,86,71,51,285,137,356
146798,30110_20190802102039.jpg,イオン金沢八景,2532,横浜,330,ほ,2019/8/2 10:20,2-1_all_corrected,52,44,404,89,456,133
146796,30110_20190802102011.jpg,イオン金沢八景,1252,横浜,330,む,2019/8/2 10:19,2-1_all_corrected,49,39,423,77,472,116
147811,30111_20190802172628.jpg,イオン稲毛,1898,千葉,301,の,2019/8/2 17:26,2-1_all_corrected,57,45,320,163,377,208
148250,30169_20190802201857.jpg,イオン相模原ショッピングセンター,9981,相模,502,な,2019/8/2 20:18,2-1_all_corrected,90,77,334,292,424,369
147816,30111_20190802172719.jpg,イオン稲毛,2611,千葉,331,ね,2019/8/2 17:26,2-1_all_corrected,71,53,325,149,396,202
147048,30060_20190802121344.jpg,関西スーパー小野原,6826,大阪,301,も,2019/8/2 12:13,2-1_all_corrected,77,55,231,232,308,287
146999,30110_20190802115437.jpg,イオン金沢八景,8074,横浜,581,う,2019/8/2 11:53,2-1_all_corrected,72,56,327,97,399,153
148407,30169_20190802220530.jpg,イオン相模原ショッピングセンター,*594,横浜,504,む,2019/8/2 22:05,2-1_all_corrected,47,33,175,112,222,145
147219,30078_20190802133802.jpg,イオンスタイル仙台卸町店,**50,仙台,332,な,2019/8/2 13:37,2-1_all_corrected,88,59,293,295,381,354
148097,30110_20190802190836.jpg,イオン金沢八景,2438,横浜,532,ち,2019/8/2 19:06,2-1_all_corrected,64,60,3,159,67,219
148267,30169_20190802202515.jpg,イオン相模原ショッピングセンター,7301,相模,100,せ,2019/8/2 20:24,2-1_all_corrected,78,70,418,289,496,359
146799,30110_20190802102132.jpg,イオン金沢八景,1101,横浜,549,な,2019/8/2 10:20,2-1_all_corrected,52,47,450,119,502,166
148006,30062_20190802183544.jpg,ミスミモール,8888,神戸,30,み,2019/8/2 18:34,2-1_all_corrected,77,61,296,161,373,222
147872,30072_20190802174344.jpg,関西スーパー京阪大和田１F,1967,大阪,531,り,2019/8/2 17:41,2-1_all_corrected,103,82,80,292,183,374
147415,30078_20190802151544.jpg,イオンスタイル仙台卸町店,3567,仙台,300,む,2019/8/2 15:15,2-1_all_corrected,79,57,429,309,508,366
146715,30169_20190802094418.jpg,イオン相模原ショッピングセンター,1001,相模,374,む,2019/8/2 9:43,2-1_all_corrected,71,53,383,20,454,73
148012,30045_20190802183810.jpg,マックスバリュー徳川明倫,1010,名古屋,31,ゆ,2019/8/2 18:37,2-1_all_corrected,83,74,45,271,128,345
147098,30110_20190802124007.jpg,イオン金沢八景,1269,横浜,530,ま,2019/8/2 12:39,2-1_all_corrected,46,37,98,75,144,112
148216,30169_20190802195647.jpg,イオン相模原ショッピングセンター,2777,相模,580,き,2019/8/2 19:56,2-1_all_corrected,81,65,242,144,323,209
148440,30110_20190802225236.jpg,イオン金沢八景,*125,足立,430,ち,2019/8/2 22:52,2-1_all_corrected,68,66,20,164,88,230
147408,30052_20190802151403.jpg,西友市ヶ尾,*111,横浜,30,た,2019/8/2 15:13,2-1_all_corrected,77,57,271,261,348,318
147259,30068_20190802135146.jpg,ケーヨーデイツー唐木田,***3,多摩,30,す,2019/8/2 13:50,2-1_all_corrected,45,36,314,94,359,130
146971,30045_20190802114127.jpg,マックスバリュー徳川明倫,1010,名古屋,31,も,2019/8/2 11:40,2-1_all_corrected,52,43,287,128,339,171
148245,30169_20190802201621.jpg,イオン相模原ショッピングセンター,1214,豊橋,534,の,2019/8/2 20:16,2-1_all_corrected,52,42,153,115,205,157
148077,30078_20190802190128.jpg,イオンスタイル仙台卸町店,1000,仙台,347,は,2019/8/2 19:00,2-1_all_corrected,90,68,195,302,285,370
147656,30045_20190802163413.jpg,マックスバリュー徳川明倫,8000,名古屋,30,せ,2019/8/2 16:33,2-1_all_corrected,49,43,263,170,312,213
148046,30136_20190802184845.jpg,イオンスタイル新百合ヶ丘,*830,多摩,343,ほ,2019/8/2 18:48,2-1_all_corrected,90,78,83,362,173,440
147203,30169_20190802133036.jpg,イオン相模原ショッピングセンター,2525,相模,593,け,2019/8/2 13:30,2-1_all_corrected,67,56,138,124,205,180
147499,30072_20190802155331.jpg,関西スーパー京阪大和田１F,7751,なにわ,830,あ,2019/8/2 15:52,2-1_all_corrected,76,63,102,140,178,203
146779,30110_20190802101625.jpg,イオン金沢八景,*766,横浜,580,そ,2019/8/2 10:15,2-1_all_corrected,49,39,346,99,395,138
148446,30105_20190802225847.jpg,カスミフードスクエア春日部武里,1106,春日部,-1,に,2019/8/2 22:57,2-1_all_corrected,52,38,230,165,282,203
146979,30062_20190802114302.jpg,ミスミモール,8888,神戸,30,む,2019/8/2 11:42,2-1_all_corrected,56,44,405,124,461,168
146713,30072_20190802094109.jpg,関西スーパー京阪大和田１F,1471,大阪,300,ひ,2019/8/2 9:40,2-1_all_corrected,73,55,293,256,366,311
148226,30169_20190802200340.jpg,イオン相模原ショッピングセンター,5128,相模,583,う,2019/8/2 20:03,2-1_all_corrected,73,57,325,74,398,131
148286,30169_20190802203310.jpg,イオン相模原ショッピングセンター,1221,相模,539,る,2019/8/2 20:32,2-1_all_corrected,52,46,206,83,258,129
148272,30110_20190802202604.jpg,イオン金沢八景,*181,横浜,333,ま,2019/8/2 20:25,2-1_all_corrected,50,48,547,111,597,159
147205,30070_20190802133154.jpg,カナートモール住道第一,***2,大阪,30,ほ,2019/8/2 13:30,2-1_all_corrected,78,67,11,242,89,309
148243,30067_20190802201524.jpg,ピットデザイン茨木宮島,8333,大阪,504,す,2019/8/2 20:14,2-1_all_corrected,47,42,208,221,255,263
146782,30110_20190802101643.jpg,イオン金沢八景,8080,横浜,551,る,2019/8/2 10:15,2-1_all_corrected,46,33,329,57,375,90
147187,30078_20190802132226.jpg,イオンスタイル仙台卸町店,3714,宮城,88,そ,2019/8/2 13:21,2-1_all_corrected,61,45,250,83,311,128
148354,30169_20190802211520.jpg,イオン相模原ショッピングセンター,4875,相模,301,ね,2019/8/2 21:14,2-1_all_corrected,90,74,412,351,502,425
146834,30110_20190802103126.jpg,イオン金沢八景,3900,横浜,503,み,2019/8/2 10:30,2-1_all_corrected,46,40,506,91,552,131
148192,30169_20190802194553.jpg,イオン相模原ショッピングセンター,*923,相模,583,は,2019/8/2 19:45,2-1_all_corrected,93,70,148,86,241,156
147747,30078_20190802170620.jpg,イオンスタイル仙台卸町店,6733,仙台,583,あ,2019/8/2 17:05,2-1_all_corrected,82,53,161,229,243,282
146805,30110_20190802102201.jpg,イオン金沢八景,3636,横浜,580,て,2019/8/2 10:20,2-1_all_corrected,49,40,394,111,443,151
148391,30110_20190802214714.jpg,イオン金沢八景,**10,横浜,397,ろ,2019/8/2 21:46,2-1_all_corrected,43,34,349,109,392,143
148168,30169_20190802193136.jpg,イオン相模原ショッピングセンター,1020,越谷,310,た,2019/8/2 19:30,2-1_all_corrected,71,63,376,236,447,299
146802,30110_20190802102151.jpg,イオン金沢八景,1001,横浜,554,な,2019/8/2 10:20,2-1_all_corrected,52,39,312,54,364,93
148134,30169_20190802191914.jpg,イオン相模原ショッピングセンター,7637,相模,501,ほ,2019/8/2 19:18,2-1_all_corrected,78,59,138,0,216,59
147511,30111_20190802155846.jpg,イオン稲毛,*216,千葉,500,と,2019/8/2 15:58,2-1_all_corrected,42,33,68,78,110,111
148397,30111_20190802215725.jpg,イオン稲毛,3128,千葉,530,む,2019/8/2 21:57,2-1_all_corrected,50,42,184,114,234,156
148363,30169_20190802212012.jpg,イオン相模原ショッピングセンター,1113,相模,583,や,2019/8/2 21:19,2-1_all_corrected,75,62,237,110,312,172
148352,30157_20190802211453.jpg,関西スーパー中央,**77,神戸,-1,の,2019/8/2 21:14,2-1_all_corrected,47,39,358,199,405,238
146658,30111_20190802085216.jpg,イオン稲毛,5387,土浦,330,ろ,2019/8/2 8:51,2-1_all_corrected,52,39,257,180,309,219
147741,30078_20190802170338.jpg,イオンスタイル仙台卸町店,4358,宮城,580,ほ,2019/8/2 17:03,2-1_all_corrected,100,66,106,384,206,450
146835,30110_20190802103131.jpg,イオン金沢八景,7788,横浜,389,す,2019/8/2 10:30,2-1_all_corrected,50,41,451,82,501,123
148311,30022_20190802204734.jpg,業務スーパー平野駅前,5562,大阪,-1,ほ,2019/8/2 20:46,2-1_all_corrected,63,60,270,213,333,273
147508,30169_20190802155715.jpg,イオン相模原ショッピングセンター,1112,相模,583,さ,2019/8/2 15:56,2-1_all_corrected,78,76,173,189,251,265
148115,30169_20190802191344.jpg,イオン相模原ショッピングセンター,*358,八王子,333,ふ,2019/8/2 19:11,2-1_all_corrected,70,76,487,305,557,381
148373,30169_20190802212714.jpg,イオン相模原ショッピングセンター,5539,沖縄,500,ほ,2019/8/2 21:24,2-1_all_corrected,77,71,497,348,574,419
147935,30169_20190802180811.jpg,イオン相模原ショッピングセンター,3066,相模,580,に,2019/8/2 18:07,2-1_all_corrected,84,76,398,283,482,359
148141,30110_20190802192222.jpg,イオン金沢八景,3456,横浜,332,ろ,2019/8/2 19:21,2-1_all_corrected,56,47,389,83,445,130
146813,30111_20190802102255.jpg,イオン稲毛,5387,土浦,300,ろ,2019/8/2 10:22,2-1_all_corrected,55,44,182,139,237,183
146679,30073_20190802091042.jpg,関西スーパー京阪大和田２F,*762,京都,800,せ,2019/8/2 9:10,2-1_all_corrected,39,34,34,130,73,164
147303,30169_20190802142125.jpg,イオン相模原ショッピングセンター,8526,横浜,330,け,2019/8/2 14:20,2-1_all_corrected,41,33,328,26,369,59
148179,30053_20190802193855.jpg,マックスバリュ小牧駅西,9100,尾張小牧,580,は,2019/8/2 19:38,2-1_all_corrected,71,79,155,267,226,346
148374,30169_20190802212748.jpg,イオン相模原ショッピングセンター,1103,相模,344,ほ,2019/8/2 21:27,2-1_all_corrected,84,67,265,94,349,161
147751,30111_20190802170737.jpg,イオン稲毛,3605,袖ヶ浦,100,さ,2019/8/2 17:07,2-1_all_corrected,54,46,271,154,325,200
148170,30062_20190802193301.jpg,ミスミモール,**11,神戸,31,め,2019/8/2 19:32,2-1_all_corrected,88,70,172,245,260,315
148342,30073_20190802210805.jpg,関西スーパー京阪大和田２F,2074,なにわ,301,ろ,2019/8/2 21:07,2-1_all_corrected,55,39,225,36,280,75
147756,30006_20190802170757.jpg,スギ薬局南千里,*990,大阪,330,ほ,2019/8/2 17:07,2-1_all_corrected,85,54,366,22,451,76
147903,30169_20190802175514.jpg,イオン相模原ショッピングセンター,3411,相模,580,め,2019/8/2 17:54,2-1_all_corrected,49,39,158,80,207,119
148113,30106_20190802191305.jpg,ジョーシン東大阪長田,1000,和泉,30,せ,2019/8/2 19:12,2-1_all_corrected,76,56,220,307,296,363
147951,30072_20190802181504.jpg,関西スーパー京阪大和田１F,*496,大阪,503,や,2019/8/2 18:14,2-1_all_corrected,52,44,121,147,173,191
147358,30110_20190802144905.jpg,イオン金沢八景,2178,横浜,580,ゆ,2019/8/2 14:47,2-1_all_corrected,49,44,85,127,134,171
147956,30111_20190802181632.jpg,イオン稲毛,**74,千葉,581,く,2019/8/2 18:16,2-1_all_corrected,43,35,379,86,422,121
148122,30169_20190802191518.jpg,イオン相模原ショッピングセンター,7553,相模,530,つ,2019/8/2 19:14,2-1_all_corrected,81,71,432,270,513,341
147393,30169_20190802150847.jpg,イオン相模原ショッピングセンター,6145,相模,501,ね,2019/8/2 15:05,2-1_all_corrected,84,69,343,245,427,314
147703,30111_20190802164415.jpg,イオン稲毛,*811,千葉,334,の,2019/8/2 16:43,2-1_all_corrected,49,39,382,103,431,142
147334,30078_20190802143713.jpg,イオンスタイル仙台卸町店,*923,仙台,583,ね,2019/8/2 14:36,2-1_all_corrected,53,49,165,86,218,135
147759,30169_20190802170811.jpg,イオン相模原ショッピングセンター,6140,相模,502,に,2019/8/2 17:07,2-1_all_corrected,76,60,316,105,392,165
148381,30111_20190802213309.jpg,イオン稲毛,5760,鹿児島,-1,む,2019/8/2 21:32,2-1_all_corrected,41,32,438,41,479,73
147761,30078_20190802170839.jpg,イオンスタイル仙台卸町店,1004,宮城,583,の,2019/8/2 17:08,2-1_all_corrected,55,42,252,102,307,144
146994,30157_20190802115204.jpg,関西スーパー中央,**55,神戸,31,め,2019/8/2 11:51,2-1_all_corrected,54,45,115,392,169,437
147277,30111_20190802140455.jpg,イオン稲毛,1625,千葉,330,す,2019/8/2 14:04,2-1_all_corrected,57,44,311,166,368,210
147879,30110_20190802174625.jpg,イオン金沢八景,7000,横浜,355,ち,2019/8/2 17:45,2-1_all_corrected,46,39,464,54,510,93
148207,30169_20190802195304.jpg,イオン相模原ショッピングセンター,*516,相模,301,も,2019/8/2 19:52,2-1_all_corrected,83,69,385,244,468,313
147883,30169_20190802174711.jpg,イオン相模原ショッピングセンター,3123,相模,583,す,2019/8/2 17:40,2-1_all_corrected,89,67,197,225,286,292
148231,30137_20190802200828.jpg,イオンスタイル品川シーサイド,*762,品川,302,ち,2019/8/2 20:07,2-1_all_corrected,55,43,270,39,325,82
148236,30169_20190802201134.jpg,イオン相模原ショッピングセンター,*116,多摩,339,は,2019/8/2 20:11,2-1_all_corrected,84,62,300,126,384,188
148209,30169_20190802195352.jpg,イオン相模原ショッピングセンター,6954,横浜,580,さ,2019/8/2 19:53,2-1_all_corrected,68,55,339,51,407,106
147417,30110_20190802151802.jpg,イオン金沢八景,*143,横浜,505,に,2019/8/2 15:16,2-1_all_corrected,74,57,416,232,490,289
147215,30110_20190802133534.jpg,イオン金沢八景,9484,横浜,580,ゆ,2019/8/2 13:34,2-1_all_corrected,75,59,302,216,377,275
147018,30078_20190802120221.jpg,イオンスタイル仙台卸町店,1117,仙台,534,と,2019/8/2 12:02,2-1_all_corrected,70,54,250,100,320,154
148433,30045_20190802223807.jpg,マックスバリュー徳川明倫,**33,名古屋,-1,と,2019/8/2 22:37,2-1_all_corrected,65,64,24,312,89,376
146792,30110_20190802101901.jpg,イオン金沢八景,1962,横浜,530,み,2019/8/2 10:17,2-1_all_corrected,53,42,430,138,483,180
148059,30169_20190802185509.jpg,イオン相模原ショッピングセンター,8368,相模,501,み,2019/8/2 18:54,2-1_all_corrected,81,69,391,274,472,343
148239,30169_20190802201355.jpg,イオン相模原ショッピングセンター,4627,相模,580,ふ,2019/8/2 20:13,2-1_all_corrected,82,69,405,324,487,393
147044,30169_20190802121209.jpg,イオン相模原ショッピングセンター,7963,相模,480,せ,2019/8/2 12:11,2-1_all_corrected,83,70,122,182,205,252
146935,30169_20190802111652.jpg,イオン相模原ショッピングセンター,8085,相模,580,と,2019/8/2 11:16,2-1_all_corrected,52,43,150,101,202,144
147028,30111_20190802120539.jpg,イオン稲毛,7013,千葉,330,な,2019/8/2 12:05,2-1_all_corrected,59,44,355,130,414,174
148264,30169_20190802202329.jpg,イオン相模原ショッピングセンター,6378,多摩,41,け,2019/8/2 20:22,2-1_all_corrected,66,39,214,144,280,183
148290,30066_20190802203523.jpg,ジョーシン和泉中央,***8,和泉,-1,ほ,2019/8/2 20:34,2-1_all_corrected,54,43,305,130,359,173
146756,30062_20190802100654.jpg,ミスミモール,**18,神戸,31,ふ,2019/8/2 10:06,2-1_all_corrected,68,56,271,175,339,231
148263,30169_20190802202326.jpg,イオン相模原ショッピングセンター,6378,多摩,-1,け,2019/8/2 20:22,2-1_all_corrected,46,34,102,39,148,73
148087,30169_20190802190517.jpg,イオン相模原ショッピングセンター,1908,相模,502,さ,2019/8/2 19:04,2-1_all_corrected,75,60,304,76,379,136
146780,30110_20190802101633.jpg,イオン金沢八景,**86,千葉,584,け,2019/8/2 10:15,2-1_all_corrected,52,44,368,80,420,124
148246,30169_20190802201627.jpg,イオン相模原ショッピングセンター,1214,相模,531,め,2019/8/2 20:16,2-1_all_corrected,54,43,162,130,216,173
147238,30078_20190802134353.jpg,イオンスタイル仙台卸町店,9744,仙台,580,こ,2019/8/2 13:43,2-1_all_corrected,76,53,273,166,349,219
148419,30169_20190802221637.jpg,イオン相模原ショッピングセンター,2621,相模,301,ふ,2019/8/2 22:16,2-1_all_corrected,80,68,414,327,494,395
148223,30012_20190802200200.jpg,西友都賀第2駐車場,1916,千葉,330,ら,2019/8/2 20:00,2-1_all_corrected,96,58,371,0,467,58
147896,30169_20190802175328.jpg,イオン相模原ショッピングセンター,1016,相模,333,り,2019/8/2 17:53,2-1_all_corrected,71,55,438,25,509,80
147601,30007_20190802162121.jpg,源ぺい山科東野,8000,大阪,30,せ,2019/8/2 16:20,2-1_all_corrected,48,47,519,275,567,322
147433,30169_20190802152328.jpg,イオン相模原ショッピングセンター,2165,相模,400,な,2019/8/2 15:23,2-1_all_corrected,79,63,295,103,374,166
147291,30169_20190802141250.jpg,イオン相模原ショッピングセンター,4402,八王子,300,ろ,2019/8/2 14:12,2-1_all_corrected,91,78,87,290,178,368
148444,30169_20190802225600.jpg,イオン相模原ショッピングセンター,*890,多摩,800,せ,2019/8/2 22:55,2-1_all_corrected,84,71,440,294,524,365
148020,30169_20190802183950.jpg,イオン相模原ショッピングセンター,4436,八王子,301,す,2019/8/2 18:39,2-1_all_corrected,75,69,396,253,471,322
147262,30060_20190802135324.jpg,関西スーパー小野原,2759,大阪,480,ひ,2019/8/2 13:52,2-1_all_corrected,81,66,342,363,423,429
148443,30169_20190802225536.jpg,イオン相模原ショッピングセンター,2956,相模,580,ま,2019/8/2 22:55,2-1_all_corrected,95,72,289,337,384,409
148271,30110_20190802202558.jpg,イオン金沢八景,*181,横浜,333,ま,2019/8/2 20:25,2-1_all_corrected,84,78,25,234,109,312
148427,30105_20190802222808.jpg,カスミフードスクエア春日部武里,9375,春日部,530,と,2019/8/2 22:27,2-1_all_corrected,74,63,103,283,177,346
148411,30169_20190802221118.jpg,イオン相模原ショッピングセンター,**31,相模,585,つ,2019/8/2 22:10,2-1_all_corrected,66,56,311,79,377,135
148278,30169_20190802202726.jpg,イオン相模原ショッピングセンター,***1,相模,393,あ,2019/8/2 20:27,2-1_all_corrected,71,71,485,308,556,379
148429,30078_20190802223037.jpg,イオンスタイル仙台卸町店,**38,仙台,583,を,2019/8/2 22:30,2-1_all_corrected,87,61,277,260,364,321
147899,30110_20190802175441.jpg,イオン金沢八景,8086,所沢,580,ま,2019/8/2 17:53,2-1_all_corrected,43,32,338,95,381,127
147638,30138_20190802163149.jpg,イオンスタイル湘南茅ヶ崎,3110,横浜,303,ま,2019/8/2 16:30,2-1_all_corrected,54,45,252,146,306,191
146974,30110_20190802114221.jpg,イオン金沢八景,2018,横浜,337,ほ,2019/8/2 11:41,2-1_all_corrected,46,36,481,97,527,133
148445,30169_20190802225616.jpg,イオン相模原ショッピングセンター,2100,相模,583,た,2019/8/2 22:55,2-1_all_corrected,79,67,253,138,332,205
148225,30046_20190802200335.jpg,マミーマート船橋日大[地上],2112,習志野,583,も,2019/8/2 20:02,2-1_all_corrected,89,56,37,394,126,450
146942,30066_20190802111948.jpg,ジョーシン和泉中央,***3,和泉,30,て,2019/8/2 11:19,2-1_all_corrected,53,40,328,174,381,214
146830,30110_20190802103115.jpg,イオン金沢八景,1891,横浜,301,め,2019/8/2 10:30,2-1_all_corrected,52,44,515,100,567,144
146691,30111_20190802092411.jpg,イオン稲毛,7750,千葉,580,こ,2019/8/2 9:23,2-1_all_corrected,71,61,373,231,444,292
148368,30169_20190802212232.jpg,イオン相模原ショッピングセンター,3401,相模,580,く,2019/8/2 21:22,2-1_all_corrected,92,76,118,244,210,320
146808,30110_20190802102216.jpg,イオン金沢八景,**39,横浜,353,ろ,2019/8/2 10:20,2-1_all_corrected,57,42,328,93,385,135
148361,30111_20190802212000.jpg,イオン稲毛,9388,千葉,303,す,2019/8/2 21:19,2-1_all_corrected,39,30,415,58,454,88
147540,30169_20190802160555.jpg,イオン相模原ショッピングセンター,8382,相模,580,ゆ,2019/8/2 16:05,2-1_all_corrected,79,64,240,120,319,184
148198,30169_20190802194908.jpg,イオン相模原ショッピングセンター,7762,相模,580,ひ,2019/8/2 19:48,2-1_all_corrected,82,68,223,116,305,184
146806,30110_20190802102206.jpg,イオン金沢八景,5015,横浜,500,い,2019/8/2 10:20,2-1_all_corrected,46,43,512,96,558,139
148359,30169_20190802211934.jpg,イオン相模原ショッピングセンター,5543,相模,330,さ,2019/8/2 21:19,2-1_all_corrected,74,75,508,315,582,390
147183,30110_20190802132214.jpg,イオン金沢八景,*521,横浜,538,み,2019/8/2 13:21,2-1_all_corrected,82,64,284,173,366,237
148303,30072_20190802204139.jpg,関西スーパー京阪大和田１F,8128,大阪,334,せ,2019/8/2 20:40,2-1_all_corrected,41,30,220,67,261,97
147179,30078_20190802131759.jpg,イオンスタイル仙台卸町店,9177,仙台,500,は,2019/8/2 13:17,2-1_all_corrected,66,55,339,131,405,186
148131,30169_20190802191757.jpg,イオン相模原ショッピングセンター,9011,相模,301,み,2019/8/2 19:17,2-1_all_corrected,77,55,349,42,426,97
147717,30078_20190802165228.jpg,イオンスタイル仙台卸町店,***9,宮城,589,と,2019/8/2 16:52,2-1_all_corrected,62,43,252,142,314,185
148136,30070_20190802192034.jpg,カナートモール住道第一,***2,大阪,30,ほ,2019/8/2 19:19,2-1_all_corrected,70,56,118,155,188,211
147942,30169_20190802181051.jpg,イオン相模原ショッピングセンター,*922,水戸,533,そ,2019/8/2 18:10,2-1_all_corrected,54,42,133,98,187,140
146807,30110_20190802102212.jpg,イオン金沢八景,3556,横浜,503,ゆ,2019/8/2 10:20,2-1_all_corrected,55,48,500,202,555,250
147780,30078_20190802171501.jpg,イオンスタイル仙台卸町店,5882,仙台,800,さ,2019/8/2 17:14,2-1_all_corrected,68,53,343,178,411,231
148394,30063_20190802215234.jpg,コーナン相模原小山モール,*501,大宮,-1,は,2019/8/2 21:51,2-1_all_corrected,40,44,57,50,97,94
147773,30072_20190802171349.jpg,関西スーパー京阪大和田１F,6937,大阪,580,や,2019/8/2 17:13,2-1_all_corrected,64,65,536,245,600,310
146836,30110_20190802103136.jpg,イオン金沢八景,9358,横浜,304,と,2019/8/2 10:30,2-1_all_corrected,45,36,385,43,430,79
146809,30110_20190802102221.jpg,イオン金沢八景,*232,横浜,50,ふ,2019/8/2 10:21,2-1_all_corrected,46,40,457,91,503,131
148163,30169_20190802192831.jpg,イオン相模原ショッピングセンター,2291,相模,500,ろ,2019/8/2 19:28,2-1_all_corrected,87,64,191,104,278,168
146831,30110_20190802103122.jpg,イオン金沢八景,1047,横浜,504,は,2019/8/2 10:30,2-1_all_corrected,45,35,412,59,457,94
147114,30085_20190802124558.jpg,業務スーパー南津守,1122,なにわ,31,ね,2019/8/2 12:45,2-1_all_corrected,45,36,280,141,325,177
148137,30169_20190802192037.jpg,イオン相模原ショッピングセンター,2701,湘南,580,み,2019/8/2 19:19,2-1_all_corrected,76,67,419,303,495,370
148130,30169_20190802191746.jpg,イオン相模原ショッピングセンター,2291,相模,500,ろ,2019/8/2 19:17,2-1_all_corrected,69,70,62,275,131,345
148302,30098_20190802204108.jpg,BRANCH仙台（東棟）,*217,仙台,331,せ,2019/8/2 20:40,2-1_all_corrected,94,70,312,250,406,320
148139,30078_20190802192120.jpg,イオンスタイル仙台卸町店,4931,仙台,580,せ,2019/8/2 19:20,2-1_all_corrected,96,65,257,253,353,318
147720,30157_20190802165253.jpg,関西スーパー中央,**18,神戸,31,ま,2019/8/2 16:52,2-1_all_corrected,53,43,122,325,175,368
148101,30110_20190802190852.jpg,イオン金沢八景,*612,つくば,333,ひ,2019/8/2 19:07,2-1_all_corrected,70,69,523,289,593,358
154942,30078_20190805181751.jpg,イオンスタイル仙台卸町店,6739,宮城,580,の,2019/8/5 18:17,2-1_all_corrected,76,61,173,202,249,263
155094,30078_20190805190546.jpg,イオンスタイル仙台卸町店,*223,仙台,501,す,2019/8/5 19:05,2-1_all_corrected,73,53,271,115,344,168
153999,30072_20190805110943.jpg,関西スーパー京阪大和田１F,*926,大阪,340,ね,2019/8/5 11:08,2-1_all_corrected,120,111,48,334,168,445
153952,30072_20190805104515.jpg,関西スーパー京阪大和田１F,5524,大阪,480,は,2019/8/5 10:44,2-1_all_corrected,72,55,100,203,172,258
155290,30169_20190805202203.jpg,イオン相模原ショッピングセンター,7766,相模,501,ぬ,2019/8/5 20:21,2-1_all_corrected,85,62,380,372,465,434
154184,30111_20190805123629.jpg,イオン稲毛,*730,千葉,586,ひ,2019/8/5 12:36,2-1_all_corrected,94,129,84,292,178,421
155056,30078_20190805185209.jpg,イオンスタイル仙台卸町店,7503,仙台,580,と,2019/8/5 18:51,2-1_all_corrected,100,69,170,360,270,429
155264,30078_20190805201416.jpg,イオンスタイル仙台卸町店,*515,仙台,334,す,2019/8/5 20:13,2-1_all_corrected,95,71,358,331,453,402
155069,30078_20190805185611.jpg,イオンスタイル仙台卸町店,3485,仙台,530,そ,2019/8/5 18:55,2-1_all_corrected,93,65,295,305,388,370
154183,30111_20190805123609.jpg,イオン稲毛,2762,千葉,581,こ,2019/8/5 12:35,2-1_all_corrected,68,57,205,178,273,235
154974,30078_20190805182932.jpg,イオンスタイル仙台卸町店,3588,仙台,333,む,2019/8/5 18:29,2-1_all_corrected,77,56,266,139,343,195
154772,30111_20190805170514.jpg,イオン稲毛,3605,袖ヶ浦,100,さ,2019/8/5 17:04,2-1_all_corrected,52,42,202,133,254,175
154911,30072_20190805180130.jpg,関西スーパー京阪大和田１F,*520,大阪,580,や,2019/8/5 18:01,2-1_all_corrected,81,58,148,183,229,241
155201,30078_20190805194810.jpg,イオンスタイル仙台卸町店,*369,仙台,530,ひ,2019/8/5 19:47,2-1_all_corrected,91,61,366,358,457,419
154182,30111_20190805123603.jpg,イオン稲毛,3630,神戸,302,ゆ,2019/8/5 12:35,2-1_all_corrected,70,53,309,169,379,222
155050,30111_20190805185025.jpg,イオン稲毛,*426,千葉,330,ま,2019/8/5 18:50,2-1_all_corrected,46,36,433,59,479,95
154975,30045_20190805182940.jpg,マックスバリュー徳川明倫,*358,名古屋,32,と,2019/8/5 18:28,2-1_all_corrected,69,49,296,180,365,229
153996,30072_20190805110826.jpg,関西スーパー京阪大和田１F,2538,大阪,480,て,2019/8/5 11:08,2-1_all_corrected,73,58,175,232,248,290
154178,30111_20190805123524.jpg,イオン稲毛,7850,千葉,330,ち,2019/8/5 12:34,2-1_all_corrected,73,57,267,194,340,251
155402,30078_20190805211227.jpg,イオンスタイル仙台卸町店,6165,仙台,501,ち,2019/8/5 21:12,2-1_all_corrected,92,59,273,290,365,349
154988,30078_20190805183418.jpg,イオンスタイル仙台卸町店,1939,仙台,501,せ,2019/8/5 18:33,2-1_all_corrected,52,44,314,74,366,118
155254,30078_20190805201213.jpg,イオンスタイル仙台卸町店,**31,仙台,333,ひ,2019/8/5 20:11,2-1_all_corrected,68,55,347,79,415,134
155059,30169_20190805185247.jpg,イオン相模原ショッピングセンター,**13,多摩,535,ろ,2019/8/5 18:52,2-1_all_corrected,82,66,436,383,518,449
155238,30072_20190805200748.jpg,関西スーパー京阪大和田１F,**83,大阪,583,を,2019/8/5 20:07,2-1_all_corrected,98,77,30,274,128,351
155207,30098_20190805195136.jpg,BRANCH仙台（東棟）,7000,宮城,311,な,2019/8/5 19:51,2-1_all_corrected,96,66,248,271,344,337
155176,30078_20190805193948.jpg,イオンスタイル仙台卸町店,*345,仙台,331,み,2019/8/5 19:39,2-1_all_corrected,85,63,354,241,439,304
155171,30078_20190805193654.jpg,イオンスタイル仙台卸町店,6091,仙台,480,り,2019/8/5 19:36,2-1_all_corrected,56,41,290,15,346,56
155381,30078_20190805210528.jpg,イオンスタイル仙台卸町店,*891,仙台,300,も,2019/8/5 20:50,2-1_all_corrected,88,63,342,296,430,359
155178,30062_20190805194000.jpg,ミスミモール,1188,神戸,31,さ,2019/8/5 19:39,2-1_all_corrected,81,67,176,207,257,274
155319,30078_20190805203448.jpg,イオンスタイル仙台卸町店,8495,仙台,501,た,2019/8/5 20:34,2-1_all_corrected,80,59,285,187,365,246
155114,30078_20190805191452.jpg,イオンスタイル仙台卸町店,4051,仙台,530,さ,2019/8/5 19:14,2-1_all_corrected,91,63,329,314,420,377
154032,30078_20190805112402.jpg,イオンスタイル仙台卸町店,*744,仙台,300,ろ,2019/8/5 11:23,2-1_all_corrected,85,62,183,222,268,284
154809,30066_20190805172402.jpg,ジョーシン和泉中央,**11,和泉,31,て,2019/8/5 17:23,2-1_all_corrected,48,37,324,118,372,155
154209,30072_20190805124903.jpg,関西スーパー京阪大和田１F,*378,なにわ,530,ゆ,2019/8/5 12:48,2-1_all_corrected,71,59,244,164,315,223
154494,30006_20190805145856.jpg,スギ薬局南千里,9573,大阪,581,つ,2019/8/5 14:58,2-1_all_corrected,90,57,366,30,456,87
155387,30078_20190805210554.jpg,イオンスタイル仙台卸町店,7499,仙台,500,つ,2019/8/5 20:54,2-1_all_corrected,71,58,294,109,365,167
155141,30147_20190805192510.jpg,三井のリパーク 厚木文化会館,*514,相模,583,ぬ,2019/8/5 19:23,2-1_all_corrected,96,70,197,295,293,365
155380,30078_20190805210523.jpg,イオンスタイル仙台卸町店,***3,仙台,534,は,2019/8/5 20:49,2-1_all_corrected,92,64,243,254,335,318
155179,30078_20190805194020.jpg,イオンスタイル仙台卸町店,1737,宮城,503,ね,2019/8/5 19:39,2-1_all_corrected,55,44,280,38,335,82
155170,30169_20190805193640.jpg,イオン相模原ショッピングセンター,3131,多摩,503,の,2019/8/5 19:36,2-1_all_corrected,88,70,362,264,450,334
154600,30111_20190805155608.jpg,イオン稲毛,8888,千葉,386,て,2019/8/5 15:55,2-1_all_corrected,52,45,356,180,408,225
155184,30078_20190805194112.jpg,イオンスタイル仙台卸町店,2834,仙台,501,て,2019/8/5 19:40,2-1_all_corrected,95,64,325,335,420,399
155183,30078_20190805194057.jpg,イオンスタイル仙台卸町店,2515,宮城,330,な,2019/8/5 19:40,2-1_all_corrected,55,39,224,0,279,39
154208,30110_20190805124856.jpg,イオン金沢八景,6984,横浜,580,や,2019/8/5 12:48,2-1_all_corrected,50,48,550,220,600,268
155329,30169_20190805203708.jpg,イオン相模原ショッピングセンター,9309,八王子,501,に,2019/8/5 20:36,2-1_all_corrected,91,76,384,327,475,403
155124,30060_20190805191741.jpg,関西スーパー小野原,9999,大阪,31,り,2019/8/5 19:16,2-1_all_corrected,78,66,521,271,599,337
155316,30078_20190805203420.jpg,イオンスタイル仙台卸町店,4053,仙台,501,ち,2019/8/5 20:33,2-1_all_corrected,78,64,404,241,482,305
154654,30111_20190805161949.jpg,イオン稲毛,*705,千葉,587,つ,2019/8/5 16:19,2-1_all_corrected,52,42,150,147,202,189
155327,30111_20190805203642.jpg,イオン稲毛,1001,千葉,373,ゆ,2019/8/5 20:36,2-1_all_corrected,79,56,300,208,379,264
154884,30072_20190805175429.jpg,関西スーパー京阪大和田１F,8087,大阪,580,も,2019/8/5 17:53,2-1_all_corrected,79,57,34,262,113,319
154625,30072_20190805160657.jpg,関西スーパー京阪大和田１F,3588,大阪,583,も,2019/8/5 16:06,2-1_all_corrected,67,62,47,196,114,258
155360,30110_20190805205741.jpg,イオン金沢八景,7393,横浜,330,ぬ,2019/8/5 20:56,2-1_all_corrected,74,66,73,199,147,265
155190,30060_20190805194312.jpg,関西スーパー小野原,7159,京都,400,た,2019/8/5 19:42,2-1_all_corrected,48,31,258,253,306,284
154045,30001_20190805113206.jpg,関西スーパー高石駅前,1921,和泉,46,は,2019/8/5 11:31,2-1_all_corrected,60,44,451,85,511,129
155197,30078_20190805194544.jpg,イオンスタイル仙台卸町店,*590,仙台,580,ほ,2019/8/5 19:45,2-1_all_corrected,90,61,222,261,312,322
154283,30110_20190805132458.jpg,イオン金沢八景,1178,横浜,536,す,2019/8/5 13:24,2-1_all_corrected,63,64,0,208,63,272
155332,30078_20190805203758.jpg,イオンスタイル仙台卸町店,*124,仙台,531,さ,2019/8/5 20:37,2-1_all_corrected,73,52,306,120,379,172
154648,30110_20190805161802.jpg,イオン金沢八景,2445,世田谷,480,あ,2019/8/5 16:17,2-1_all_corrected,50,43,93,184,143,227
154225,30062_20190805125619.jpg,ミスミモール,***3,神戸,30,ふ,2019/8/5 12:55,2-1_all_corrected,80,72,40,261,120,333
155196,30078_20190805194519.jpg,イオンスタイル仙台卸町店,*225,仙台,332,つ,2019/8/5 19:44,2-1_all_corrected,90,56,379,310,469,366
155191,30078_20190805194423.jpg,イオンスタイル仙台卸町店,6666,宮城,50,は,2019/8/5 19:43,2-1_all_corrected,76,47,305,192,381,239
155198,30078_20190805194631.jpg,イオンスタイル仙台卸町店,9512,岩手,501,ほ,2019/8/5 19:45,2-1_all_corrected,84,63,283,206,367,269
154623,30110_20190805160636.jpg,イオン金沢八景,5678,横浜,586,さ,2019/8/5 16:05,2-1_all_corrected,75,58,393,136,468,194
155153,30110_20190805192909.jpg,イオン金沢八景,**28,横浜,356,さ,2019/8/5 19:28,2-1_all_corrected,42,37,421,15,463,52
154871,30066_20190805175041.jpg,ジョーシン和泉中央,**11,和泉,31,て,2019/8/5 17:50,2-1_all_corrected,67,58,201,198,268,256
154769,30110_20190805170434.jpg,イオン金沢八景,5511,横浜,339,ほ,2019/8/5 17:03,2-1_all_corrected,45,39,383,71,428,110
155213,30169_20190805195315.jpg,イオン相模原ショッピングセンター,4105,多摩,580,さ,2019/8/5 19:52,2-1_all_corrected,101,75,199,110,300,185
155021,30078_20190805184323.jpg,イオンスタイル仙台卸町店,*929,仙台,330,り,2019/8/5 18:42,2-1_all_corrected,86,62,331,266,417,328
154563,30078_20190805153731.jpg,イオンスタイル仙台卸町店,7583,仙台,530,た,2019/8/5 15:37,2-1_all_corrected,89,64,258,292,347,356
155017,30169_20190805184238.jpg,イオン相模原ショッピングセンター,3773,多摩,531,ゆ,2019/8/5 18:42,2-1_all_corrected,96,82,424,348,520,430
155487,30006_20190805221200.jpg,スギ薬局南千里,5150,徳島,530,め,2019/8/5 22:11,2-1_all_corrected,78,39,505,0,583,39
155222,30078_20190805195644.jpg,イオンスタイル仙台卸町店,9261,仙台,500,ほ,2019/8/5 19:56,2-1_all_corrected,79,53,372,242,451,295
154599,30169_20190805155512.jpg,イオン相模原ショッピングセンター,5568,相模,530,つ,2019/8/5 15:54,2-1_all_corrected,70,59,202,174,272,233
154995,30045_20190805183724.jpg,マックスバリュー徳川明倫,**17,名古屋,31,り,2019/8/5 18:36,2-1_all_corrected,52,39,269,106,321,145
155088,30072_20190805190457.jpg,関西スーパー京阪大和田１F,2222,なにわ,586,ひ,2019/8/5 19:04,2-1_all_corrected,76,57,259,203,335,260
154966,30078_20190805182603.jpg,イオンスタイル仙台卸町店,8325,仙台,580,こ,2019/8/5 18:25,2-1_all_corrected,82,58,204,160,286,218
154959,30078_20190805182414.jpg,イオンスタイル仙台卸町店,5021,宮城,580,に,2019/8/5 18:23,2-1_all_corrected,71,54,200,78,271,132
153947,30033_20190805104309.jpg,マックスバリュ南15条,8008,札幌,324,ち,2019/8/5 10:42,2-1_all_corrected,95,77,434,319,529,396
155247,30078_20190805201011.jpg,イオンスタイル仙台卸町店,7108,仙台,300,は,2019/8/5 20:09,2-1_all_corrected,87,61,409,297,496,358
154395,30169_20190805141345.jpg,イオン相模原ショッピングセンター,1118,相模,345,て,2019/8/5 14:13,2-1_all_corrected,58,44,379,141,437,185
154957,30078_20190805182406.jpg,イオンスタイル仙台卸町店,*326,仙台,503,ふ,2019/8/5 18:23,2-1_all_corrected,81,58,314,200,395,258
155011,30111_20190805184159.jpg,イオン稲毛,8008,千葉,352,ね,2019/8/5 18:41,2-1_all_corrected,51,37,126,98,177,135
155472,30078_20190805220333.jpg,イオンスタイル仙台卸町店,4355,仙台,300,と,2019/8/5 22:03,2-1_all_corrected,91,64,313,283,404,347
154106,30006_20190805120417.jpg,スギ薬局南千里,**18,大阪,31,む,2019/8/5 12:03,2-1_all_corrected,94,56,310,90,404,146
155020,30078_20190805184303.jpg,イオンスタイル仙台卸町店,***2,仙台,337,ま,2019/8/5 18:42,2-1_all_corrected,99,67,217,305,316,372
155018,30078_20190805184244.jpg,イオンスタイル仙台卸町店,3718,仙台,300,ね,2019/8/5 18:42,2-1_all_corrected,48,47,189,8,237,55
154768,30169_20190805170430.jpg,イオン相模原ショッピングセンター,5132,多摩,530,は,2019/8/5 17:04,2-1_all_corrected,69,54,143,89,212,143
155087,30078_20190805190436.jpg,イオンスタイル仙台卸町店,3637,仙台,583,あ,2019/8/5 19:04,2-1_all_corrected,77,56,245,186,322,242
154367,30060_20190805135505.jpg,関西スーパー小野原,6532,大阪,503,み,2019/8/5 13:54,2-1_all_corrected,69,60,477,257,546,317
155410,30110_20190805211416.jpg,イオン金沢八景,*405,横浜,342,な,2019/8/5 21:13,2-1_all_corrected,76,67,32,180,108,247
154993,30111_20190805183640.jpg,イオン稲毛,3003,千葉,346,ひ,2019/8/5 18:36,2-1_all_corrected,52,40,168,105,220,145
155042,30078_20190805184841.jpg,イオンスタイル仙台卸町店,6404,仙台,300,や,2019/8/5 18:48,2-1_all_corrected,81,56,346,217,427,273
153983,30079_20190805110221.jpg,ピットデザイン仙台卸町駅前駐車場,5817,仙台,580,て,2019/8/5 11:01,2-1_all_corrected,49,37,444,170,493,207
154994,30078_20190805183643.jpg,イオンスタイル仙台卸町店,2677,宮城,581,い,2019/8/5 18:36,2-1_all_corrected,83,58,239,278,322,336
155283,30169_20190805201958.jpg,イオン相模原ショッピングセンター,2860,多摩,580,の,2019/8/5 20:19,2-1_all_corrected,88,77,438,358,526,435
154785,30110_20190805171257.jpg,イオン金沢八景,3918,横浜,303,の,2019/8/5 17:12,2-1_all_corrected,55,43,499,92,554,135
155006,30169_20190805184118.jpg,イオン相模原ショッピングセンター,***1,相模,387,ろ,2019/8/5 18:40,2-1_all_corrected,50,36,491,1,541,37
154915,30111_20190805180256.jpg,イオン稲毛,6775,千葉,503,そ,2019/8/5 18:02,2-1_all_corrected,55,46,343,157,398,203
154572,30169_20190805154130.jpg,イオン相模原ショッピングセンター,*753,相模,536,す,2019/8/5 15:41,2-1_all_corrected,53,42,153,92,206,134
155008,30078_20190805184134.jpg,イオンスタイル仙台卸町店,5131,仙台,501,つ,2019/8/5 18:41,2-1_all_corrected,92,69,371,308,463,377
155037,30169_20190805184802.jpg,イオン相模原ショッピングセンター,9995,相模,330,と,2019/8/5 18:47,2-1_all_corrected,51,41,149,99,200,140
155097,30072_20190805190620.jpg,関西スーパー京阪大和田１F,8120,大阪,334,せ,2019/8/5 19:05,2-1_all_corrected,47,34,399,84,446,118
155090,30078_20190805190507.jpg,イオンスタイル仙台卸町店,*619,仙台,330,ふ,2019/8/5 19:04,2-1_all_corrected,51,43,176,27,227,70
154714,30111_20190805164941.jpg,イオン稲毛,***3,習志野,372,つ,2019/8/5 16:49,2-1_all_corrected,69,70,501,286,570,356
155269,30111_20190805201457.jpg,イオン稲毛,2654,千葉,400,ね,2019/8/5 20:14,2-1_all_corrected,56,44,174,144,230,188
155294,30169_20190805202245.jpg,イオン相模原ショッピングセンター,4138,多摩,302,さ,2019/8/5 20:22,2-1_all_corrected,88,75,412,345,500,420
154779,30118_20190805170954.jpg,ショッパーズプラザ横須賀(6F・屋上),**22,野田,430,は,2019/8/5 17:09,2-1_all_corrected,56,75,4,247,60,322
155463,30078_20190805215326.jpg,イオンスタイル仙台卸町店,1951,仙台,300,め,2019/8/5 21:53,2-1_all_corrected,83,60,414,293,497,353
153816,30072_20190805085804.jpg,関西スーパー京阪大和田１F,*762,京都,800,せ,2019/8/5 8:57,2-1_all_corrected,56,42,495,190,551,232
154784,30111_20190805171220.jpg,イオン稲毛,*522,千葉,333,ち,2019/8/5 17:11,2-1_all_corrected,57,44,206,141,263,185
155430,30078_20190805212331.jpg,イオンスタイル仙台卸町店,7162,仙台,580,ぬ,2019/8/5 21:23,2-1_all_corrected,89,65,336,305,425,370
155259,30078_20190805201326.jpg,イオンスタイル仙台卸町店,***1,仙台,511,ち,2019/8/5 20:13,2-1_all_corrected,78,59,285,216,363,275
154181,30130_20190805123551.jpg,クロスガーデン多摩（RF）,6865,札幌,580,そ,2019/8/5 12:35,2-1_all_corrected,46,36,393,202,439,238
155098,30072_20190805190659.jpg,関西スーパー京阪大和田１F,8128,大阪,334,せ,2019/8/5 19:06,2-1_all_corrected,43,29,218,64,261,93
155401,30078_20190805211222.jpg,イオンスタイル仙台卸町店,*103,仙台,530,や,2019/8/5 21:12,2-1_all_corrected,53,38,236,0,289,38
154978,30078_20190805183029.jpg,イオンスタイル仙台卸町店,7140,仙台,580,ひ,2019/8/5 18:30,2-1_all_corrected,78,58,186,160,264,218
155325,30006_20190805203621.jpg,スギ薬局南千里,*121,大阪,351,む,2019/8/5 20:35,2-1_all_corrected,100,61,281,90,381,151
155119,30169_20190805191645.jpg,イオン相模原ショッピングセンター,**33,京都,589,て,2019/8/5 19:16,2-1_all_corrected,55,45,138,152,193,197
155126,30111_20190805192025.jpg,イオン稲毛,9828,千葉,300,せ,2019/8/5 19:19,2-1_all_corrected,84,55,498,395,582,450
155175,30078_20190805193943.jpg,イオンスタイル仙台卸町店,*601,仙台,530,ほ,2019/8/5 19:39,2-1_all_corrected,92,62,326,312,418,374
155181,30078_20190805194031.jpg,イオンスタイル仙台卸町店,4540,所沢,580,わ,2019/8/5 19:40,2-1_all_corrected,87,61,308,279,395,340
154633,30057_20190805161028.jpg,ライフ東府中,1178,多摩,580,め,2019/8/5 16:09,2-1_all_corrected,54,43,313,185,367,228
154065,30157_20190805114035.jpg,関西スーパー中央,*267,神戸,530,つ,2019/8/5 11:40,2-1_all_corrected,52,46,144,397,196,443
155385,30078_20190805210545.jpg,イオンスタイル仙台卸町店,8395,仙台,580,こ,2019/8/5 20:54,2-1_all_corrected,92,63,331,329,423,392
154634,30078_20190805161053.jpg,イオンスタイル仙台卸町店,*263,仙台,500,ろ,2019/8/5 16:10,2-1_all_corrected,58,41,304,140,362,181
155116,30110_20190805191533.jpg,イオン金沢八景,*612,つくば,333,ひ,2019/8/5 19:14,2-1_all_corrected,63,54,458,181,521,235
155111,30169_20190805191245.jpg,イオン相模原ショッピングセンター,*456,多摩,530,る,2019/8/5 19:12,2-1_all_corrected,51,39,383,151,434,190
155384,30078_20190805210540.jpg,イオンスタイル仙台卸町店,4705,仙台,580,に,2019/8/5 20:54,2-1_all_corrected,90,63,298,317,388,380
154269,30111_20190805131754.jpg,イオン稲毛,2899,千葉,580,ほ,2019/8/5 13:17,2-1_all_corrected,55,41,351,128,406,169
155180,30078_20190805194026.jpg,イオンスタイル仙台卸町店,5455,仙台,580,は,2019/8/5 19:40,2-1_all_corrected,82,61,266,174,348,235
155174,30078_20190805193929.jpg,イオンスタイル仙台卸町店,*725,仙台,501,て,2019/8/5 19:39,2-1_all_corrected,57,45,339,96,396,141
155379,30078_20190805210518.jpg,イオンスタイル仙台卸町店,9376,宮城,580,ま,2019/8/5 20:49,2-1_all_corrected,97,66,262,339,359,405
155187,30078_20190805194244.jpg,イオンスタイル仙台卸町店,1477,宮城,301,な,2019/8/5 19:42,2-1_all_corrected,79,59,368,224,447,283
154873,30111_20190805175104.jpg,イオン稲毛,1000,千葉,519,ら,2019/8/5 17:50,2-1_all_corrected,59,45,342,160,401,205
155390,30078_20190805210611.jpg,イオンスタイル仙台卸町店,2427,横浜,303,み,2019/8/5 21:00,2-1_all_corrected,69,60,182,84,251,144
155194,30078_20190805194501.jpg,イオンスタイル仙台卸町店,*121,仙台,300,も,2019/8/5 19:44,2-1_all_corrected,53,47,338,96,391,143
155167,30157_20190805193605.jpg,関西スーパー中央,8000,岡山,592,さ,2019/8/5 19:35,2-1_all_corrected,44,62,293,177,337,239
154686,30072_20190805163422.jpg,関西スーパー京阪大和田１F,*387,和泉,530,ひ,2019/8/5 16:33,2-1_all_corrected,51,37,349,58,400,95
154211,30045_20190805124928.jpg,マックスバリュー徳川明倫,*358,名古屋,32,と,2019/8/5 12:48,2-1_all_corrected,40,33,317,113,357,146
155502,30078_20190805224538.jpg,イオンスタイル仙台卸町店,7338,仙台,580,に,2019/8/5 22:45,2-1_all_corrected,99,70,236,332,335,402
155161,30169_20190805193405.jpg,イオン相模原ショッピングセンター,9693,多摩,71,ま,2019/8/5 19:33,2-1_all_corrected,59,33,388,80,447,113
155195,30078_20190805194505.jpg,イオンスタイル仙台卸町店,9857,仙台,500,ぬ,2019/8/5 19:44,2-1_all_corrected,88,60,358,261,446,321
155391,30078_20190805210615.jpg,イオンスタイル仙台卸町店,9358,仙台,300,は,2019/8/5 21:03,2-1_all_corrected,106,71,242,369,348,440
154680,30072_20190805163013.jpg,関西スーパー京阪大和田１F,2388,大阪,302,て,2019/8/5 16:29,2-1_all_corrected,57,43,390,81,447,124
155331,30078_20190805203754.jpg,イオンスタイル仙台卸町店,1310,仙台,583,さ,2019/8/5 20:37,2-1_all_corrected,81,58,309,262,390,320
155135,30110_20190805192340.jpg,イオン金沢八景,**68,横浜,304,み,2019/8/5 19:23,2-1_all_corrected,53,38,171,85,224,123
155307,30078_20190805202802.jpg,イオンスタイル仙台卸町店,7637,仙台,500,み,2019/8/5 20:27,2-1_all_corrected,83,56,294,201,377,257
155300,30078_20190805202355.jpg,イオンスタイル仙台卸町店,4869,宮城,581,け,2019/8/5 20:23,2-1_all_corrected,74,54,258,148,332,202
154965,30078_20190805182558.jpg,イオンスタイル仙台卸町店,1983,宮城,300,や,2019/8/5 18:25,2-1_all_corrected,94,65,142,319,236,384
155040,30072_20190805184815.jpg,関西スーパー京阪大和田１F,*806,なにわ,503,わ,2019/8/5 18:47,2-1_all_corrected,75,55,6,182,81,237
155286,30072_20190805202114.jpg,関西スーパー京阪大和田１F,3021,大阪,301,て,2019/8/5 20:20,2-1_all_corrected,52,42,190,67,242,109
154962,30169_20190805182435.jpg,イオン相模原ショッピングセンター,1101,相模,583,に,2019/8/5 18:23,2-1_all_corrected,87,73,79,271,166,344
154954,30078_20190805182254.jpg,イオンスタイル仙台卸町店,**23,仙台,583,る,2019/8/5 18:22,2-1_all_corrected,71,56,299,168,370,224
155210,30078_20190805195148.jpg,イオンスタイル仙台卸町店,7615,仙台,580,と,2019/8/5 19:51,2-1_all_corrected,54,39,246,37,300,76
154900,30085_20190805175856.jpg,業務スーパー南津守,***5,なにわ,30,と,2019/8/5 17:57,2-1_all_corrected,46,31,331,176,377,207
155228,30078_20190805200001.jpg,イオンスタイル仙台卸町店,2841,仙台,500,ち,2019/8/5 19:59,2-1_all_corrected,85,58,323,244,408,302
155483,30078_20190805220952.jpg,イオンスタイル仙台卸町店,4659,宮城,502,む,2019/8/5 22:09,2-1_all_corrected,96,62,305,327,401,389
155221,30078_20190805195616.jpg,イオンスタイル仙台卸町店,3139,仙台,300,も,2019/8/5 19:55,2-1_all_corrected,55,38,240,0,295,38
155219,30110_20190805195457.jpg,イオン金沢八景,7726,横浜,505,に,2019/8/5 19:54,2-1_all_corrected,66,64,42,294,108,358
153926,30072_20190805102530.jpg,関西スーパー京阪大和田１F,*929,大阪,532,と,2019/8/5 10:25,2-1_all_corrected,67,55,45,132,112,187
155048,30060_20190805184945.jpg,関西スーパー小野原,**33,大阪,484,こ,2019/8/5 18:49,2-1_all_corrected,54,42,222,275,276,317
155289,30078_20190805202147.jpg,イオンスタイル仙台卸町店,3429,仙台,501,す,2019/8/5 20:21,2-1_all_corrected,84,60,381,313,465,373
154700,30111_20190805164115.jpg,イオン稲毛,3421,千葉,530,と,2019/8/5 16:40,2-1_all_corrected,56,39,166,146,222,185
153973,30001_20190805105639.jpg,関西スーパー高石駅前,*324,和泉,586,さ,2019/8/5 10:56,2-1_all_corrected,88,65,299,207,387,272
154964,30111_20190805182516.jpg,イオン稲毛,8454,千葉,581,た,2019/8/5 18:24,2-1_all_corrected,73,55,313,182,386,237
153927,30001_20190805102613.jpg,関西スーパー高石駅前,3695,なにわ,501,め,2019/8/5 10:25,2-1_all_corrected,88,61,270,205,358,266
155220,30078_20190805195510.jpg,イオンスタイル仙台卸町店,1102,仙台,333,は,2019/8/5 19:54,2-1_all_corrected,72,53,259,85,331,138
154937,30169_20190805181616.jpg,イオン相模原ショッピングセンター,*456,多摩,530,る,2019/8/5 18:15,2-1_all_corrected,51,48,311,156,362,204
154592,30023_20190805155353.jpg,ピットデザイン山科東野,7777,京都,522,み,2019/8/5 15:53,2-1_all_corrected,89,68,287,112,376,180
154754,30060_20190805165839.jpg,関西スーパー小野原,5689,大阪,480,の,2019/8/5 16:57,2-1_all_corrected,82,67,333,372,415,439
154753,30110_20190805165810.jpg,イオン金沢八景,2002,横浜,377,さ,2019/8/5 16:57,2-1_all_corrected,54,43,360,92,414,135
155211,30078_20190805195207.jpg,イオンスタイル仙台卸町店,7615,仙台,580,と,2019/8/5 19:51,2-1_all_corrected,74,54,257,131,331,185
160374,30079_20190808193333.jpg,ピットデザイン仙台卸町駅前駐車場,3777,仙台,500,ゆ,2019/8/8 19:32,2-1_all_corrected,54,45,332,135,386,180
159695,30111_20190808135542.jpg,イオン稲毛,1441,千葉,330,ゆ,2019/8/8 13:55,2-1_all_corrected,68,55,226,169,294,224
160177,30045_20190808180712.jpg,マックスバリュー徳川明倫,**77,名古屋,31,ほ,2019/8/8 18:06,2-1_all_corrected,90,78,50,305,140,383
159603,30168_20190808124926.jpg,イオン東雲店（屋上）,7154,なにわ,400,ほ,2019/8/8 12:48,2-1_all_corrected,43,32,196,34,239,66
160316,30144_20190808191144.jpg,イオン幕張,*108,千葉,339,ひ,2019/8/8 19:11,2-1_all_corrected,73,49,284,214,357,263
160124,30144_20190808174509.jpg,イオン幕張,1124,千葉,315,た,2019/8/8 17:44,2-1_all_corrected,42,30,199,39,241,69
159256,30072_20190808084106.jpg,関西スーパー京阪大和田１F,2404,神戸,100,す,2019/8/8 8:40,2-1_all_corrected,63,60,68,192,131,252
159269,30111_20190808085623.jpg,イオン稲毛,1020,習志野,585,ち,2019/8/8 8:56,2-1_all_corrected,74,55,327,155,401,210
160549,30098_20190808205620.jpg,BRANCH仙台（東棟）,*211,仙台,333,ぬ,2019/8/8 20:55,2-1_all_corrected,102,72,193,301,295,373
159407,30063_20190808105021.jpg,コーナン相模原小山モール,**88,横浜,31,る,2019/8/8 10:49,2-1_all_corrected,73,58,98,206,171,264
160182,30144_20190808180829.jpg,イオン幕張,6055,千葉,330,は,2019/8/8 18:08,2-1_all_corrected,80,55,292,264,372,319
160176,30060_20190808180710.jpg,関西スーパー小野原,2645,神戸,503,み,2019/8/8 18:06,2-1_all_corrected,74,57,291,204,365,261
160512,30167_20190808203917.jpg,イオン東雲店,*673,春日部,880,り,2019/8/8 20:38,2-1_all_corrected,71,65,90,280,161,345
160321,30072_20190808191300.jpg,関西スーパー京阪大和田１F,***1,大阪,30,と,2019/8/8 19:12,2-1_all_corrected,51,35,398,236,449,271
160319,30167_20190808191253.jpg,イオン東雲店,7134,千葉,500,さ,2019/8/8 19:11,2-1_all_corrected,50,37,266,240,316,277
159257,30062_20190808084124.jpg,ミスミモール,*123,神戸,31,ぬ,2019/8/8 8:40,2-1_all_corrected,80,60,320,182,400,242
159295,30085_20190808091459.jpg,業務スーパー南津守,***1,なにわ,30,の,2019/8/8 9:14,2-1_all_corrected,40,33,223,168,263,201
160328,30111_20190808191535.jpg,イオン稲毛,*246,千葉,583,す,2019/8/8 19:15,2-1_all_corrected,56,41,154,173,210,214
160434,30169_20190808200428.jpg,イオン相模原ショッピングセンター,1212,湘南,353,と,2019/8/8 20:04,2-1_all_corrected,89,67,303,106,392,173
159783,30111_20190808150045.jpg,イオン稲毛,9074,千葉,302,と,2019/8/8 15:00,2-1_all_corrected,54,42,173,125,227,167
160092,30078_20190808173205.jpg,イオンスタイル仙台卸町店,3438,仙台,480,う,2019/8/8 17:31,2-1_all_corrected,75,56,313,210,388,266
160059,30144_20190808172312.jpg,イオン幕張,2017,宇都宮,580,ひ,2019/8/8 17:22,2-1_all_corrected,78,57,346,304,424,361
159779,30062_20190808145953.jpg,ミスミモール,*330,神戸,383,て,2019/8/8 14:59,2-1_all_corrected,45,33,480,102,525,135
160253,30110_20190808184250.jpg,イオン金沢八景,7420,横浜,301,ろ,2019/8/8 18:42,2-1_all_corrected,65,56,426,94,491,150
160451,30073_20190808201542.jpg,関西スーパー京阪大和田２F,*920,なにわ,338,ほ,2019/8/8 20:15,2-1_all_corrected,73,59,318,76,391,135
159349,30001_20190808100320.jpg,関西スーパー高石駅前,8890,和泉,502,つ,2019/8/8 10:03,2-1_all_corrected,76,52,352,123,428,175
159371,30144_20190808102510.jpg,イオン幕張,7275,千葉,302,せ,2019/8/8 10:24,2-1_all_corrected,54,40,160,115,214,155
160200,30144_20190808181437.jpg,イオン幕張,2305,千葉,502,ぬ,2019/8/8 18:14,2-1_all_corrected,77,50,253,220,330,270
159511,30060_20190808114213.jpg,関西スーパー小野原,7223,大阪,480,に,2019/8/8 11:41,2-1_all_corrected,68,63,319,288,387,351
159949,30078_20190808162120.jpg,イオンスタイル仙台卸町店,3180,宮城,581,あ,2019/8/8 16:20,2-1_all_corrected,91,60,188,302,279,362
159378,30110_20190808103204.jpg,イオン金沢八景,*701,横浜,349,ま,2019/8/8 10:31,2-1_all_corrected,74,60,316,153,390,213
160458,30167_20190808202027.jpg,イオン東雲店,9927,多摩,502,ゆ,2019/8/8 20:19,2-1_all_corrected,56,48,413,338,469,386
159971,30169_20190808163330.jpg,イオン相模原ショッピングセンター,1515,多摩,352,む,2019/8/8 16:32,2-1_all_corrected,82,64,301,247,383,311
159912,30167_20190808160533.jpg,イオン東雲店,1210,足立,533,ち,2019/8/8 16:03,2-1_all_corrected,51,41,276,152,327,193
160093,30072_20190808173322.jpg,関西スーパー京阪大和田１F,**73,大阪,586,つ,2019/8/8 17:32,2-1_all_corrected,71,55,145,118,216,173
159572,30111_20190808123007.jpg,イオン稲毛,2368,千葉,530,り,2019/8/8 12:29,2-1_all_corrected,68,53,328,155,396,208
160263,30060_20190808184723.jpg,関西スーパー小野原,**33,大阪,484,こ,2019/8/8 18:46,2-1_all_corrected,85,60,270,390,355,450
159749,30167_20190808143427.jpg,イオン東雲店,7411,足立,230,さ,2019/8/8 14:33,2-1_all_corrected,48,31,240,242,288,273
159312,30111_20190808093225.jpg,イオン稲毛,**78,千葉,344,そ,2019/8/8 9:31,2-1_all_corrected,68,62,516,283,584,345
160230,30144_20190808183158.jpg,イオン幕張,*930,千葉,535,ゆ,2019/8/8 18:31,2-1_all_corrected,68,55,115,162,183,217
159510,30078_20190808114156.jpg,イオンスタイル仙台卸町店,4787,仙台,501,ち,2019/8/8 11:41,2-1_all_corrected,70,37,314,249,384,286
160208,30144_20190808181651.jpg,イオン幕張,3223,春日部,301,み,2019/8/8 18:16,2-1_all_corrected,89,63,331,344,420,407
159722,30111_20190808141439.jpg,イオン稲毛,*123,千葉,348,る,2019/8/8 14:14,2-1_all_corrected,48,41,348,108,396,149
160237,30111_20190808183548.jpg,イオン稲毛,8008,千葉,352,ね,2019/8/8 18:35,2-1_all_corrected,52,41,141,104,193,145
160457,30063_20190808202006.jpg,コーナン相模原小山モール,*712,相模,532,ろ,2019/8/8 20:19,2-1_all_corrected,64,58,470,140,534,198
159383,30060_20190808103357.jpg,関西スーパー小野原,7372,なにわ,580,け,2019/8/8 10:33,2-1_all_corrected,69,59,384,201,453,260
159964,30169_20190808162942.jpg,イオン相模原ショッピングセンター,1264,土浦,100,い,2019/8/8 16:29,2-1_all_corrected,31,48,559,117,590,165
160486,30110_20190808203230.jpg,イオン金沢八景,*990,横浜,331,み,2019/8/8 20:32,2-1_all_corrected,47,41,312,122,359,163
159997,30110_20190808165022.jpg,イオン金沢八景,*181,横浜,333,ま,2019/8/8 16:49,2-1_all_corrected,73,65,191,211,264,276
159707,30111_20190808140450.jpg,イオン稲毛,6171,千葉,580,よ,2019/8/8 14:04,2-1_all_corrected,41,33,39,85,80,118
160649,30111_20190808221542.jpg,イオン稲毛,7662,千葉,530,の,2019/8/8 22:15,2-1_all_corrected,51,40,133,106,184,146
159363,30139_20190808101802.jpg,イオン板橋ショッピングセンター,*906,練馬,34,と,2019/8/8 10:17,2-1_all_corrected,53,44,197,181,250,225
160080,30090_20190808172854.jpg,イトーヨーカドー木場 西棟,7227,足立,332,つ,2019/8/8 17:28,2-1_all_corrected,74,51,236,233,310,284
159798,30144_20190808150729.jpg,イオン幕張,8208,袖ヶ浦,300,も,2019/8/8 15:07,2-1_all_corrected,88,60,322,390,410,450
159330,30167_20190808094322.jpg,イオン東雲店,8765,宇都宮,330,ろ,2019/8/8 9:42,2-1_all_corrected,51,42,336,263,387,305
160087,30111_20190808173041.jpg,イオン稲毛,*115,千葉,549,た,2019/8/8 17:30,2-1_all_corrected,57,42,358,145,415,187
160241,30167_20190808183727.jpg,イオン東雲店,8008,足立,547,そ,2019/8/8 18:36,2-1_all_corrected,50,40,358,244,408,284
159550,30006_20190808121201.jpg,スギ薬局南千里,***5,大阪,30,つ,2019/8/8 12:11,2-1_all_corrected,85,50,367,23,452,73
159301,30139_20190808092042.jpg,イオン板橋ショッピングセンター,2254,品川,35,す,2019/8/8 9:20,2-1_all_corrected,56,39,232,164,288,203
160213,30144_20190808181901.jpg,イオン幕張,*135,習志野,333,む,2019/8/8 18:18,2-1_all_corrected,81,56,307,273,388,329
159362,30072_20190808101510.jpg,関西スーパー京阪大和田１F,*563,京都,800,せ,2019/8/8 10:13,2-1_all_corrected,97,74,69,339,166,413
160026,30111_20190808170655.jpg,イオン稲毛,2612,千葉,332,ほ,2019/8/8 17:06,2-1_all_corrected,59,42,359,138,418,180
159996,30144_20190808164914.jpg,イオン幕張,4236,世田谷,500,す,2019/8/8 16:48,2-1_all_corrected,56,43,265,159,321,202
159737,30144_20190808142246.jpg,イオン幕張,9968,千葉,581,く,2019/8/8 14:22,2-1_all_corrected,59,42,179,154,238,196
159965,30144_20190808163138.jpg,イオン幕張,9522,横浜,304,む,2019/8/8 16:31,2-1_all_corrected,76,49,230,218,306,267
160028,30001_20190808170752.jpg,関西スーパー高石駅前,5626,和泉,502,つ,2019/8/8 17:07,2-1_all_corrected,62,44,456,58,518,102
159502,30111_20190808113851.jpg,イオン稲毛,9616,千葉,500,た,2019/8/8 11:38,2-1_all_corrected,45,35,77,82,122,117
160088,30060_20190808173041.jpg,関西スーパー小野原,3406,大阪,480,な,2019/8/8 17:30,2-1_all_corrected,90,68,343,382,433,450
160285,30060_20190808185859.jpg,関西スーパー小野原,*168,大阪,586,ひ,2019/8/8 18:58,2-1_all_corrected,42,34,65,205,107,239
160416,30169_20190808195505.jpg,イオン相模原ショッピングセンター,8322,相模,330,な,2019/8/8 19:54,2-1_all_corrected,65,58,77,306,142,364
160086,30167_20190808173040.jpg,イオン東雲店,**21,大宮,431,て,2019/8/8 17:30,2-1_all_corrected,68,58,179,244,247,302
159799,30144_20190808150749.jpg,イオン幕張,2300,千葉,334,せ,2019/8/8 15:07,2-1_all_corrected,57,46,298,191,355,237
159627,30038_20190808130703.jpg,ザ・ダイソー東大和,*612,多摩,584,ま,2019/8/8 13:06,2-1_all_corrected,50,42,438,164,488,206
160136,30091_20190808175100.jpg,イトーヨーカドー木場 立体,9999,足立,348,と,2019/8/8 17:50,2-1_all_corrected,57,43,305,162,362,205
159629,30144_20190808130748.jpg,イオン幕張,7236,習志野,330,り,2019/8/8 13:07,2-1_all_corrected,71,53,141,189,212,242
160303,30110_20190808190543.jpg,イオン金沢八景,*612,つくば,333,ひ,2019/8/8 19:05,2-1_all_corrected,65,62,518,235,583,297
160131,30076_20190808174936.jpg,ヤマダ電機なんば,***5,なにわ,385,の,2019/8/8 17:49,2-1_all_corrected,82,54,322,207,404,261
160165,30144_20190808180353.jpg,イオン幕張,1118,習志野,549,む,2019/8/8 18:03,2-1_all_corrected,62,42,216,198,278,240
160162,30072_20190808180132.jpg,関西スーパー京阪大和田１F,1117,大阪,590,あ,2019/8/8 18:01,2-1_all_corrected,45,29,159,24,204,53
159273,30072_20190808085958.jpg,関西スーパー京阪大和田１F,*762,京都,800,せ,2019/8/8 8:59,2-1_all_corrected,65,59,399,184,464,243
159274,30072_20190808090043.jpg,関西スーパー京阪大和田１F,*762,京都,800,せ,2019/8/8 9:00,2-1_all_corrected,47,39,224,127,271,166
160108,30169_20190808173719.jpg,イオン相模原ショッピングセンター,8424,相模,301,て,2019/8/8 17:36,2-1_all_corrected,55,39,127,82,182,121
159610,30144_20190808125624.jpg,イオン幕張,1223,袖ヶ浦,585,の,2019/8/8 12:55,2-1_all_corrected,82,58,276,331,358,389
159873,30144_20190808154732.jpg,イオン幕張,6129,長野,300,は,2019/8/8 15:47,2-1_all_corrected,93,65,384,360,477,425
159887,30169_20190808155349.jpg,イオン相模原ショッピングセンター,8424,相模,301,て,2019/8/8 15:53,2-1_all_corrected,76,54,252,116,328,170
159414,30111_20190808105301.jpg,イオン稲毛,1010,千葉,557,ま,2019/8/8 10:52,2-1_all_corrected,70,57,234,190,304,247
160509,30079_20190808203808.jpg,ピットデザイン仙台卸町駅前駐車場,8686,仙台,300,め,2019/8/8 20:37,2-1_all_corrected,70,60,246,252,316,312
159447,30079_20190808111246.jpg,ピットデザイン仙台卸町駅前駐車場,9100,仙台,580,う,2019/8/8 11:12,2-1_all_corrected,44,29,344,62,388,91
159818,30072_20190808151432.jpg,関西スーパー京阪大和田１F,3507,大阪,480,と,2019/8/8 15:14,2-1_all_corrected,71,57,154,175,225,232
160155,30144_20190808175932.jpg,イオン幕張,1212,千葉,367,た,2019/8/8 17:59,2-1_all_corrected,58,41,229,161,287,202
160538,30111_20190808205021.jpg,イオン稲毛,3003,千葉,346,ひ,2019/8/8 20:49,2-1_all_corrected,66,57,307,180,373,237
160197,30167_20190808181409.jpg,イオン東雲店,*673,春日部,880,り,2019/8/8 18:13,2-1_all_corrected,71,64,170,246,241,310
159829,30167_20190808152204.jpg,イオン東雲店,8888,足立,383,め,2019/8/8 15:21,2-1_all_corrected,45,35,269,213,314,248
159255,30073_20190808084043.jpg,関西スーパー京阪大和田２F,2404,神戸,100,す,2019/8/8 8:40,2-1_all_corrected,82,69,476,290,558,359
160324,30157_20190808191317.jpg,関西スーパー中央,**77,神戸,31,の,2019/8/8 19:12,2-1_all_corrected,71,57,250,392,321,449
159468,30144_20190808112142.jpg,イオン幕張,1102,千葉,585,せ,2019/8/8 11:21,2-1_all_corrected,45,38,136,144,181,182
160370,30167_20190808193156.jpg,イオン東雲店,1434,足立,530,あ,2019/8/8 19:31,2-1_all_corrected,53,47,246,116,299,163
160384,30111_20190808193932.jpg,イオン稲毛,7070,千葉,538,つ,2019/8/8 19:39,2-1_all_corrected,41,31,448,49,489,80
159665,30169_20190808133325.jpg,イオン相模原ショッピングセンター,**87,相模,535,り,2019/8/8 13:33,2-1_all_corrected,75,61,258,199,333,260
160189,30144_20190808181241.jpg,イオン幕張,1975,千葉,583,え,2019/8/8 18:12,2-1_all_corrected,71,49,282,217,353,266
160145,30078_20190808175625.jpg,イオンスタイル仙台卸町店,3316,仙台,500,く,2019/8/8 17:56,2-1_all_corrected,79,61,148,173,227,234
159837,30144_20190808152721.jpg,イオン幕張,6202,習志野,330,た,2019/8/8 15:26,2-1_all_corrected,57,41,181,175,238,216
160187,30144_20190808181016.jpg,イオン幕張,*784,品川,330,ち,2019/8/8 18:09,2-1_all_corrected,70,49,306,219,376,268
160173,30144_20190808180606.jpg,イオン幕張,*323,千葉,587,て,2019/8/8 18:05,2-1_all_corrected,90,63,220,337,310,400
160528,30100_20190808204631.jpg,JBM長崎三芳町,5445,長崎,581,え,2019/8/8 20:45,2-1_all_corrected,50,36,231,251,281,287
160379,30072_20190808193825.jpg,関西スーパー京阪大和田１F,***1,大阪,30,と,2019/8/8 19:38,2-1_all_corrected,47,33,159,131,206,164
160126,30144_20190808174624.jpg,イオン幕張,8259,千葉,502,む,2019/8/8 17:45,2-1_all_corrected,71,51,154,188,225,239
160181,30014_20190808180814.jpg,フォルテ蘇我ベルク棟,***5,千葉,30,る,2019/8/8 18:07,2-1_all_corrected,66,67,17,125,83,192
160511,30111_20190808203900.jpg,イオン稲毛,*340,千葉,331,ね,2019/8/8 20:38,2-1_all_corrected,51,40,134,120,185,160
160378,30111_20190808193817.jpg,イオン稲毛,1020,千葉,588,も,2019/8/8 19:37,2-1_all_corrected,55,44,164,161,219,205
160186,30111_20190808181002.jpg,イオン稲毛,4445,千葉,502,ら,2019/8/8 18:09,2-1_all_corrected,70,51,348,147,418,198
159663,30111_20190808133224.jpg,イオン稲毛,2171,千葉,503,す,2019/8/8 13:31,2-1_all_corrected,42,35,63,82,105,117
160349,30072_20190808192253.jpg,関西スーパー京阪大和田１F,**11,大阪,280,つ,2019/8/8 19:22,2-1_all_corrected,44,33,369,14,413,47
159451,30001_20190808111428.jpg,関西スーパー高石駅前,*403,和泉,330,ろ,2019/8/8 11:14,2-1_all_corrected,82,60,262,151,344,211
159831,30078_20190808152434.jpg,イオンスタイル仙台卸町店,7183,会津,583,い,2019/8/8 15:24,2-1_all_corrected,86,58,251,268,337,326
159372,30022_20190808102735.jpg,業務スーパー平野駅前,**88,なにわ,31,ぬ,2019/8/8 10:27,2-1_all_corrected,77,67,23,87,100,154
159988,30111_20190808164540.jpg,イオン稲毛,3605,袖ヶ浦,100,さ,2019/8/8 16:45,2-1_all_corrected,53,42,249,143,302,185
159729,30169_20190808141834.jpg,イオン相模原ショッピングセンター,2934,相模,480,こ,2019/8/8 14:18,2-1_all_corrected,85,69,144,210,229,279
159381,30001_20190808103214.jpg,関西スーパー高石駅前,4251,和泉,501,さ,2019/8/8 10:31,2-1_all_corrected,83,60,300,221,383,281
159972,30052_20190808163413.jpg,西友市ヶ尾,***3,横浜,30,む,2019/8/8 16:33,2-1_all_corrected,78,58,211,277,289,335
160007,30066_20190808165538.jpg,ジョーシン和泉中央,***5,和泉,30,そ,2019/8/8 16:55,2-1_all_corrected,52,43,272,178,324,221
159921,30070_20190808160953.jpg,カナートモール住道第一,8000,大阪,30,ろ,2019/8/8 16:09,2-1_all_corrected,84,64,445,251,529,315
159780,30111_20190808150005.jpg,イオン稲毛,1870,千葉,580,ぬ,2019/8/8 14:59,2-1_all_corrected,70,54,141,166,211,220
160292,30045_20190808190152.jpg,マックスバリュー徳川明倫,*358,名古屋,32,ひ,2019/8/8 19:01,2-1_all_corrected,51,44,396,144,447,188
160266,30091_20190808184855.jpg,イトーヨーカドー木場 立体,**11,足立,394,や,2019/8/8 18:48,2-1_all_corrected,51,43,177,170,228,213
160096,30111_20190808173447.jpg,イオン稲毛,1026,千葉,584,ふ,2019/8/8 17:34,2-1_all_corrected,58,41,350,129,408,170
160062,30169_20190808172332.jpg,イオン相模原ショッピングセンター,9281,相模,301,ひ,2019/8/8 17:23,2-1_all_corrected,69,56,182,102,251,158
159548,30144_20190808121119.jpg,イオン幕張,2666,千葉,302,つ,2019/8/8 12:10,2-1_all_corrected,71,53,201,172,272,225
159745,30006_20190808143226.jpg,スギ薬局南千里,*919,大阪,502,ら,2019/8/8 14:32,2-1_all_corrected,115,72,213,60,328,132
160065,30072_20190808172447.jpg,関西スーパー京阪大和田１F,4486,大阪,580,ひ,2019/8/8 17:24,2-1_all_corrected,76,55,236,225,312,280
160257,30169_20190808184538.jpg,イオン相模原ショッピングセンター,*956,多摩,301,な,2019/8/8 18:45,2-1_all_corrected,83,80,479,319,562,399
160401,30078_20190808194654.jpg,イオンスタイル仙台卸町店,1001,仙台,348,ち,2019/8/8 19:46,2-1_all_corrected,77,61,398,277,475,338
159917,30167_20190808160754.jpg,イオン東雲店,3511,多摩,480,そ,2019/8/8 16:06,2-1_all_corrected,70,57,260,187,330,244
160091,30144_20190808173200.jpg,イオン幕張,6836,千葉,480,り,2019/8/8 17:31,2-1_all_corrected,69,53,423,259,492,312
159742,30144_20190808142803.jpg,イオン幕張,***7,野田,586,を,2019/8/8 14:27,2-1_all_corrected,43,31,176,102,219,133
159513,30111_20190808114306.jpg,イオン稲毛,8671,水戸,502,に,2019/8/8 11:42,2-1_all_corrected,53,74,483,376,536,450
159980,30072_20190808164045.jpg,関西スーパー京阪大和田１F,*810,大阪,544,ら,2019/8/8 16:40,2-1_all_corrected,69,53,85,135,154,188
159974,30110_20190808163552.jpg,イオン金沢八景,*847,横浜,334,す,2019/8/8 16:35,2-1_all_corrected,67,65,1,213,68,278
160006,30137_20190808165535.jpg,イオンスタイル品川シーサイド,1011,品川,362,の,2019/8/8 16:54,2-1_all_corrected,58,42,327,41,385,83
159726,30111_20190808141633.jpg,イオン稲毛,5290,千葉,502,ゆ,2019/8/8 14:16,2-1_all_corrected,58,42,392,117,450,159
159380,30156_20190808103208.jpg,万代 西神中央店,1839,滋賀,501,つ,2019/8/8 10:31,2-1_all_corrected,54,41,289,230,343,271
160037,30078_20190808171300.jpg,イオンスタイル仙台卸町店,1002,仙台,583,を,2019/8/8 17:12,2-1_all_corrected,96,65,224,350,320,415
159717,30072_20190808141106.jpg,関西スーパー京阪大和田１F,*808,大阪,543,ぬ,2019/8/8 14:10,2-1_all_corrected,74,59,207,262,281,321
159916,30167_20190808160714.jpg,イオン東雲店,3511,多摩,480,そ,2019/8/8 16:06,2-1_all_corrected,52,44,225,100,277,144
159744,30144_20190808143029.jpg,イオン幕張,1005,柏,583,ふ,2019/8/8 14:30,2-1_all_corrected,84,59,319,320,403,379
159775,30144_20190808145741.jpg,イオン幕張,8615,千葉,502,て,2019/8/8 14:57,2-1_all_corrected,43,38,199,173,242,211
159757,30111_20190808144337.jpg,イオン稲毛,1471,千葉,583,う,2019/8/8 14:43,2-1_all_corrected,43,33,414,60,457,93
160242,30078_20190808183743.jpg,イオンスタイル仙台卸町店,9999,仙台,335,ゆ,2019/8/8 18:37,2-1_all_corrected,66,54,387,158,453,212
159562,30169_20190808122413.jpg,イオン相模原ショッピングセンター,3047,多摩,583,か,2019/8/8 12:23,2-1_all_corrected,52,41,68,92,120,133
159792,30078_20190808150509.jpg,イオンスタイル仙台卸町店,1921,仙台,500,た,2019/8/8 15:04,2-1_all_corrected,69,56,359,159,428,215
159933,30060_20190808161526.jpg,関西スーパー小野原,8832,大阪,503,ほ,2019/8/8 16:15,2-1_all_corrected,83,71,422,309,505,380
159553,30063_20190808121508.jpg,コーナン相模原小山モール,***7,横浜,30,は,2019/8/8 12:14,2-1_all_corrected,77,64,186,175,263,239
160274,30144_20190808185145.jpg,イオン幕張,1979,千葉,331,ほ,2019/8/8 18:51,2-1_all_corrected,51,36,146,123,197,159
160482,30144_20190808202939.jpg,イオン幕張,3126,練馬,502,さ,2019/8/8 20:29,2-1_all_corrected,79,59,340,280,419,339
159967,30110_20190808163204.jpg,イオン金沢八景,**55,横浜,31,や,2019/8/8 16:31,2-1_all_corrected,72,67,14,292,86,359
159993,30111_20190808164837.jpg,イオン稲毛,5537,野田,501,な,2019/8/8 16:48,2-1_all_corrected,52,43,212,140,264,183
160218,30144_20190808182126.jpg,イオン幕張,1212,千葉,373,と,2019/8/8 18:20,2-1_all_corrected,79,54,278,280,357,334
160023,30144_20190808170420.jpg,イオン幕張,*999,千葉,541,ち,2019/8/8 17:04,2-1_all_corrected,55,36,161,112,216,148
159956,30111_20190808162604.jpg,イオン稲毛,3021,千葉,531,ね,2019/8/8 16:25,2-1_all_corrected,74,51,330,158,404,209
160229,30072_20190808183056.jpg,関西スーパー京阪大和田１F,8739,大阪,586,め,2019/8/8 18:30,2-1_all_corrected,42,33,211,78,253,111
159552,30111_20190808121408.jpg,イオン稲毛,8955,千葉,502,め,2019/8/8 12:13,2-1_all_corrected,73,64,360,243,433,307
160611,30169_20190808213533.jpg,イオン相模原ショッピングセンター,8888,相模,342,ひ,2019/8/8 21:35,2-1_all_corrected,89,68,221,70,310,138
159599,30078_20190808124513.jpg,イオンスタイル仙台卸町店,1355,仙台,330,つ,2019/8/8 12:44,2-1_all_corrected,73,57,359,188,432,245
159793,30111_20190808150513.jpg,イオン稲毛,2612,千葉,531,な,2019/8/8 15:04,2-1_all_corrected,55,44,367,137,422,181
160272,30072_20190808185120.jpg,関西スーパー京阪大和田１F,2495,大阪,503,や,2019/8/8 18:50,2-1_all_corrected,86,71,178,286,264,357
160616,30144_20190808214233.jpg,イオン幕張,1000,千葉,384,や,2019/8/8 21:42,2-1_all_corrected,79,59,302,327,381,386
159597,30091_20190808124305.jpg,イトーヨーカドー木場 立体,7284,品川,330,ち,2019/8/8 12:42,2-1_all_corrected,66,55,341,155,407,210
159904,30103_20190808160138.jpg,八尾老原１丁目,1001,大阪,31,つ,2019/8/8 16:01,2-1_all_corrected,82,61,244,165,326,226
160244,30072_20190808183826.jpg,関西スーパー京阪大和田１F,2629,大阪,500,り,2019/8/8 18:37,2-1_all_corrected,68,54,158,205,226,259
159332,30167_20190808094555.jpg,イオン東雲店,*980,習志野,330,た,2019/8/8 9:45,2-1_all_corrected,54,42,316,267,370,309
160243,30169_20190808183824.jpg,イオン相模原ショッピングセンター,*111,相模,580,さ,2019/8/8 18:37,2-1_all_corrected,84,66,213,161,297,227
160085,30168_20190808173016.jpg,イオン東雲店（屋上）,**21,大宮,494,て,2019/8/8 17:29,2-1_all_corrected,56,37,266,163,322,200
159957,30144_20190808162702.jpg,イオン幕張,7485,習志野,301,な,2019/8/8 16:26,2-1_all_corrected,54,38,156,89,210,127
159705,30111_20190808140409.jpg,イオン稲毛,***3,千葉,537,ま,2019/8/8 14:03,2-1_all_corrected,70,54,351,233,421,287
159361,30072_20190808101458.jpg,関西スーパー京阪大和田１F,*563,京都,800,せ,2019/8/8 10:13,2-1_all_corrected,69,58,0,216,69,274
159966,30144_20190808163148.jpg,イオン幕張,4304,千葉,502,ち,2019/8/8 16:31,2-1_all_corrected,85,50,323,297,408,347
159368,30072_20190808102139.jpg,関西スーパー京阪大和田１F,1220,大阪,341,ひ,2019/8/8 10:20,2-1_all_corrected,106,84,424,302,530,386
159995,30167_20190808164914.jpg,イオン東雲店,7411,足立,230,さ,2019/8/8 16:48,2-1_all_corrected,56,46,403,362,459,408
159487,30106_20190808113045.jpg,ジョーシン東大阪長田,8008,京都,31,ふ,2019/8/8 11:30,2-1_all_corrected,76,52,234,302,310,354
160166,30144_20190808180411.jpg,イオン幕張,8080,千葉,342,ひ,2019/8/8 18:03,2-1_all_corrected,48,61,3,250,51,311
160192,30167_20190808181334.jpg,イオン東雲店,*673,春日部,880,り,2019/8/8 18:12,2-1_all_corrected,38,32,33,39,71,71
159445,30110_20190808111106.jpg,イオン金沢八景,*868,横浜,530,の,2019/8/8 11:10,2-1_all_corrected,89,77,22,373,111,450
159683,30078_20190808134151.jpg,イオンスタイル仙台卸町店,3740,仙台,580,ひ,2019/8/8 13:41,2-1_all_corrected,57,45,296,97,353,142
160150,30001_20190808175756.jpg,関西スーパー高石駅前,1122,和泉,785,そ,2019/8/8 17:57,2-1_all_corrected,74,53,282,155,356,208
159684,30045_20190808134323.jpg,マックスバリュー徳川明倫,**33,名古屋,31,み,2019/8/8 13:42,2-1_all_corrected,46,41,126,174,172,215
159871,30111_20190808154628.jpg,イオン稲毛,*303,千葉,338,ゆ,2019/8/8 15:46,2-1_all_corrected,57,45,172,141,229,186
160309,30144_20190808190942.jpg,イオン幕張,***3,千葉,374,そ,2019/8/8 19:09,2-1_all_corrected,58,37,243,151,301,188
160135,30144_20190808175046.jpg,イオン幕張,7000,千葉,326,は,2019/8/8 17:50,2-1_all_corrected,57,43,209,133,266,176
159682,30045_20190808134026.jpg,マックスバリュー徳川明倫,***3,名古屋,30,は,2019/8/8 13:40,2-1_all_corrected,71,57,150,215,221,272
160151,30144_20190808175801.jpg,イオン幕張,1122,袖ヶ浦,342,る,2019/8/8 17:57,2-1_all_corrected,64,40,208,176,272,216
159640,30111_20190808131837.jpg,イオン稲毛,*334,千葉,503,と,2019/8/8 13:18,2-1_all_corrected,46,37,75,90,121,127
159815,30072_20190808151257.jpg,関西スーパー京阪大和田１F,*577,大阪,581,さ,2019/8/8 15:12,2-1_all_corrected,54,42,402,194,456,236
159678,30103_20190808133648.jpg,八尾老原１丁目,**33,大阪,31,り,2019/8/8 13:36,2-1_all_corrected,86,61,308,278,394,339
160306,30157_20190808190731.jpg,関西スーパー中央,**77,神戸,31,の,2019/8/8 19:07,2-1_all_corrected,66,58,444,253,510,311
160339,30072_20190808191927.jpg,関西スーパー京阪大和田１F,4889,大阪,302,み,2019/8/8 19:19,2-1_all_corrected,70,53,170,145,240,198
160301,30144_20190808190525.jpg,イオン幕張,8316,習志野,330,に,2019/8/8 19:05,2-1_all_corrected,82,54,210,276,292,330
159877,30167_20190808154921.jpg,イオン東雲店,7411,足立,230,さ,2019/8/8 15:48,2-1_all_corrected,46,33,273,244,319,277
160330,30111_20190808191611.jpg,イオン稲毛,1831,大宮,330,ち,2019/8/8 19:15,2-1_all_corrected,58,45,199,108,257,153
162047,30045_20190809185741.jpg,マックスバリュー徳川明倫,**22,名古屋,31,ろ,2019/8/9 18:57,2-1_all_corrected,72,65,91,251,163,316
161863,30045_20190809174703.jpg,マックスバリュー徳川明倫,1001,名古屋,31,ひ,2019/8/9 17:46,2-1_all_corrected,78,64,50,247,128,311
162078,30157_20190809191430.jpg,関西スーパー中央,**77,神戸,31,の,2019/8/9 19:14,2-1_all_corrected,49,50,403,221,452,271
161897,30169_20190809175704.jpg,イオン相模原ショッピングセンター,9693,多摩,71,ま,2019/8/9 17:56,2-1_all_corrected,61,38,415,83,476,121
161255,30167_20190809125158.jpg,イオン東雲店,7411,足立,230,さ,2019/8/9 12:51,2-1_all_corrected,69,53,378,373,447,426
161631,30078_20190809160412.jpg,イオンスタイル仙台卸町店,8065,三河,502,む,2019/8/9 16:03,2-1_all_corrected,74,54,312,148,386,202
161890,30086_20190809175423.jpg,テックランド大阪りんくう,***3,和泉,30,と,2019/8/9 17:53,2-1_all_corrected,54,38,256,209,310,247
161864,30157_20190809174711.jpg,関西スーパー中央,1371,神戸,530,ひ,2019/8/9 17:46,2-1_all_corrected,69,51,237,341,306,392
161801,30072_20190809172207.jpg,関西スーパー京阪大和田１F,3558,京都,502,ね,2019/8/9 17:21,2-1_all_corrected,69,55,291,116,360,171
161230,30167_20190809123703.jpg,イオン東雲店,4704,足立,481,り,2019/8/9 12:36,2-1_all_corrected,67,60,195,235,262,295
161466,30167_20190809144422.jpg,イオン東雲店,7411,足立,230,さ,2019/8/9 14:43,2-1_all_corrected,52,37,295,272,347,309
162022,30072_20190809184650.jpg,関西スーパー京阪大和田１F,2814,大阪,500,い,2019/8/9 18:46,2-1_all_corrected,51,39,134,57,185,96
161005,30072_20190809101416.jpg,関西スーパー京阪大和田１F,2375,大阪,581,ね,2019/8/9 10:12,2-1_all_corrected,83,72,0,369,83,441
161468,30068_20190809144445.jpg,ケーヨーデイツー唐木田,***5,多摩,30,ゆ,2019/8/9 14:43,2-1_all_corrected,50,38,365,162,415,200
161662,30078_20190809162330.jpg,イオンスタイル仙台卸町店,6315,仙台,580,つ,2019/8/9 16:23,2-1_all_corrected,93,61,203,335,296,396
161696,30111_20190809164608.jpg,イオン稲毛,*614,千葉,336,や,2019/8/9 16:45,2-1_all_corrected,69,56,236,164,305,220
162070,30086_20190809190928.jpg,テックランド大阪りんくう,***8,和泉,30,み,2019/8/9 19:09,2-1_all_corrected,49,39,161,122,210,161
161291,30111_20190809131059.jpg,イオン稲毛,*114,多摩,501,む,2019/8/9 13:10,2-1_all_corrected,70,55,321,146,391,201
162289,30144_20190809205659.jpg,イオン幕張,**74,足立,302,ひ,2019/8/9 20:56,2-1_all_corrected,72,53,213,189,285,242
161854,30144_20190809174324.jpg,イオン幕張,5800,千葉,331,ま,2019/8/9 17:42,2-1_all_corrected,54,37,198,133,252,170
162083,30006_20190809191622.jpg,スギ薬局南千里,*523,大阪,335,ら,2019/8/9 19:16,2-1_all_corrected,95,73,81,110,176,183
161434,30144_20190809142621.jpg,イオン幕張,**57,千葉,330,と,2019/8/9 14:25,2-1_all_corrected,46,33,186,77,232,110
161066,30103_20190809105343.jpg,八尾老原１丁目,**55,大阪,31,も,2019/8/9 10:53,2-1_all_corrected,54,41,309,103,363,144
161891,30072_20190809175531.jpg,関西スーパー京阪大和田１F,*128,大阪,585,あ,2019/8/9 17:55,2-1_all_corrected,48,36,97,36,145,72
161004,30072_20190809101401.jpg,関西スーパー京阪大和田１F,1300,大阪,532,も,2019/8/9 10:13,2-1_all_corrected,40,29,179,10,219,39
161655,30169_20190809161853.jpg,イオン相模原ショッピングセンター,8424,相模,301,て,2019/8/9 16:18,2-1_all_corrected,55,36,131,87,186,123
161185,30001_20190809120312.jpg,関西スーパー高石駅前,4123,和泉,500,め,2019/8/9 12:02,2-1_all_corrected,55,42,397,34,452,76
161975,30111_20190809182607.jpg,イオン稲毛,1025,千葉,588,る,2019/8/9 18:25,2-1_all_corrected,71,60,266,203,337,263
160896,30167_20190809085550.jpg,イオン東雲店,7411,足立,230,さ,2019/8/9 8:55,2-1_all_corrected,69,58,368,361,437,419
161570,30078_20190809153616.jpg,イオンスタイル仙台卸町店,8122,宮城,100,た,2019/8/9 15:35,2-1_all_corrected,75,51,417,286,492,337
161928,30144_20190809181225.jpg,イオン幕張,*225,習志野,333,の,2019/8/9 18:12,2-1_all_corrected,87,60,290,317,377,377
161114,30062_20190809111947.jpg,ミスミモール,**18,神戸,31,ふ,2019/8/9 11:19,2-1_all_corrected,75,64,164,225,239,289
162308,30060_20190809210922.jpg,関西スーパー小野原,*435,大阪,480,た,2019/8/9 21:09,2-1_all_corrected,79,60,243,329,322,389
161921,30091_20190809180833.jpg,イトーヨーカドー木場 立体,*626,神戸,338,ろ,2019/8/9 18:08,2-1_all_corrected,53,41,263,59,316,100
161942,30111_20190809181805.jpg,イオン稲毛,1001,千葉,567,ま,2019/8/9 18:17,2-1_all_corrected,56,45,206,132,262,177
161177,30060_20190809120007.jpg,関西スーパー小野原,1001,大阪,31,と,2019/8/9 11:59,2-1_all_corrected,71,52,491,151,562,203
162300,30169_20190809210440.jpg,イオン相模原ショッピングセンター,**97,多摩,302,ま,2019/8/9 21:04,2-1_all_corrected,59,43,383,43,442,86
161320,30144_20190809132347.jpg,イオン幕張,3618,足立,533,そ,2019/8/9 13:23,2-1_all_corrected,61,42,221,167,282,209
161302,30169_20190809131609.jpg,イオン相模原ショッピングセンター,1161,多摩,480,わ,2019/8/9 13:15,2-1_all_corrected,68,61,513,255,581,316
162128,30079_20190809192639.jpg,ピットデザイン仙台卸町駅前駐車場,*557,仙台,430,す,2019/8/9 19:25,2-1_all_corrected,61,44,333,137,394,181
161768,30072_20190809171205.jpg,関西スーパー京阪大和田１F,2199,大阪,581,ぬ,2019/8/9 17:11,2-1_all_corrected,66,63,0,203,66,266
161562,30078_20190809153118.jpg,イオンスタイル仙台卸町店,1151,仙台,330,む,2019/8/9 15:30,2-1_all_corrected,95,72,173,330,268,402
161509,30144_20190809150353.jpg,イオン幕張,**87,千葉,341,に,2019/8/9 15:03,2-1_all_corrected,56,39,199,149,255,188
160883,30072_20190809083521.jpg,関西スーパー京阪大和田１F,*762,京都,800,せ,2019/8/9 8:34,2-1_all_corrected,71,60,161,268,232,328
161969,30062_20190809182450.jpg,ミスミモール,***3,神戸,30,ほ,2019/8/9 18:24,2-1_all_corrected,75,59,185,141,260,200
161960,30111_20190809182256.jpg,イオン稲毛,6789,千葉,532,す,2019/8/9 18:22,2-1_all_corrected,68,59,268,184,336,243
161197,30060_20190809121334.jpg,関西スーパー小野原,1001,大阪,31,と,2019/8/9 12:13,2-1_all_corrected,71,62,488,270,559,332
161369,30078_20190809135053.jpg,イオンスタイル仙台卸町店,3034,宮城,580,せ,2019/8/9 13:50,2-1_all_corrected,81,51,251,228,332,279
161107,30101_20190809111359.jpg,にしてつストアレガネット姪浜,**55,福岡,31,ね,2019/8/9 11:13,2-1_all_corrected,80,59,100,330,180,389
162120,30072_20190809192503.jpg,関西スーパー京阪大和田１F,*398,大阪,580,て,2019/8/9 19:24,2-1_all_corrected,43,32,115,38,158,70
161136,30045_20190809113218.jpg,マックスバリュー徳川明倫,2525,名古屋,31,そ,2019/8/9 11:31,2-1_all_corrected,47,35,303,86,350,121
161368,30079_20190809135009.jpg,ピットデザイン仙台卸町駅前駐車場,6031,仙台,580,は,2019/8/9 13:49,2-1_all_corrected,44,34,387,54,431,88
161992,30078_20190809183040.jpg,イオンスタイル仙台卸町店,3825,仙台,580,て,2019/8/9 18:30,2-1_all_corrected,84,61,178,234,262,295
162142,30072_20190809193058.jpg,関西スーパー京阪大和田１F,*103,大阪,339,て,2019/8/9 19:30,2-1_all_corrected,69,53,179,120,248,173
161162,30111_20190809115001.jpg,イオン稲毛,5545,千葉,330,て,2019/8/9 11:49,2-1_all_corrected,56,45,187,118,243,163
161950,30111_20190809182128.jpg,イオン稲毛,*225,千葉,538,め,2019/8/9 18:21,2-1_all_corrected,67,56,250,156,317,212
161822,30091_20190809173322.jpg,イトーヨーカドー木場 立体,3968,足立,57,ろ,2019/8/9 17:32,2-1_all_corrected,73,56,307,155,380,211
161026,30060_20190809102858.jpg,関西スーパー小野原,3350,大阪,483,あ,2019/8/9 10:28,2-1_all_corrected,85,68,217,355,302,423
161684,30060_20190809163934.jpg,関西スーパー小野原,***2,大阪,588,ひ,2019/8/9 16:39,2-1_all_corrected,71,61,423,353,494,414
161825,30091_20190809173353.jpg,イトーヨーカドー木場 立体,5885,足立,331,さ,2019/8/9 17:33,2-1_all_corrected,92,67,419,286,511,353
161474,30168_20190809144944.jpg,イオン東雲店（屋上）,3198,足立,502,な,2019/8/9 14:49,2-1_all_corrected,49,37,201,96,250,133
161487,30009_20190809145236.jpg,西友新北習志野,***8,習志野,527,ね,2019/8/9 14:52,2-1_all_corrected,158,102,209,0,367,102
161814,30072_20190809172947.jpg,関西スーパー京阪大和田１F,1906,大阪,581,さ,2019/8/9 17:29,2-1_all_corrected,80,65,8,198,88,263
161088,30111_20190809110456.jpg,イオン稲毛,7033,福岡,302,た,2019/8/9 11:04,2-1_all_corrected,76,58,313,170,389,228
162256,30169_20190809203411.jpg,イオン相模原ショッピングセンター,**33,相模,366,は,2019/8/9 20:33,2-1_all_corrected,87,67,131,263,218,330
161271,30144_20190809125855.jpg,イオン幕張,3038,千葉,530,ふ,2019/8/9 12:58,2-1_all_corrected,56,40,138,137,194,177
162063,30113_20190809190357.jpg,ハローデイ新宮店第四,*100,福岡,352,る,2019/8/9 19:03,2-1_all_corrected,85,58,242,128,327,186
161072,30014_20190809105608.jpg,フォルテ蘇我ベルク棟,***3,千葉,30,な,2019/8/9 10:55,2-1_all_corrected,46,44,60,95,106,139
162055,30167_20190809185938.jpg,イオン東雲店,8008,足立,388,た,2019/8/9 18:58,2-1_all_corrected,73,58,381,383,454,441
161849,30006_20190809174211.jpg,スギ薬局南千里,**73,大阪,345,や,2019/8/9 17:42,2-1_all_corrected,119,75,159,85,278,160
161247,30078_20190809124612.jpg,イオンスタイル仙台卸町店,*703,宮城,584,ね,2019/8/9 12:45,2-1_all_corrected,85,62,162,281,247,343
161016,30090_20190809102527.jpg,イトーヨーカドー木場 西棟,5923,足立,530,い,2019/8/9 10:24,2-1_all_corrected,73,55,370,248,443,303
162204,30078_20190809195949.jpg,イオンスタイル仙台卸町店,*230,仙台,500,う,2019/8/9 19:59,2-1_all_corrected,85,67,162,239,247,306
162009,30062_20190809184154.jpg,ミスミモール,**55,和泉,31,ほ,2019/8/9 18:41,2-1_all_corrected,66,65,168,171,234,236
162000,30111_20190809183438.jpg,イオン稲毛,5983,成田,580,う,2019/8/9 18:34,2-1_all_corrected,69,60,246,197,315,257
161443,30068_20190809143436.jpg,ケーヨーデイツー唐木田,***3,多摩,30,の,2019/8/9 14:33,2-1_all_corrected,53,44,305,166,358,210
161671,30009_20190809163030.jpg,西友新北習志野,8711,習志野,530,の,2019/8/9 16:30,2-1_all_corrected,158,103,257,0,415,103
161676,30110_20190809163551.jpg,イオン金沢八景,*369,横浜,344,は,2019/8/9 16:35,2-1_all_corrected,67,71,4,330,71,401
161020,30072_20190809102701.jpg,関西スーパー京阪大和田１F,*563,京都,800,せ,2019/8/9 10:26,2-1_all_corrected,54,44,62,158,116,202
162007,30045_20190809184108.jpg,マックスバリュー徳川明倫,***5,名古屋,30,み,2019/8/9 18:40,2-1_all_corrected,51,40,212,138,263,178
161823,30169_20190809173324.jpg,イオン相模原ショッピングセンター,*810,相模,585,て,2019/8/9 17:33,2-1_all_corrected,53,42,122,118,175,160
161877,30144_20190809175046.jpg,イオン幕張,**11,千葉,568,の,2019/8/9 17:50,2-1_all_corrected,76,47,233,255,309,302
161410,30091_20190809140909.jpg,イトーヨーカドー木場 立体,6877,足立,530,せ,2019/8/9 14:08,2-1_all_corrected,80,59,275,234,355,293
161428,30062_20190809142256.jpg,ミスミモール,**10,神戸,31,む,2019/8/9 14:22,2-1_all_corrected,76,66,121,204,197,270
160969,30045_20190809094707.jpg,マックスバリュー徳川明倫,8000,名古屋,30,せ,2019/8/9 9:46,2-1_all_corrected,47,41,261,156,308,197
161846,30072_20190809174123.jpg,関西スーパー京阪大和田１F,4426,大阪,500,い,2019/8/9 17:40,2-1_all_corrected,101,85,2,347,103,432
162401,30090_20190809223428.jpg,イトーヨーカドー木場 西棟,5315,浜松,581,ぬ,2019/8/9 22:34,2-1_all_corrected,69,56,322,202,391,258
161802,30072_20190809172255.jpg,関西スーパー京阪大和田１F,3558,京都,502,ね,2019/8/9 17:22,2-1_all_corrected,44,34,188,47,232,81
162026,30111_20190809184807.jpg,イオン稲毛,**78,千葉,344,そ,2019/8/9 18:47,2-1_all_corrected,68,51,317,182,385,233
161695,30006_20190809164606.jpg,スギ薬局南千里,5812,大阪,330,も,2019/8/9 16:45,2-1_all_corrected,103,63,323,84,426,147
161833,30110_20190809173639.jpg,イオン金沢八景,**33,群馬,550,り,2019/8/9 17:36,2-1_all_corrected,73,61,329,293,402,354
161692,30111_20190809164547.jpg,イオン稲毛,3605,袖ヶ浦,100,さ,2019/8/9 16:45,2-1_all_corrected,67,55,258,155,325,210
161454,30078_20190809144028.jpg,イオンスタイル仙台卸町店,8493,仙台,500,た,2019/8/9 14:40,2-1_all_corrected,71,50,212,125,283,175
161064,30111_20190809105241.jpg,イオン稲毛,***3,千葉,30,せ,2019/8/9 10:52,2-1_all_corrected,47,33,147,118,194,151
161269,30111_20190809125803.jpg,イオン稲毛,*618,新潟,536,ら,2019/8/9 12:57,2-1_all_corrected,53,42,391,119,444,161
161867,30144_20190809174800.jpg,イオン幕張,9516,千葉,302,つ,2019/8/9 17:47,2-1_all_corrected,55,42,103,133,158,175
161251,30085_20190809124708.jpg,業務スーパー南津守,*111,なにわ,30,は,2019/8/9 12:46,2-1_all_corrected,71,54,296,269,367,323
160979,30001_20190809095552.jpg,関西スーパー高石駅前,3721,堺,480,き,2019/8/9 9:55,2-1_all_corrected,67,54,295,88,362,142
161052,30060_20190809104440.jpg,関西スーパー小野原,8856,多摩,502,に,2019/8/9 10:44,2-1_all_corrected,40,31,89,212,129,243
161851,30078_20190809174231.jpg,イオンスタイル仙台卸町店,**17,品川,391,す,2019/8/9 17:42,2-1_all_corrected,101,51,220,399,321,450
161409,30167_20190809140855.jpg,イオン東雲店,**22,足立,357,ね,2019/8/9 14:07,2-1_all_corrected,74,58,243,217,317,275
161694,30167_20190809164604.jpg,イオン東雲店,7411,足立,230,さ,2019/8/9 16:45,2-1_all_corrected,60,43,330,339,390,382
161437,30157_20190809142844.jpg,関西スーパー中央,8989,大阪,480,な,2019/8/9 14:28,2-1_all_corrected,51,42,195,380,246,422
162080,30085_20190809191602.jpg,業務スーパー南津守,**55,なにわ,31,め,2019/8/9 19:15,2-1_all_corrected,87,66,482,326,569,392
161261,30078_20190809125519.jpg,イオンスタイル仙台卸町店,**73,宮城,333,む,2019/8/9 12:54,2-1_all_corrected,80,60,349,284,429,344
161065,30139_20190809105306.jpg,イオン板橋ショッピングセンター,***1,練馬,30,ね,2019/8/9 10:52,2-1_all_corrected,48,35,309,144,357,179
161866,30110_20190809174738.jpg,イオン金沢八景,*715,横浜,348,に,2019/8/9 17:47,2-1_all_corrected,52,44,461,56,513,100
161892,30072_20190809175603.jpg,関西スーパー京阪大和田１F,1906,大阪,303,そ,2019/8/9 17:55,2-1_all_corrected,78,66,0,202,78,268
162130,30063_20190809192652.jpg,コーナン相模原小山モール,6130,多摩,330,ね,2019/8/9 19:26,2-1_all_corrected,76,65,507,181,583,246
162108,30144_20190809192132.jpg,イオン幕張,1220,千葉,341,は,2019/8/9 19:21,2-1_all_corrected,87,62,297,330,384,392
161574,30062_20190809153716.jpg,ミスミモール,1001,神戸,31,ろ,2019/8/9 15:36,2-1_all_corrected,52,40,445,106,497,146
161589,30072_20190809154803.jpg,関西スーパー京阪大和田１F,5000,大阪,580,そ,2019/8/9 15:46,2-1_all_corrected,93,72,6,215,99,287
161542,30111_20190809151818.jpg,イオン稲毛,1156,千葉,531,す,2019/8/9 15:17,2-1_all_corrected,67,53,255,168,322,221
162333,30090_20190809212913.jpg,イトーヨーカドー木場 西棟,1116,足立,344,ろ,2019/8/9 21:28,2-1_all_corrected,57,44,228,190,285,234
162139,30091_20190809192925.jpg,イトーヨーカドー木場 立体,5339,柏,300,た,2019/8/9 19:29,2-1_all_corrected,52,46,256,76,308,122
161982,30111_20190809182733.jpg,イオン稲毛,8008,千葉,375,に,2019/8/9 18:27,2-1_all_corrected,57,43,346,151,403,194
162199,30078_20190809195748.jpg,イオンスタイル仙台卸町店,7168,仙台,580,ね,2019/8/9 19:57,2-1_all_corrected,71,53,214,142,285,195
161144,30167_20190809113540.jpg,イオン東雲店,4776,袖ヶ浦,580,と,2019/8/9 11:34,2-1_all_corrected,69,56,187,203,256,259
162100,30090_20190809191949.jpg,イトーヨーカドー木場 西棟,*521,足立,337,せ,2019/8/9 19:19,2-1_all_corrected,55,39,269,166,324,205
161543,30111_20190809151913.jpg,イオン稲毛,3309,千葉,502,め,2019/8/9 15:18,2-1_all_corrected,57,45,207,162,264,207
161370,30091_20190809135121.jpg,イトーヨーカドー木場 立体,3968,足立,57,ろ,2019/8/9 13:50,2-1_all_corrected,51,39,237,178,288,217
161189,30060_20190809120551.jpg,関西スーパー小野原,*354,神戸,481,り,2019/8/9 12:05,2-1_all_corrected,55,73,22,243,77,316
161521,30078_20190809150919.jpg,イオンスタイル仙台卸町店,*884,仙台,580,ね,2019/8/9 15:08,2-1_all_corrected,79,57,286,239,365,296
161348,30045_20190809134032.jpg,マックスバリュー徳川明倫,1001,名古屋,31,ほ,2019/8/9 13:39,2-1_all_corrected,75,59,173,160,248,219
161173,30169_20190809115613.jpg,イオン相模原ショッピングセンター,1016,相模,584,ち,2019/8/9 11:55,2-1_all_corrected,77,62,236,127,313,189
162359,30169_20190809215308.jpg,イオン相模原ショッピングセンター,*423,横浜,537,た,2019/8/9 21:52,2-1_all_corrected,92,67,251,303,343,370
161346,30039_20190809133949.jpg,イトーヨーカドー大井町,8081,品川,330,ら,2019/8/9 13:39,2-1_all_corrected,67,56,255,156,322,212
161948,30111_20190809182050.jpg,イオン稲毛,*396,習志野,483,あ,2019/8/9 18:20,2-1_all_corrected,54,45,210,163,264,208
160862,30167_20190809082100.jpg,イオン東雲店,7411,足立,230,さ,2019/8/9 8:20,2-1_all_corrected,73,55,349,363,422,418
161379,30006_20190809135325.jpg,スギ薬局南千里,3220,大阪,330,の,2019/8/9 13:53,2-1_all_corrected,126,75,108,113,234,188
161983,30110_20190809182816.jpg,イオン金沢八景,8808,横浜,503,ひ,2019/8/9 18:27,2-1_all_corrected,78,66,506,179,584,245
161169,30111_20190809115419.jpg,イオン稲毛,*625,千葉,544,ぬ,2019/8/9 11:53,2-1_all_corrected,56,43,195,150,251,193
161738,30167_20190809170520.jpg,イオン東雲店,5726,足立,500,え,2019/8/9 17:03,2-1_all_corrected,71,58,223,233,294,291
161535,30169_20190809151438.jpg,イオン相模原ショッピングセンター,**15,相模,502,つ,2019/8/9 15:14,2-1_all_corrected,74,58,306,99,380,157
162386,30169_20190809221843.jpg,イオン相模原ショッピングセンター,8660,多摩,331,て,2019/8/9 22:18,2-1_all_corrected,67,59,309,182,376,241
161399,30066_20190809140320.jpg,ジョーシン和泉中央,**88,和泉,31,ち,2019/8/9 14:02,2-1_all_corrected,66,54,215,192,281,246
162178,30144_20190809194844.jpg,イオン幕張,2963,岐阜,302,せ,2019/8/9 19:48,2-1_all_corrected,98,63,236,386,334,449
161908,30111_20190809180206.jpg,イオン稲毛,4007,千葉,302,に,2019/8/9 18:01,2-1_all_corrected,58,42,356,190,414,232
161937,30045_20190809181434.jpg,マックスバリュー徳川明倫,1010,名古屋,31,ゆ,2019/8/9 18:14,2-1_all_corrected,53,45,236,132,289,177
161337,30110_20190809133252.jpg,イオン金沢八景,1797,横浜,50,も,2019/8/9 13:32,2-1_all_corrected,46,39,286,52,332,91
161906,30072_20190809175951.jpg,関西スーパー京阪大和田１F,4982,なにわ,301,て,2019/8/9 17:59,2-1_all_corrected,77,61,1,196,78,257
161102,30111_20190809111233.jpg,イオン稲毛,6645,千葉,581,き,2019/8/9 11:12,2-1_all_corrected,69,52,399,225,468,277
161592,30110_20190809154902.jpg,イオン金沢八景,8320,横浜,583,い,2019/8/9 15:48,2-1_all_corrected,76,65,127,313,203,378
160881,30073_20190809083500.jpg,関西スーパー京阪大和田２F,*762,京都,800,こ,2019/8/9 8:34,2-1_all_corrected,50,61,546,213,596,274
161150,30090_20190809114136.jpg,イトーヨーカドー木場 西棟,5456,足立,301,や,2019/8/9 11:41,2-1_all_corrected,80,58,331,292,411,350
161336,30078_20190809133135.jpg,イオンスタイル仙台卸町店,3657,仙台,580,き,2019/8/9 13:31,2-1_all_corrected,78,54,234,213,312,267
161938,30144_20190809181443.jpg,イオン幕張,9370,横浜,581,う,2019/8/9 18:14,2-1_all_corrected,85,61,333,327,418,388
161797,30167_20190809172024.jpg,イオン東雲店,**21,大宮,431,て,2019/8/9 17:19,2-1_all_corrected,82,65,204,288,286,353
161909,30111_20190809180238.jpg,イオン稲毛,1016,千葉,343,む,2019/8/9 18:02,2-1_all_corrected,55,41,363,136,418,177
160996,30167_20190809100811.jpg,イオン東雲店,**21,大宮,431,て,2019/8/9 10:07,2-1_all_corrected,49,38,308,158,357,196
162094,30006_20190809191900.jpg,スギ薬局南千里,**73,大阪,345,や,2019/8/9 19:18,2-1_all_corrected,141,120,130,259,271,379
162255,30169_20190809203359.jpg,イオン相模原ショッピングセンター,**33,相模,366,は,2019/8/9 20:33,2-1_all_corrected,87,67,131,263,218,330
161875,30169_20190809174957.jpg,イオン相模原ショッピングセンター,4069,相模,301,は,2019/8/9 17:48,2-1_all_corrected,55,41,448,5,503,46
162051,30079_20190809185906.jpg,ピットデザイン仙台卸町駅前駐車場,7064,仙台,580,に,2019/8/9 18:58,2-1_all_corrected,51,35,357,171,408,206
162297,30144_20190809210228.jpg,イオン幕張,3302,山梨,400,た,2019/8/9 21:02,2-1_all_corrected,84,60,253,294,337,354
162201,30169_20190809195847.jpg,イオン相模原ショッピングセンター,8787,多摩,331,な,2019/8/9 19:58,2-1_all_corrected,80,73,452,370,532,443
161226,30001_20190809123605.jpg,関西スーパー高石駅前,8890,和泉,502,つ,2019/8/9 12:35,2-1_all_corrected,58,43,300,82,358,125
161013,30072_20190809102143.jpg,関西スーパー京阪大和田１F,8348,なにわ,580,む,2019/8/9 10:20,2-1_all_corrected,59,64,429,159,488,223
161887,30111_20190809175311.jpg,イオン稲毛,8430,千葉,301,ひ,2019/8/9 17:52,2-1_all_corrected,55,42,178,132,233,174
162057,30110_20190809190109.jpg,イオン金沢八景,*488,横浜,580,る,2019/8/9 19:00,2-1_all_corrected,52,46,206,130,258,176
161084,30111_20190809110143.jpg,イオン稲毛,***5,千葉,30,ふ,2019/8/9 11:01,2-1_all_corrected,44,32,420,79,464,111
162262,30110_20190809203728.jpg,イオン金沢八景,*703,横浜,346,む,2019/8/9 20:37,2-1_all_corrected,53,41,373,75,426,116
161273,30078_20190809130037.jpg,イオンスタイル仙台卸町店,1579,石川,530,す,2019/8/9 13:00,2-1_all_corrected,100,49,304,401,404,450
162254,30110_20190809203354.jpg,イオン金沢八景,*222,横浜,355,も,2019/8/9 20:33,2-1_all_corrected,49,41,292,65,341,106
161644,30052_20190809161100.jpg,西友市ヶ尾,*111,横浜,30,た,2019/8/9 16:10,2-1_all_corrected,52,38,376,192,428,230
161811,30111_20190809172853.jpg,イオン稲毛,1530,千葉,531,ろ,2019/8/9 17:28,2-1_all_corrected,55,45,221,159,276,204
161015,30144_20190809102315.jpg,イオン幕張,3199,千葉,580,み,2019/8/9 10:22,2-1_all_corrected,54,40,166,152,220,192
162231,30144_20190809201840.jpg,イオン幕張,*304,足立,331,ふ,2019/8/9 20:18,2-1_all_corrected,83,57,249,318,332,375
206981,30111_20190828121713.jpg,イオン稲毛,1693,千葉,530,に,2019/8/28 12:16,2-1_all_corrected,59,46,387,128,446,174
207296,30137_20190828143015.jpg,イオンスタイル品川シーサイド,*630,神戸,345,て,2019/8/28 14:29,2-1_all_corrected,97,73,276,339,373,412
206512,30167_20190828083538.jpg,イオン東雲店,7411,足立,230,さ,2019/8/28 8:35,2-1_all_corrected,55,43,323,320,378,363
208212,30169_20190828184753.jpg,イオン相模原ショッピングセンター,**10,多摩,381,の,2019/8/28 18:47,2-1_all_corrected,56,42,385,164,441,206
207057,30022_20190828124921.jpg,業務スーパー平野駅前,*111,なにわ,30,せ,2019/8/28 12:48,2-1_all_corrected,72,65,98,133,170,198
207405,30157_20190828145357.jpg,関西スーパー中央,*888,神戸,515,す,2019/8/28 14:53,2-1_all_corrected,78,62,162,258,240,320
208029,30063_20190828181302.jpg,コーナン相模原小山モール,*330,神戸,100,う,2019/8/28 18:12,2-1_all_corrected,69,65,29,305,98,370
208011,30144_20190828181005.jpg,イオン幕張,7651,習志野,580,る,2019/8/28 18:09,2-1_all_corrected,42,50,8,208,50,258
207865,30167_20190828173011.jpg,イオン東雲店,7411,足立,230,さ,2019/8/28 17:29,2-1_all_corrected,51,37,255,257,306,294
207831,30078_20190828172207.jpg,イオンスタイル仙台卸町店,6254,仙台,501,そ,2019/8/28 17:21,2-1_all_corrected,43,37,214,4,257,41
208045,30144_20190828181627.jpg,イオン幕張,*805,横浜,536,に,2019/8/28 18:16,2-1_all_corrected,62,42,247,221,309,263
208270,30110_20190828190023.jpg,イオン金沢八景,*612,つくば,333,ひ,2019/8/28 18:59,2-1_all_corrected,72,60,387,212,459,272
208042,30139_20190828181548.jpg,イオン板橋ショッピングセンター,*275,川口,480,り,2019/8/28 18:15,2-1_all_corrected,72,60,258,274,330,334
207231,30110_20190828140126.jpg,イオン金沢八景,9802,横浜,330,ひ,2019/8/28 14:01,2-1_all_corrected,80,68,87,248,167,316
206926,30090_20190828115559.jpg,イトーヨーカドー木場 西棟,9636,足立,480,く,2019/8/28 11:55,2-1_all_corrected,77,51,140,238,217,289
208246,30169_20190828185445.jpg,イオン相模原ショッピングセンター,5399,横浜,503,め,2019/8/28 18:54,2-1_all_corrected,87,75,429,329,516,404
207236,30072_20190828140416.jpg,関西スーパー京阪大和田１F,2526,大阪,532,ま,2019/8/28 14:03,2-1_all_corrected,71,53,394,154,465,207
207004,30001_20190828122811.jpg,関西スーパー高石駅前,1825,和泉,330,ま,2019/8/28 12:27,2-1_all_corrected,75,55,347,99,422,154
208010,30144_20190828180959.jpg,イオン幕張,5440,成田,500,せ,2019/8/28 18:09,2-1_all_corrected,80,57,244,277,324,334
206989,30157_20190828121953.jpg,関西スーパー中央,6188,神戸,300,ほ,2019/8/28 12:19,2-1_all_corrected,71,53,153,389,224,442
207404,30167_20190828145131.jpg,イオン東雲店,3012,成田,100,さ,2019/8/28 14:51,2-1_all_corrected,51,35,350,271,401,306
206973,30111_20190828121346.jpg,イオン稲毛,9573,千葉,580,ほ,2019/8/28 12:12,2-1_all_corrected,68,54,147,159,215,213
208683,30167_20190828203930.jpg,イオン東雲店,4704,足立,481,り,2019/8/28 20:39,2-1_all_corrected,66,62,172,271,238,333
207607,30066_20190828161147.jpg,ジョーシン和泉中央,**11,和泉,31,な,2019/8/28 16:11,2-1_all_corrected,69,53,194,216,263,269
208416,30110_20190828192506.jpg,イオン金沢八景,1001,横浜,31,あ,2019/8/28 19:24,2-1_all_corrected,84,60,410,307,494,367
206786,30062_20190828110109.jpg,ミスミモール,***3,神戸,30,ほ,2019/8/28 11:00,2-1_all_corrected,42,32,464,67,506,99
208081,30144_20190828182506.jpg,イオン幕張,1588,習志野,331,ふ,2019/8/28 18:24,2-1_all_corrected,88,63,277,304,365,367
207206,30137_20190828135455.jpg,イオンスタイル品川シーサイド,9296,品川,580,こ,2019/8/28 13:54,2-1_all_corrected,95,63,371,387,466,450
207034,30167_20190828123736.jpg,イオン東雲店,1117,足立,349,つ,2019/8/28 12:36,2-1_all_corrected,75,79,5,291,80,370
208109,30046_20190828183217.jpg,マミーマート船橋日大[地上],5216,習志野,580,こ,2019/8/28 18:31,2-1_all_corrected,40,31,185,49,225,80
206636,30070_20190828093200.jpg,カナートモール住道第一,**55,大阪,31,す,2019/8/28 9:31,2-1_all_corrected,76,57,342,147,418,204
207710,30060_20190828164434.jpg,関西スーパー小野原,3406,大阪,480,な,2019/8/28 16:44,2-1_all_corrected,93,63,286,387,379,450
208107,30111_20190828183154.jpg,イオン稲毛,8031,宮崎,500,た,2019/8/28 18:31,2-1_all_corrected,52,39,178,144,230,183
207514,30111_20190828153805.jpg,イオン稲毛,5462,千葉,580,ふ,2019/8/28 15:37,2-1_all_corrected,56,43,342,144,398,187
208138,30169_20190828183710.jpg,イオン相模原ショッピングセンター,7662,相模,530,ち,2019/8/28 18:36,2-1_all_corrected,89,75,443,337,532,412
207721,30167_20190828164813.jpg,イオン東雲店,2917,所沢,580,の,2019/8/28 16:47,2-1_all_corrected,75,59,149,256,224,315
208361,30072_20190828191544.jpg,関西スーパー京阪大和田１F,4950,大阪,502,わ,2019/8/28 19:15,2-1_all_corrected,46,33,170,80,216,113
207112,30044_20190828131338.jpg,ココス横浜港南台,***9,横浜,31,る,2019/8/28 13:13,2-1_all_corrected,80,50,216,209,296,259
206696,30072_20190828095107.jpg,関西スーパー京阪大和田１F,7225,大阪,430,さ,2019/8/28 9:50,2-1_all_corrected,98,85,102,327,200,412
208191,30091_20190828184503.jpg,イトーヨーカドー木場 立体,8579,袖ヶ浦,530,つ,2019/8/28 18:44,2-1_all_corrected,85,61,152,259,237,320
207571,30045_20190828155625.jpg,マックスバリュー徳川明倫,***1,名古屋,30,ぬ,2019/8/28 15:55,2-1_all_corrected,52,43,376,129,428,172
207981,30144_20190828180334.jpg,イオン幕張,9237,千葉,301,に,2019/8/28 18:03,2-1_all_corrected,55,40,178,119,233,159
207727,30144_20190828164952.jpg,イオン幕張,1717,千葉,360,ゆ,2019/8/28 16:49,2-1_all_corrected,74,50,185,198,259,248
208130,30169_20190828183530.jpg,イオン相模原ショッピングセンター,1182,多摩,333,せ,2019/8/28 18:35,2-1_all_corrected,79,72,504,337,583,409
208933,30079_20190828224748.jpg,ピットデザイン仙台卸町駅前駐車場,1062,仙台,300,ろ,2019/8/28 22:47,2-1_all_corrected,77,56,350,134,427,190
207523,30045_20190828154029.jpg,マックスバリュー徳川明倫,**33,名古屋,31,そ,2019/8/28 15:39,2-1_all_corrected,45,34,313,87,358,121
208795,30139_20190828211524.jpg,イオン板橋ショッピングセンター,3671,練馬,480,れ,2019/8/28 21:15,2-1_all_corrected,75,61,242,290,317,351
207742,30110_20190828165446.jpg,イオン金沢八景,*181,横浜,333,ま,2019/8/28 16:54,2-1_all_corrected,90,104,3,346,93,450
206690,30167_20190828094845.jpg,イオン東雲店,7411,足立,230,さ,2019/8/28 9:48,2-1_all_corrected,56,44,357,343,413,387
207321,30006_20190828143339.jpg,スギ薬局南千里,2739,大阪,480,す,2019/8/28 14:33,2-1_all_corrected,109,69,162,198,271,267
207583,30078_20190828160022.jpg,イオンスタイル仙台卸町店,3388,仙台,100,す,2019/8/28 15:59,2-1_all_corrected,60,34,214,62,274,96
206663,30132_20190828093815.jpg,イオンスタイル東神奈川,*534,新潟,430,せ,2019/8/28 9:31,2-1_all_corrected,74,58,214,230,288,288
206809,30145_20190828111128.jpg,イオン高根木戸,8377,習志野,580,い,2019/8/28 11:11,2-1_all_corrected,57,42,264,150,321,192
207579,30045_20190828155844.jpg,マックスバリュー徳川明倫,8008,名古屋,31,は,2019/8/28 15:58,2-1_all_corrected,47,35,314,113,361,148
208183,30144_20190828184409.jpg,イオン幕張,*503,千葉,555,よ,2019/8/28 18:43,2-1_all_corrected,39,33,241,113,280,146
208345,30040_20190828191206.jpg,ハローデイ門司港,3981,北九州,330,た,2019/8/28 19:11,2-1_all_corrected,58,41,309,333,367,374
207769,30111_20190828170159.jpg,イオン稲毛,8623,千葉,531,せ,2019/8/28 17:00,2-1_all_corrected,86,61,473,389,559,450
208710,30139_20190828204643.jpg,イオン板橋ショッピングセンター,*275,川口,480,り,2019/8/28 20:46,2-1_all_corrected,86,68,322,371,408,439
208380,30072_20190828191933.jpg,関西スーパー京阪大和田１F,6328,大阪,480,て,2019/8/28 19:19,2-1_all_corrected,42,35,181,86,223,121
208179,30072_20190828184336.jpg,関西スーパー京阪大和田１F,2000,大阪,334,か,2019/8/28 18:43,2-1_all_corrected,72,58,13,175,85,233
207793,30145_20190828170731.jpg,イオン高根木戸,5755,春日井,100,あ,2019/8/28 17:06,2-1_all_corrected,38,26,146,71,184,97
207935,30046_20190828174843.jpg,マミーマート船橋日大[地上],**15,習志野,586,ね,2019/8/28 17:48,2-1_all_corrected,36,29,148,38,184,67
208373,30144_20190828191714.jpg,イオン幕張,3365,千葉,503,く,2019/8/28 19:16,2-1_all_corrected,43,38,131,149,174,187
207760,30072_20190828165917.jpg,関西スーパー京阪大和田１F,1597,大阪,500,い,2019/8/28 16:58,2-1_all_corrected,128,117,186,315,314,432
207162,30167_20190828133255.jpg,イオン東雲店,*412,足立,830,ゆ,2019/8/28 13:32,2-1_all_corrected,69,60,119,192,188,252
208318,30072_20190828190721.jpg,関西スーパー京阪大和田１F,1555,大阪,583,く,2019/8/28 19:06,2-1_all_corrected,46,35,165,82,211,117
207959,30078_20190828175643.jpg,イオンスタイル仙台卸町店,8787,仙台,330,は,2019/8/28 17:56,2-1_all_corrected,57,43,332,93,389,136
208112,30063_20190828183255.jpg,コーナン相模原小山モール,7384,相模,301,ふ,2019/8/28 18:32,2-1_all_corrected,68,58,458,136,526,194
207508,30169_20190828153711.jpg,イオン相模原ショッピングセンター,*333,相模,322,ら,2019/8/28 15:36,2-1_all_corrected,73,56,325,176,398,232
207359,30144_20190828144200.jpg,イオン幕張,1110,千葉,538,な,2019/8/28 14:41,2-1_all_corrected,87,66,410,351,497,417
207957,30111_20190828175613.jpg,イオン稲毛,*362,千葉,301,わ,2019/8/28 17:55,2-1_all_corrected,43,35,75,83,118,118
207761,30072_20190828165923.jpg,関西スーパー京阪大和田１F,1597,大阪,500,い,2019/8/28 16:58,2-1_all_corrected,92,65,314,166,406,231
207795,30091_20190828170801.jpg,イトーヨーカドー木場 立体,1933,足立,500,つ,2019/8/28 17:07,2-1_all_corrected,49,38,411,226,460,264
207596,30110_20190828160602.jpg,イオン金沢八景,***1,横浜,352,た,2019/8/28 16:05,2-1_all_corrected,65,65,1,185,66,250
208388,30167_20190828192012.jpg,イオン東雲店,2139,多摩,500,い,2019/8/28 19:19,2-1_all_corrected,35,29,471,39,506,68
207106,30169_20190828131001.jpg,イオン相模原ショッピングセンター,*515,多摩,545,の,2019/8/28 13:09,2-1_all_corrected,53,41,128,82,181,123
207565,30111_20190828155454.jpg,イオン稲毛,*137,千葉,300,に,2019/8/28 15:54,2-1_all_corrected,70,53,298,177,368,230
208546,30046_20190828195736.jpg,マミーマート船橋日大[地上],3747,習志野,301,ふ,2019/8/28 19:57,2-1_all_corrected,43,31,218,67,261,98
208328,30169_20190828190900.jpg,イオン相模原ショッピングセンター,7312,相模,330,て,2019/8/28 19:08,2-1_all_corrected,54,45,147,232,201,277
208125,30137_20190828183445.jpg,イオンスタイル品川シーサイド,*555,品川,507,る,2019/8/28 18:34,2-1_all_corrected,81,66,422,281,503,347
208919,30079_20190828223111.jpg,ピットデザイン仙台卸町駅前駐車場,1062,仙台,300,ろ,2019/8/28 22:30,2-1_all_corrected,72,53,282,133,354,186
207967,30167_20190828180037.jpg,イオン東雲店,6702,横浜,304,ま,2019/8/28 18:00,2-1_all_corrected,93,75,58,337,151,412
206488,30111_20190828082233.jpg,イオン稲毛,8564,千葉,330,せ,2019/8/28 8:21,2-1_all_corrected,56,42,366,124,422,166
208095,30139_20190828182827.jpg,イオン板橋ショッピングセンター,1282,越谷,480,り,2019/8/28 18:27,2-1_all_corrected,71,62,267,315,338,377
207472,30144_20190828152209.jpg,イオン幕張,7770,千葉,531,め,2019/8/28 15:21,2-1_all_corrected,49,31,192,78,241,109
207486,30138_20190828153013.jpg,イオンスタイル湘南茅ヶ崎,***6,湘南,540,ね,2019/8/28 15:29,2-1_all_corrected,77,55,163,319,240,374
207823,30046_20190828171716.jpg,マミーマート船橋日大[地上],*722,習志野,340,な,2019/8/28 17:16,2-1_all_corrected,40,28,190,20,230,48
208433,30132_20190828192925.jpg,イオンスタイル東神奈川,***8,横浜,30,に,2019/8/28 19:28,2-1_all_corrected,66,53,324,212,390,265
208291,30144_20190828190254.jpg,イオン幕張,8888,杉並,307,ら,2019/8/28 19:02,2-1_all_corrected,41,36,247,96,288,132
206905,30167_20190828114900.jpg,イオン東雲店,7757,石川,480,れ,2019/8/28 11:48,2-1_all_corrected,42,33,362,87,404,120
206750,30111_20190828103007.jpg,イオン稲毛,*358,千葉,592,な,2019/8/28 10:29,2-1_all_corrected,53,43,333,144,386,187
207824,30062_20190828171737.jpg,ミスミモール,***8,神戸,30,て,2019/8/28 17:17,2-1_all_corrected,81,63,185,270,266,333
208050,30072_20190828181837.jpg,関西スーパー京阪大和田１F,1000,大阪,453,の,2019/8/28 18:18,2-1_all_corrected,47,43,399,131,446,174
207417,30090_20190828145811.jpg,イトーヨーカドー木場 西棟,6449,足立,530,い,2019/8/28 14:57,2-1_all_corrected,86,64,392,352,478,416
208004,30111_20190828180813.jpg,イオン稲毛,*301,千葉,304,ゆ,2019/8/28 18:07,2-1_all_corrected,39,32,62,64,101,96
207870,30052_20190828173104.jpg,西友市ヶ尾,8000,横浜,30,み,2019/8/28 17:30,2-1_all_corrected,83,61,292,291,375,352
208493,30111_20190828194459.jpg,イオン稲毛,1003,千葉,347,ゆ,2019/8/28 19:44,2-1_all_corrected,42,32,68,72,110,104
206993,30062_20190828122504.jpg,ミスミモール,***3,神戸,30,ふ,2019/8/28 12:24,2-1_all_corrected,59,40,333,150,392,190
207283,30072_20190828142631.jpg,関西スーパー京阪大和田１F,***1,大阪,30,と,2019/8/28 14:26,2-1_all_corrected,56,41,106,187,162,228
208263,30144_20190828185947.jpg,イオン幕張,1014,千葉,584,ま,2019/8/28 18:59,2-1_all_corrected,87,62,274,340,361,402
208051,30139_20190828181852.jpg,イオン板橋ショッピングセンター,3671,練馬,480,れ,2019/8/28 18:18,2-1_all_corrected,77,62,244,288,321,350
208056,30144_20190828182000.jpg,イオン幕張,*921,千葉,535,ろ,2019/8/28 18:19,2-1_all_corrected,39,32,195,11,234,43
207445,30111_20190828150921.jpg,イオン稲毛,**11,千葉,31,な,2019/8/28 15:08,2-1_all_corrected,47,41,173,104,220,145
208069,30111_20190828182334.jpg,イオン稲毛,*303,千葉,338,ゆ,2019/8/28 18:22,2-1_all_corrected,51,44,218,146,269,190
208067,30111_20190828182303.jpg,イオン稲毛,*286,千葉,330,わ,2019/8/28 18:22,2-1_all_corrected,51,41,129,117,180,158
208403,30022_20190828192314.jpg,業務スーパー平野駅前,***8,なにわ,30,る,2019/8/28 19:22,2-1_all_corrected,82,70,62,159,144,229
207420,30110_20190828145817.jpg,イオン金沢八景,8533,横浜,330,ふ,2019/8/28 14:57,2-1_all_corrected,39,31,325,17,364,48
207847,30144_20190828172642.jpg,イオン幕張,2162,千葉,501,た,2019/8/28 17:26,2-1_all_corrected,83,64,307,359,390,423
207088,30137_20190828130121.jpg,イオンスタイル品川シーサイド,1977,練馬,333,の,2019/8/28 13:00,2-1_all_corrected,69,56,184,131,253,187
208696,30110_20190828204250.jpg,イオン金沢八景,1912,横浜,480,て,2019/8/28 20:42,2-1_all_corrected,72,61,428,229,500,290
208459,30098_20190828193525.jpg,BRANCH仙台（東棟）,1001,仙台,347,つ,2019/8/28 19:34,2-1_all_corrected,106,75,170,275,276,350
207429,30045_20190828150350.jpg,マックスバリュー徳川明倫,***1,名古屋,30,ぬ,2019/8/28 15:03,2-1_all_corrected,49,49,484,153,533,202
207885,30144_20190828173527.jpg,イオン幕張,3092,習志野,580,ひ,2019/8/28 17:34,2-1_all_corrected,82,54,231,319,313,373
208495,30106_20190828194547.jpg,ジョーシン東大阪長田,**55,大阪,31,ろ,2019/8/28 19:45,2-1_all_corrected,81,60,81,285,162,345
206913,30167_20190828115009.jpg,イオン東雲店,*703,足立,344,さ,2019/8/28 11:49,2-1_all_corrected,55,46,437,347,492,393
207009,30022_20190828123015.jpg,業務スーパー平野駅前,***8,大阪,30,も,2019/8/28 12:29,2-1_all_corrected,48,44,16,274,64,318
207235,30144_20190828140355.jpg,イオン幕張,1399,千葉,580,ま,2019/8/28 14:03,2-1_all_corrected,71,56,292,218,363,274
207232,30110_20190828140127.jpg,イオン金沢八景,9807,横浜,330,ひ,2019/8/28 14:01,2-1_all_corrected,52,47,484,107,536,154
208874,30167_20190828220513.jpg,イオン東雲店,*916,足立,338,に,2019/8/28 22:04,2-1_all_corrected,67,52,424,353,491,405
208621,30001_20190828202125.jpg,関西スーパー高石駅前,*475,和泉,330,つ,2019/8/28 20:21,2-1_all_corrected,69,55,440,94,509,149
208023,30072_20190828181210.jpg,関西スーパー京阪大和田１F,**50,大阪,340,ら,2019/8/28 18:11,2-1_all_corrected,40,32,415,32,455,64
207868,30167_20190828173035.jpg,イオン東雲店,**21,大宮,431,て,2019/8/28 17:30,2-1_all_corrected,90,70,152,345,242,415
207401,30144_20190828145040.jpg,イオン幕張,1003,千葉,348,て,2019/8/28 14:50,2-1_all_corrected,46,32,185,90,231,122
207895,30169_20190828173818.jpg,イオン相模原ショッピングセンター,2628,多摩,530,つ,2019/8/28 17:37,2-1_all_corrected,86,67,366,296,452,363
206978,30111_20190828121506.jpg,イオン稲毛,1025,成田,331,せ,2019/8/28 12:13,2-1_all_corrected,74,63,288,230,362,293
208244,30106_20190828185431.jpg,ジョーシン東大阪長田,**10,大阪,31,な,2019/8/28 18:54,2-1_all_corrected,94,68,96,345,190,413
208076,30144_20190828182412.jpg,イオン幕張,*813,千葉,334,わ,2019/8/28 18:23,2-1_all_corrected,43,33,189,29,232,62
207650,30144_20190828162559.jpg,イオン幕張,4225,足立,301,た,2019/8/28 16:25,2-1_all_corrected,92,65,355,340,447,405
207692,30144_20190828163902.jpg,イオン幕張,4246,千葉,302,て,2019/8/28 16:38,2-1_all_corrected,53,39,190,95,243,134
208423,30066_20190828192656.jpg,ジョーシン和泉中央,1001,和泉,31,と,2019/8/28 19:26,2-1_all_corrected,76,60,144,268,220,328
207695,30137_20190828163942.jpg,イオンスタイル品川シーサイド,*111,品川,30,せ,2019/8/28 16:39,2-1_all_corrected,82,60,277,259,359,319
208286,30169_20190828190206.jpg,イオン相模原ショッピングセンター,*410,相模,581,て,2019/8/28 19:01,2-1_all_corrected,57,43,90,138,147,181
207635,30167_20190828162108.jpg,イオン東雲店,7411,足立,230,さ,2019/8/28 16:20,2-1_all_corrected,58,41,299,305,357,346
208817,30039_20190828212435.jpg,イトーヨーカドー大井町,*329,品川,337,た,2019/8/28 21:23,2-1_all_corrected,57,44,346,127,403,171
206979,30090_20190828121527.jpg,イトーヨーカドー木場 西棟,*158,足立,330,り,2019/8/28 12:15,2-1_all_corrected,58,41,193,232,251,273
207893,30111_20190828173744.jpg,イオン稲毛,1190,千葉,531,そ,2019/8/28 17:37,2-1_all_corrected,49,38,132,95,181,133
208221,30167_20190828185000.jpg,イオン東雲店,1010,足立,331,の,2019/8/28 18:49,2-1_all_corrected,55,43,327,283,382,326
206983,30060_20190828121811.jpg,関西スーパー小野原,7372,なにわ,580,け,2019/8/28 12:17,2-1_all_corrected,77,71,485,249,562,320
208025,30139_20190828181222.jpg,イオン板橋ショッピングセンター,6105,練馬,480,れ,2019/8/28 18:11,2-1_all_corrected,68,54,180,233,248,287
207260,30060_20190828141733.jpg,関西スーパー小野原,6226,大阪,430,せ,2019/8/28 14:17,2-1_all_corrected,66,53,307,173,373,226
208674,30110_20190828203518.jpg,イオン金沢八景,1370,横浜,304,む,2019/8/28 20:34,2-1_all_corrected,71,53,145,135,216,188
208022,30111_20190828181149.jpg,イオン稲毛,6689,千葉,330,そ,2019/8/28 18:10,2-1_all_corrected,62,43,370,141,432,184
208680,30006_20190828203737.jpg,スギ薬局南千里,3330,大阪,581,な,2019/8/28 20:37,2-1_all_corrected,126,118,142,28,268,146
207603,30074_20190828160925.jpg,マックスバリュ北1条東,1202,札幌,342,ゆ,2019/8/28 16:08,2-1_all_corrected,45,45,545,105,590,150
207293,30078_20190828142927.jpg,イオンスタイル仙台卸町店,3657,仙台,500,き,2019/8/28 14:29,2-1_all_corrected,76,55,254,138,330,193
208396,30078_20190828192149.jpg,イオンスタイル仙台卸町店,9119,仙台,530,そ,2019/8/28 19:21,2-1_all_corrected,83,61,185,257,268,318
206805,30169_20190828111036.jpg,イオン相模原ショッピングセンター,8205,相模,300,ろ,2019/8/28 11:10,2-1_all_corrected,56,48,368,140,424,188
207324,30169_20190828143413.jpg,イオン相模原ショッピングセンター,1211,相模,535,み,2019/8/28 14:33,2-1_all_corrected,75,61,258,207,333,268
208398,30144_20190828192152.jpg,イオン幕張,8395,千葉,-1,に,2019/8/28 19:21,2-1_all_corrected,38,33,220,94,258,127
206695,30041_20190828095105.jpg,ライフ宮内,8282,川崎,530,も,2019/8/28 9:50,2-1_all_corrected,78,64,484,274,562,338
208790,30139_20190828211403.jpg,イオン板橋ショッピングセンター,1282,越谷,480,り,2019/8/28 21:13,2-1_all_corrected,79,62,302,352,381,414
207946,30078_20190828175259.jpg,イオンスタイル仙台卸町店,2948,仙台,400,か,2019/8/28 17:52,2-1_all_corrected,53,46,318,130,371,176
207713,30145_20190828164541.jpg,イオン高根木戸,3777,習志野,583,せ,2019/8/28 16:45,2-1_all_corrected,48,34,281,52,329,86
206893,30006_20190828114234.jpg,スギ薬局南千里,*488,大阪,330,て,2019/8/28 11:42,2-1_all_corrected,105,65,489,113,594,178
208103,30046_20190828183121.jpg,マミーマート船橋日大[地上],2115,柏,530,さ,2019/8/28 18:30,2-1_all_corrected,150,123,128,22,278,145
207346,30137_20190828143903.jpg,イオンスタイル品川シーサイド,1033,品川,332,ま,2019/8/28 14:38,2-1_all_corrected,73,71,526,369,599,440
207722,30045_20190828164904.jpg,マックスバリュー徳川明倫,2525,名古屋,31,そ,2019/8/28 16:48,2-1_all_corrected,71,64,95,287,166,351
206856,30072_20190828112718.jpg,関西スーパー京阪大和田１F,6547,なにわ,800,あ,2019/8/28 11:26,2-1_all_corrected,52,42,97,149,149,191
207110,30136_20190828131257.jpg,イオンスタイル新百合ヶ丘,**77,川崎,367,を,2019/8/28 13:12,2-1_all_corrected,65,56,250,171,315,227
206835,30078_20190828111839.jpg,イオンスタイル仙台卸町店,1790,仙台,580,は,2019/8/28 11:18,2-1_all_corrected,98,69,243,344,341,413
208194,30169_20190828184506.jpg,イオン相模原ショッピングセンター,1389,相模,530,せ,2019/8/28 18:44,2-1_all_corrected,92,76,130,258,222,334
207128,30091_20190828131844.jpg,イトーヨーカドー木場 立体,8598,足立,480,れ,2019/8/28 13:18,2-1_all_corrected,73,60,167,235,240,295
208736,30139_20190828205409.jpg,イオン板橋ショッピングセンター,6105,練馬,480,れ,2019/8/28 20:53,2-1_all_corrected,81,70,233,332,314,402
207545,30060_20190828154751.jpg,関西スーパー小野原,8118,大阪,555,さ,2019/8/28 15:47,2-1_all_corrected,38,42,459,10,497,52
207922,30078_20190828174456.jpg,イオンスタイル仙台卸町店,8158,仙台,590,ほ,2019/8/28 17:44,2-1_all_corrected,75,55,369,195,444,250
207770,30145_20190828170217.jpg,イオン高根木戸,8086,習志野,580,ひ,2019/8/28 17:01,2-1_all_corrected,59,42,308,140,367,182
207925,30144_20190828174537.jpg,イオン幕張,7788,愛媛,546,つ,2019/8/28 17:45,2-1_all_corrected,81,63,388,328,469,391
206803,30169_20190828111026.jpg,イオン相模原ショッピングセンター,8205,相模,300,う,2019/8/28 11:09,2-1_all_corrected,44,34,364,54,408,88
207172,30001_20190828133706.jpg,関西スーパー高石駅前,8033,和泉,480,け,2019/8/28 13:36,2-1_all_corrected,90,62,174,248,264,310
208566,30169_20190828200357.jpg,イオン相模原ショッピングセンター,8420,相模,530,せ,2019/8/28 20:03,2-1_all_corrected,83,61,318,226,401,287
208330,30111_20190828190922.jpg,イオン稲毛,*369,千葉,530,む,2019/8/28 19:08,2-1_all_corrected,47,35,414,83,461,118
208133,30144_20190828183555.jpg,イオン幕張,8668,千葉,501,は,2019/8/28 18:35,2-1_all_corrected,82,62,383,349,465,411
206895,30072_20190828114433.jpg,関西スーパー京阪大和田１F,*563,京都,800,せ,2019/8/28 11:44,2-1_all_corrected,55,45,0,162,55,207
207520,30111_20190828153843.jpg,イオン稲毛,2182,千葉,530,た,2019/8/28 15:38,2-1_all_corrected,56,44,345,115,401,159
207195,30167_20190828135110.jpg,イオン東雲店,2695,品川,502,す,2019/8/28 13:50,2-1_all_corrected,93,54,94,396,187,450
207701,30167_20190828164110.jpg,イオン東雲店,9281,足立,301,す,2019/8/28 16:40,2-1_all_corrected,69,55,517,364,586,419
207954,30144_20190828175451.jpg,イオン幕張,2729,千葉,502,ね,2019/8/28 17:54,2-1_all_corrected,58,41,345,196,403,237
208312,30138_20190828190623.jpg,イオンスタイル湘南茅ヶ崎,9501,湘南,300,ろ,2019/8/28 19:05,2-1_all_corrected,88,70,419,326,507,396
208725,30006_20190828204947.jpg,スギ薬局南千里,3330,大阪,581,な,2019/8/28 20:49,2-1_all_corrected,91,54,316,27,407,81
208180,30072_20190828184340.jpg,関西スーパー京阪大和田１F,2000,大阪,334,て,2019/8/28 18:43,2-1_all_corrected,59,45,238,128,297,173
208384,30090_20190828191958.jpg,イトーヨーカドー木場 西棟,1108,千葉,334,る,2019/8/28 19:19,2-1_all_corrected,74,55,317,269,391,324
207738,30060_20190828165334.jpg,関西スーパー小野原,8832,大阪,503,ほ,2019/8/28 16:53,2-1_all_corrected,74,64,441,281,515,345
207364,30078_20190828144349.jpg,イオンスタイル仙台卸町店,9877,宮城,580,ほ,2019/8/28 14:43,2-1_all_corrected,75,56,266,194,341,250
208783,30072_20190828210931.jpg,関西スーパー京阪大和田１F,*123,大阪,591,さ,2019/8/28 21:09,2-1_all_corrected,69,64,210,208,279,272
206845,30145_20190828112327.jpg,イオン高根木戸,1887,堺,100,あ,2019/8/28 11:23,2-1_all_corrected,47,32,198,65,245,97
207193,30169_20190828135002.jpg,イオン相模原ショッピングセンター,3350,相模,331,す,2019/8/28 13:49,2-1_all_corrected,80,59,300,100,380,159
206829,30046_20190828111703.jpg,マミーマート船橋日大[地上],1043,習志野,331,そ,2019/8/28 11:16,2-1_all_corrected,56,43,267,102,323,145
207765,30111_20190828170130.jpg,イオン稲毛,1275,千葉,583,か,2019/8/28 17:00,2-1_all_corrected,54,43,325,171,379,214
208143,30167_20190828183849.jpg,イオン東雲店,***5,足立,14,ね,2019/8/28 18:38,2-1_all_corrected,36,29,394,76,430,105
207908,30144_20190828174150.jpg,イオン幕張,1516,千葉,532,そ,2019/8/28 17:41,2-1_all_corrected,91,70,382,342,473,412
208186,30144_20190828184441.jpg,イオン幕張,*117,千葉,337,た,2019/8/28 18:44,2-1_all_corrected,68,55,175,194,243,249
207753,30144_20190828165620.jpg,イオン幕張,*317,千葉,535,ぬ,2019/8/28 16:55,2-1_all_corrected,71,50,183,195,254,245
207083,30001_20190828130010.jpg,関西スーパー高石駅前,7788,和泉,556,む,2019/8/28 12:59,2-1_all_corrected,74,57,312,101,386,158
207084,30078_20190828130013.jpg,イオンスタイル仙台卸町店,5067,宮城,503,せ,2019/8/28 12:59,2-1_all_corrected,87,65,367,328,454,393
208497,30136_20190828194705.jpg,イオンスタイル新百合ヶ丘,9999,大宮,374,あ,2019/8/28 19:46,2-1_all_corrected,79,67,96,327,175,394
207619,30016_20190828161447.jpg,フィール上社,**22,名古屋,31,ほ,2019/8/28 16:14,2-1_all_corrected,69,53,463,287,532,340
207280,30076_20190828142524.jpg,ヤマダ電機なんば,*146,なにわ,100,ろ,2019/8/28 14:24,2-1_all_corrected,52,35,276,72,328,107
207046,30144_20190828124351.jpg,イオン幕張,*707,千葉,585,す,2019/8/28 12:43,2-1_all_corrected,70,52,270,257,340,309
208203,30169_20190828184621.jpg,イオン相模原ショッピングセンター,2797,大宮,502,の,2019/8/28 18:45,2-1_all_corrected,88,74,425,318,513,392
207041,30110_20190828124115.jpg,イオン金沢八景,*123,横浜,591,は,2019/8/28 12:40,2-1_all_corrected,50,38,410,147,460,185
208835,30094_20190828213627.jpg,西友熱田三番町店,5891,名古屋,503,す,2019/8/28 21:35,2-1_all_corrected,53,44,254,193,307,237
207273,30091_20190828142239.jpg,イトーヨーカドー木場 立体,1121,前橋,310,ゆ,2019/8/28 14:22,2-1_all_corrected,72,71,27,336,99,407
207816,30110_20190828171442.jpg,イオン金沢八景,3428,横浜,504,ほ,2019/8/28 17:14,2-1_all_corrected,70,61,183,235,253,296
208250,30144_20190828185537.jpg,イオン幕張,*716,千葉,337,た,2019/8/28 18:55,2-1_all_corrected,74,49,327,278,401,327
208091,30111_20190828182748.jpg,イオン稲毛,8021,千葉,509,せ,2019/8/28 18:27,2-1_all_corrected,49,34,415,82,464,116
207811,30045_20190828171310.jpg,マックスバリュー徳川明倫,8000,名古屋,30,せ,2019/8/28 17:12,2-1_all_corrected,51,44,191,144,242,188
208065,30111_20190828182250.jpg,イオン稲毛,1330,千葉,503,た,2019/8/28 18:21,2-1_all_corrected,47,34,100,114,147,148
208401,30006_20190828192226.jpg,スギ薬局南千里,*323,大阪,587,て,2019/8/28 19:22,2-1_all_corrected,92,65,205,88,297,153
208098,30111_20190828182951.jpg,イオン稲毛,*336,千葉,503,つ,2019/8/28 18:29,2-1_all_corrected,79,54,254,250,333,304
207216,30072_20190828135739.jpg,関西スーパー京阪大和田１F,***1,大阪,30,と,2019/8/28 13:57,2-1_all_corrected,49,35,388,232,437,267
208408,30063_20190828192417.jpg,コーナン相模原小山モール,7745,相模,301,そ,2019/8/28 19:23,2-1_all_corrected,65,61,501,134,566,195
207820,30169_20190828171616.jpg,イオン相模原ショッピングセンター,2865,相模,500,ふ,2019/8/28 17:15,2-1_all_corrected,68,56,301,141,369,197
206906,30167_20190828114906.jpg,イオン東雲店,4704,足立,481,り,2019/8/28 11:48,2-1_all_corrected,34,31,39,46,73,77
208292,30144_20190828190259.jpg,イオン幕張,8888,杉並,302,つ,2019/8/28 19:02,2-1_all_corrected,78,53,233,259,311,312
207681,30167_20190828163610.jpg,イオン東雲店,2426,足立,481,り,2019/8/28 16:35,2-1_all_corrected,56,47,300,200,356,247
208834,30110_20190828213609.jpg,イオン金沢八景,1111,横浜,333,つ,2019/8/28 21:35,2-1_all_corrected,76,71,20,208,96,279
207872,30169_20190828173159.jpg,イオン相模原ショッピングセンター,4585,相模,400,と,2019/8/28 17:31,2-1_all_corrected,54,39,127,100,181,139
206706,30137_20190828095521.jpg,イオンスタイル品川シーサイド,1011,品川,362,の,2019/8/28 9:54,2-1_all_corrected,94,69,383,336,477,405
207049,30111_20190828124452.jpg,イオン稲毛,1001,千葉,598,て,2019/8/28 12:44,2-1_all_corrected,55,43,183,151,238,194
208233,30111_20190828185224.jpg,イオン稲毛,9374,千葉,302,そ,2019/8/28 18:51,2-1_all_corrected,57,45,365,138,422,183
206907,30167_20190828114936.jpg,イオン東雲店,4704,足立,481,り,2019/8/28 11:49,2-1_all_corrected,80,67,84,361,164,428
207821,30169_20190828171702.jpg,イオン相模原ショッピングセンター,3747,多摩,301,の,2019/8/28 17:16,2-1_all_corrected,69,58,246,147,315,205
207025,30090_20190828123620.jpg,イトーヨーカドー木場 西棟,9636,足立,480,く,2019/8/28 12:35,2-1_all_corrected,53,35,270,146,323,181
206936,30145_20190828115918.jpg,イオン高根木戸,5755,静岡,100,あ,2019/8/28 11:58,2-1_all_corrected,36,26,252,93,288,119
208251,30045_20190828185539.jpg,マックスバリュー徳川明倫,*358,名古屋,32,ひ,2019/8/28 18:55,2-1_all_corrected,52,41,137,191,189,232
181810,30111_20190819090600.jpg,イオン稲毛,8564,千葉,330,せ,2019/8/19 9:05,2-1_all_corrected,69,55,319,161,388,216
183571,30078_20190819182120.jpg,イオンスタイル仙台卸町店,4457,仙台,583,あ,2019/8/19 18:20,2-1_all_corrected,66,58,135,99,201,157
181828,30072_20190819092253.jpg,関西スーパー京阪大和田１F,9147,大阪,503,ゆ,2019/8/19 9:22,2-1_all_corrected,100,82,1,319,101,401
182691,30144_20190819155034.jpg,イオン幕張,*881,千葉,530,ま,2019/8/19 15:50,2-1_all_corrected,54,31,212,148,266,179
182457,30167_20190819141345.jpg,イオン東雲店,4479,広島,300,む,2019/8/19 14:13,2-1_all_corrected,80,60,135,285,215,345
182801,30072_20190819161123.jpg,関西スーパー京阪大和田１F,5605,なにわ,580,ふ,2019/8/19 16:10,2-1_all_corrected,70,55,259,133,329,188
182459,30111_20190819141436.jpg,イオン稲毛,*125,千葉,339,や,2019/8/19 14:13,2-1_all_corrected,66,54,242,166,308,220
182466,30169_20190819142214.jpg,イオン相模原ショッピングセンター,*319,多摩,333,む,2019/8/19 14:21,2-1_all_corrected,84,76,382,274,466,350
182492,30144_20190819143244.jpg,イオン幕張,5116,千葉,330,は,2019/8/19 14:32,2-1_all_corrected,60,41,172,171,232,212
184355,30169_20190819214731.jpg,イオン相模原ショッピングセンター,*350,相模,337,は,2019/8/19 21:47,2-1_all_corrected,91,79,100,329,191,408
183721,30144_20190819184911.jpg,イオン幕張,7879,千葉,302,せ,2019/8/19 18:48,2-1_all_corrected,77,54,184,253,261,307
182435,30144_20190819140551.jpg,イオン幕張,5458,千葉,503,そ,2019/8/19 14:05,2-1_all_corrected,57,38,296,224,353,262
181881,30167_20190819095718.jpg,イオン東雲店,3740,足立,503,わ,2019/8/19 9:56,2-1_all_corrected,38,30,13,0,51,30
183373,30144_20190819175037.jpg,イオン幕張,9093,袖ヶ浦,300,ひ,2019/8/19 17:50,2-1_all_corrected,68,49,251,188,319,237
183387,30167_20190819175137.jpg,イオン東雲店,**21,大宮,431,て,2019/8/19 17:51,2-1_all_corrected,53,44,279,181,332,225
184169,30111_20190819205627.jpg,イオン稲毛,**26,千葉,549,て,2019/8/19 20:55,2-1_all_corrected,49,36,386,102,435,138
182058,30006_20190819113427.jpg,スギ薬局南千里,1865,大阪,503,さ,2019/8/19 11:34,2-1_all_corrected,92,58,334,37,426,95
183945,30060_20190819194429.jpg,関西スーパー小野原,9999,大阪,31,り,2019/8/19 19:44,2-1_all_corrected,87,89,508,302,595,391
181827,30111_20190819092251.jpg,イオン稲毛,1020,千葉,483,む,2019/8/19 9:22,2-1_all_corrected,53,44,164,158,217,202
182493,30144_20190819143321.jpg,イオン幕張,***7,野田,586,を,2019/8/19 14:33,2-1_all_corrected,44,33,150,108,194,141
182003,30111_20190819111327.jpg,イオン稲毛,1020,千葉,351,た,2019/8/19 11:12,2-1_all_corrected,69,55,352,153,421,208
181820,30111_20190819091732.jpg,イオン稲毛,1020,千葉,587,ゆ,2019/8/19 9:16,2-1_all_corrected,69,59,253,167,322,226
182699,30169_20190819155637.jpg,イオン相模原ショッピングセンター,5883,相模,50,む,2019/8/19 15:56,2-1_all_corrected,99,77,313,355,412,432
183928,30111_20190819194026.jpg,イオン稲毛,6756,千葉,583,ゆ,2019/8/19 19:39,2-1_all_corrected,51,38,372,103,423,141
183742,30157_20190819185255.jpg,関西スーパー中央,*333,神戸,330,あ,2019/8/19 18:52,2-1_all_corrected,41,38,207,142,248,180
182402,30111_20190819135528.jpg,イオン稲毛,8170,千葉,300,も,2019/8/19 13:54,2-1_all_corrected,53,45,278,146,331,191
183149,30111_20190819171549.jpg,イオン稲毛,5008,千葉,331,た,2019/8/19 17:15,2-1_all_corrected,55,47,219,165,274,212
183171,30111_20190819171853.jpg,イオン稲毛,*418,千葉,334,ほ,2019/8/19 17:18,2-1_all_corrected,69,52,368,142,437,194
183727,30103_20190819184930.jpg,八尾老原１丁目,8888,大阪,30,そ,2019/8/19 18:49,2-1_all_corrected,54,47,187,141,241,188
183388,30111_20190819175154.jpg,イオン稲毛,4159,千葉,581,て,2019/8/19 17:51,2-1_all_corrected,54,43,343,118,397,161
183807,30091_20190819190735.jpg,イトーヨーカドー木場 立体,3981,群馬,302,す,2019/8/19 17:10,2-1_all_corrected,52,41,337,125,389,166
183652,30167_20190819183658.jpg,イオン東雲店,*288,足立,302,せ,2019/8/19 18:36,2-1_all_corrected,68,57,454,360,522,417
183831,30144_20190819191243.jpg,イオン幕張,***1,千葉,30,ら,2019/8/19 19:12,2-1_all_corrected,69,52,112,212,181,264
183032,30167_20190819165319.jpg,イオン東雲店,*410,千葉,430,つ,2019/8/19 16:52,2-1_all_corrected,75,54,235,233,310,287
181937,30006_20190819103841.jpg,スギ薬局南千里,7513,大阪,501,や,2019/8/19 10:38,2-1_all_corrected,138,120,99,107,237,227
183207,30043_20190819172330.jpg,ファインシティ東松戸,*828,野田,333,す,2019/8/19 17:23,2-1_all_corrected,71,64,37,369,108,433
183663,30072_20190819183830.jpg,関西スーパー京阪大和田１F,**44,大阪,330,い,2019/8/19 18:38,2-1_all_corrected,74,61,5,236,79,297
184071,30167_20190819203307.jpg,イオン東雲店,7000,足立,325,ま,2019/8/19 20:32,2-1_all_corrected,89,66,166,345,255,411
184288,30167_20190819212503.jpg,イオン東雲店,*220,足立,302,の,2019/8/19 21:24,2-1_all_corrected,51,39,340,138,391,177
183206,30172_20190819172318.jpg,ピットデザインすわの町,*102,久留米,430,す,2019/8/19 17:22,2-1_all_corrected,71,53,237,177,308,230
184023,30098_20190819201842.jpg,BRANCH仙台（東棟）,*211,仙台,333,ぬ,2019/8/19 20:18,2-1_all_corrected,101,71,200,307,301,378
183662,30144_20190819183826.jpg,イオン幕張,2877,千葉,503,そ,2019/8/19 18:37,2-1_all_corrected,70,51,296,217,366,268
183696,30063_20190819184547.jpg,コーナン相模原小山モール,8647,相模,301,つ,2019/8/19 18:45,2-1_all_corrected,64,59,465,121,529,180
182788,30072_20190819161003.jpg,関西スーパー京阪大和田１F,6669,大阪,503,ひ,2019/8/19 16:08,2-1_all_corrected,101,63,21,387,122,450
183806,30091_20190819190719.jpg,イトーヨーカドー木場 立体,*151,川崎,80,り,2019/8/19 17:06,2-1_all_corrected,41,38,351,95,392,133
183461,30144_20190819180756.jpg,イオン幕張,1826,習志野,530,に,2019/8/19 18:07,2-1_all_corrected,86,61,261,314,347,375
182721,30072_20190819160310.jpg,関西スーパー京阪大和田１F,1117,大阪,538,の,2019/8/19 16:01,2-1_all_corrected,96,82,57,317,153,399
181953,30167_20190819105137.jpg,イオン東雲店,*461,足立,580,ち,2019/8/19 10:51,2-1_all_corrected,50,40,285,161,335,201
183638,30062_20190819183531.jpg,ミスミモール,***3,神戸,30,ほ,2019/8/19 18:34,2-1_all_corrected,55,41,361,97,416,138
183255,30072_20190819173059.jpg,関西スーパー京阪大和田１F,3225,大阪,581,さ,2019/8/19 17:30,2-1_all_corrected,55,40,52,178,107,218
182380,30167_20190819134526.jpg,イオン東雲店,6702,横浜,304,ま,2019/8/19 13:45,2-1_all_corrected,81,62,156,257,237,319
182146,30138_20190819120747.jpg,イオンスタイル湘南茅ヶ崎,6129,多摩,400,に,2019/8/19 12:07,2-1_all_corrected,59,41,215,140,274,181
183094,30169_20190819170741.jpg,イオン相模原ショッピングセンター,5750,相模,400,て,2019/8/19 17:07,2-1_all_corrected,60,44,141,178,201,222
182369,30157_20190819134250.jpg,関西スーパー中央,*809,神戸,333,ほ,2019/8/19 13:42,2-1_all_corrected,65,42,173,408,238,450
183614,30144_20190819182847.jpg,イオン幕張,8846,千葉,581,さ,2019/8/19 18:28,2-1_all_corrected,85,62,332,382,417,444
182356,30167_20190819133849.jpg,イオン東雲店,4260,品川,502,さ,2019/8/19 13:38,2-1_all_corrected,35,30,24,32,59,62
182507,30111_20190819143743.jpg,イオン稲毛,1186,千葉,332,す,2019/8/19 14:36,2-1_all_corrected,71,50,354,146,425,196
183879,30111_20190819192610.jpg,イオン稲毛,6134,千葉,480,そ,2019/8/19 19:25,2-1_all_corrected,70,54,409,261,479,315
184052,30169_20190819202908.jpg,イオン相模原ショッピングセンター,7066,相模,580,ま,2019/8/19 20:28,2-1_all_corrected,85,74,135,242,220,316
183277,30060_20190819173352.jpg,関西スーパー小野原,8520,大阪,330,す,2019/8/19 17:33,2-1_all_corrected,78,57,372,375,450,432
181985,30060_20190819110532.jpg,関西スーパー小野原,2579,大阪,580,ぬ,2019/8/19 11:05,2-1_all_corrected,68,64,487,224,555,288
183428,30072_20190819180039.jpg,関西スーパー京阪大和田１F,2248,大阪,302,ゆ,2019/8/19 18:00,2-1_all_corrected,75,51,121,135,196,186
183625,30072_20190819183141.jpg,関西スーパー京阪大和田１F,5834,大阪,480,ち,2019/8/19 18:31,2-1_all_corrected,44,34,343,66,387,100
183417,30078_20190819175826.jpg,イオンスタイル仙台卸町店,8609,宮城,301,ゆ,2019/8/19 17:58,2-1_all_corrected,66,55,170,78,236,133
182199,30111_20190819123639.jpg,イオン稲毛,4450,千葉,500,つ,2019/8/19 12:35,2-1_all_corrected,44,36,106,90,150,126
183883,30167_20190819192658.jpg,イオン東雲店,7000,福島,325,あ,2019/8/19 19:26,2-1_all_corrected,38,32,434,67,472,99
183410,30066_20190819175622.jpg,ジョーシン和泉中央,1000,和泉,30,み,2019/8/19 17:56,2-1_all_corrected,69,57,214,204,283,261
184097,30169_20190819203744.jpg,イオン相模原ショッピングセンター,5953,多摩,502,ら,2019/8/19 20:37,2-1_all_corrected,75,64,375,270,450,334
184202,30169_20190819210707.jpg,イオン相模原ショッピングセンター,8248,相模,580,ひ,2019/8/19 21:06,2-1_all_corrected,76,58,212,168,288,226
182761,30073_20190819160738.jpg,関西スーパー京阪大和田２F,8922,大阪,503,ほ,2019/8/19 16:07,2-1_all_corrected,81,65,390,273,471,338
183247,30110_20190819172947.jpg,イオン金沢八景,8815,横浜,530,り,2019/8/19 17:29,2-1_all_corrected,81,69,224,238,305,307
181948,30060_20190819104709.jpg,関西スーパー小野原,*974,大阪,880,あ,2019/8/19 10:46,2-1_all_corrected,71,54,282,284,353,338
183885,30144_20190819192713.jpg,イオン幕張,*615,千葉,537,の,2019/8/19 19:26,2-1_all_corrected,84,60,173,266,257,326
182357,30167_20190819133909.jpg,イオン東雲店,4260,品川,502,さ,2019/8/19 13:38,2-1_all_corrected,95,76,65,366,160,442
182501,30045_20190819143524.jpg,マックスバリュー徳川明倫,***1,名古屋,30,つ,2019/8/19 14:34,2-1_all_corrected,55,47,263,229,318,276
183487,30101_20190819181039.jpg,にしてつストアレガネット姪浜,**55,福岡,31,ね,2019/8/19 18:10,2-1_all_corrected,70,52,175,260,245,312
183646,30078_20190819183618.jpg,イオンスタイル仙台卸町店,5150,宮城,532,ね,2019/8/19 18:35,2-1_all_corrected,93,61,342,381,435,442
182760,30072_20190819160725.jpg,関西スーパー京阪大和田１F,9725,大阪,503,み,2019/8/19 16:06,2-1_all_corrected,68,53,245,92,313,145
181912,30041_20190819102559.jpg,ライフ宮内,1172,久留米,580,ふ,2019/8/19 10:25,2-1_all_corrected,74,60,461,354,535,414
183813,30091_20190819190908.jpg,イトーヨーカドー木場 立体,**88,品川,321,る,2019/8/19 17:40,2-1_all_corrected,52,45,192,152,244,197
181778,30157_20190819083340.jpg,関西スーパー中央,***7,神戸,30,や,2019/8/19 8:33,2-1_all_corrected,40,46,93,192,133,238
183684,30144_20190819184250.jpg,イオン幕張,8084,袖ヶ浦,483,い,2019/8/19 18:42,2-1_all_corrected,69,52,352,188,421,240
183683,30072_20190819184229.jpg,関西スーパー京阪大和田１F,6187,大阪,580,ち,2019/8/19 18:41,2-1_all_corrected,67,51,200,228,267,279
181851,30111_20190819094428.jpg,イオン稲毛,*358,千葉,592,な,2019/8/19 9:43,2-1_all_corrected,54,44,349,144,403,188
184376,30169_20190819215948.jpg,イオン相模原ショッピングセンター,*750,相模,50,ま,2019/8/19 21:59,2-1_all_corrected,84,70,174,196,258,266
182623,30145_20190819151349.jpg,イオン高根木戸,8643,習志野,400,さ,2019/8/19 15:13,2-1_all_corrected,50,36,354,179,404,215
184188,30169_20190819210305.jpg,イオン相模原ショッピングセンター,1717,多摩,585,さ,2019/8/19 21:02,2-1_all_corrected,74,58,260,111,334,169
183392,30144_20190819175246.jpg,イオン幕張,1216,習志野,338,み,2019/8/19 17:52,2-1_all_corrected,72,54,250,223,322,277
183995,30111_20190819200438.jpg,イオン稲毛,6703,高崎,580,く,2019/8/19 20:04,2-1_all_corrected,56,44,178,158,234,202
184378,30169_20190819220116.jpg,イオン相模原ショッピングセンター,2412,多摩,580,ほ,2019/8/19 22:00,2-1_all_corrected,95,76,185,220,280,296
181867,30006_20190819095152.jpg,スギ薬局南千里,*990,大阪,330,ほ,2019/8/19 9:51,2-1_all_corrected,83,53,399,3,482,56
183733,30144_20190819185113.jpg,イオン幕張,*902,袖ヶ浦,530,ぬ,2019/8/19 18:50,2-1_all_corrected,56,44,206,110,262,154
182615,30167_20190819151105.jpg,イオン東雲店,1203,足立,530,あ,2019/8/19 15:10,2-1_all_corrected,69,55,259,201,328,256
183555,30078_20190819181910.jpg,イオンスタイル仙台卸町店,7176,練馬,330,せ,2019/8/19 18:18,2-1_all_corrected,83,61,410,325,493,386
183932,30110_20190819194051.jpg,イオン金沢八景,*501,横浜,352,か,2019/8/19 19:40,2-1_all_corrected,70,55,398,94,468,149
183590,30144_20190819182422.jpg,イオン幕張,2410,千葉,330,む,2019/8/19 18:23,2-1_all_corrected,72,56,246,223,318,279
183756,30167_20190819185719.jpg,イオン東雲店,3050,足立,503,の,2019/8/19 18:56,2-1_all_corrected,35,29,411,73,446,102
183597,30144_20190819182516.jpg,イオン幕張,5124,千葉,531,す,2019/8/19 18:24,2-1_all_corrected,78,56,229,238,307,294
182648,30111_20190819152801.jpg,イオン稲毛,1158,練馬,530,に,2019/8/19 15:26,2-1_all_corrected,55,43,176,132,231,175
183732,30169_20190819185040.jpg,イオン相模原ショッピングセンター,9009,相模,334,ら,2019/8/19 18:50,2-1_all_corrected,99,78,167,340,266,418
183960,30169_20190819195042.jpg,イオン相模原ショッピングセンター,5161,相模,301,ね,2019/8/19 19:50,2-1_all_corrected,84,64,369,259,453,323
184180,30169_20190819210111.jpg,イオン相模原ショッピングセンター,3712,相模,583,え,2019/8/19 21:00,2-1_all_corrected,90,75,137,241,227,316
182613,30167_20190819151035.jpg,イオン東雲店,1203,足立,530,あ,2019/8/19 15:10,2-1_all_corrected,41,34,7,3,48,37
183536,30111_20190819181613.jpg,イオン稲毛,*316,千葉,341,せ,2019/8/19 18:15,2-1_all_corrected,54,41,177,132,231,173
182444,30111_20190819141004.jpg,イオン稲毛,3927,習志野,530,ね,2019/8/19 14:09,2-1_all_corrected,55,42,394,133,449,175
183750,30063_20190819185556.jpg,コーナン相模原小山モール,6345,相模,501,み,2019/8/19 18:55,2-1_all_corrected,84,67,52,300,136,367
183757,30110_20190819185731.jpg,イオン金沢八景,1001,横浜,31,の,2019/8/19 18:57,2-1_all_corrected,77,67,440,170,517,237
182685,30144_20190819154832.jpg,イオン幕張,3517,足立,331,ふ,2019/8/19 15:48,2-1_all_corrected,75,53,266,242,341,295
182671,30060_20190819154146.jpg,関西スーパー小野原,3406,大阪,480,な,2019/8/19 15:41,2-1_all_corrected,87,63,409,387,496,450
182018,30169_20190819111940.jpg,イオン相模原ショッピングセンター,5698,相模,301,ま,2019/8/19 11:19,2-1_all_corrected,54,47,25,296,79,343
183934,30110_20190819194102.jpg,イオン金沢八景,*501,横浜,352,ゆ,2019/8/19 19:40,2-1_all_corrected,68,63,16,174,84,237
183933,30110_20190819194057.jpg,イオン金沢八景,*501,横浜,352,う,2019/8/19 19:40,2-1_all_corrected,67,63,5,181,72,244
183346,30144_20190819174652.jpg,イオン幕張,1737,千葉,331,す,2019/8/19 17:46,2-1_all_corrected,89,65,322,334,411,399
183948,30046_20190819194641.jpg,マミーマート船橋日大[地上],*473,習志野,580,き,2019/8/19 19:45,2-1_all_corrected,72,52,352,224,424,276
181882,30167_20190819095755.jpg,イオン東雲店,3740,足立,503,わ,2019/8/19 9:57,2-1_all_corrected,74,57,274,216,348,273
183946,30169_20190819194606.jpg,イオン相模原ショッピングセンター,3110,多摩,566,け,2019/8/19 19:45,2-1_all_corrected,52,39,133,104,185,143
181847,30157_20190819093753.jpg,関西スーパー中央,***7,神戸,30,や,2019/8/19 9:37,2-1_all_corrected,55,42,218,292,273,334
183142,30070_20190819171440.jpg,カナートモール住道第一,***8,大阪,30,ま,2019/8/19 17:14,2-1_all_corrected,61,43,239,154,300,197
183526,30074_20190819181516.jpg,マックスバリュ北1条東,1434,札幌,500,う,2019/8/19 18:14,2-1_all_corrected,50,45,211,102,261,147
183384,30167_20190819175127.jpg,イオン東雲店,5486,春日部,501,ほ,2019/8/19 17:51,2-1_all_corrected,87,66,67,344,154,410
182858,30078_20190819161749.jpg,イオンスタイル仙台卸町店,*405,習志野,534,す,2019/8/19 16:17,2-1_all_corrected,68,56,327,152,395,208
183941,30111_20190819194323.jpg,イオン稲毛,6760,千葉,304,め,2019/8/19 19:42,2-1_all_corrected,51,38,402,101,453,139
183189,30151_20190819172124.jpg,テックランド今福東店,*679,なにわ,580,み,2019/8/19 17:20,2-1_all_corrected,63,44,197,149,260,193
183324,30111_20190819174219.jpg,イオン稲毛,*117,千葉,359,ら,2019/8/19 17:41,2-1_all_corrected,53,41,390,124,443,165
182454,30078_20190819141314.jpg,イオンスタイル仙台卸町店,4769,仙台,480,り,2019/8/19 14:12,2-1_all_corrected,55,43,298,139,353,182
182202,30111_20190819123715.jpg,イオン稲毛,4726,柏,580,こ,2019/8/19 12:36,2-1_all_corrected,71,58,279,170,350,228
182205,30167_20190819123847.jpg,イオン東雲店,8610,足立,300,あ,2019/8/19 12:38,2-1_all_corrected,49,37,332,147,381,184
182453,30167_20190819141305.jpg,イオン東雲店,4479,広島,300,む,2019/8/19 14:12,2-1_all_corrected,36,35,14,48,50,83
183118,30110_20190819171124.jpg,イオン金沢八景,9608,横浜,505,と,2019/8/19 17:10,2-1_all_corrected,67,55,120,169,187,224
182465,30045_20190819142104.jpg,マックスバリュー徳川明倫,**18,名古屋,31,ひ,2019/8/19 14:20,2-1_all_corrected,47,34,359,111,406,145
183776,30169_20190819190119.jpg,イオン相模原ショッピングセンター,1863,相模,590,て,2019/8/19 19:00,2-1_all_corrected,64,54,142,135,206,189
182401,30060_20190819135522.jpg,関西スーパー小野原,1112,大阪,340,つ,2019/8/19 13:55,2-1_all_corrected,93,73,349,322,442,395
184392,30169_20190819220900.jpg,イオン相模原ショッピングセンター,3109,大宮,583,か,2019/8/19 22:08,2-1_all_corrected,87,73,448,370,535,443
184361,30105_20190819214916.jpg,カスミフードスクエア春日部武里,**39,春日部,334,ほ,2019/8/19 21:48,2-1_all_corrected,71,66,113,277,184,343
182406,30078_20190819135702.jpg,イオンスタイル仙台卸町店,4403,宮城,580,け,2019/8/19 13:56,2-1_all_corrected,99,69,132,380,231,449
181846,30060_20190819093752.jpg,関西スーパー小野原,***7,大阪,536,は,2019/8/19 9:37,2-1_all_corrected,69,73,521,321,590,394
182605,30169_20190819150844.jpg,イオン相模原ショッピングセンター,***8,湘南,522,に,2019/8/19 15:08,2-1_all_corrected,64,58,303,154,367,212
182295,30039_20190819131550.jpg,イトーヨーカドー大井町,***1,品川,30,な,2019/8/19 13:15,2-1_all_corrected,67,61,156,186,223,247
183922,30023_20190819193827.jpg,ピットデザイン山科東野,7777,京都,522,み,2019/8/19 19:38,2-1_all_corrected,83,64,352,97,435,161
183748,30144_20190819185501.jpg,イオン幕張,2552,千葉,503,つ,2019/8/19 18:54,2-1_all_corrected,44,47,57,198,101,245
182463,30078_20190819141944.jpg,イオンスタイル仙台卸町店,8612,秋田,501,ひ,2019/8/19 14:19,2-1_all_corrected,58,45,274,70,332,115
183925,30079_20190819193910.jpg,ピットデザイン仙台卸町駅前駐車場,*333,仙台,531,は,2019/8/19 19:38,2-1_all_corrected,71,54,167,188,238,242
184131,30169_20190819204428.jpg,イオン相模原ショッピングセンター,***5,相模,580,ひ,2019/8/19 20:43,2-1_all_corrected,83,64,289,279,372,343
182464,30078_20190819142027.jpg,イオンスタイル仙台卸町店,6757,宮城,300,ろ,2019/8/19 14:20,2-1_all_corrected,52,46,212,8,264,54
181812,30111_20190819090800.jpg,イオン稲毛,1020,千葉,588,き,2019/8/19 9:07,2-1_all_corrected,56,44,345,140,401,184
183741,30091_20190819185237.jpg,イトーヨーカドー木場 立体,7777,神戸,361,ゆ,2019/8/19 18:52,2-1_all_corrected,89,65,441,235,530,300
183268,30072_20190819173234.jpg,関西スーパー京阪大和田１F,1010,大阪,591,き,2019/8/19 17:32,2-1_all_corrected,80,63,12,167,92,230
181993,30167_20190819110810.jpg,イオン東雲店,*363,足立,481,り,2019/8/19 11:07,2-1_all_corrected,48,40,239,160,287,200
183892,30022_20190819192811.jpg,業務スーパー平野駅前,***3,なにわ,30,ぬ,2019/8/19 19:27,2-1_all_corrected,71,56,237,67,308,123
182940,30144_20190819162731.jpg,イオン幕張,*175,千葉,532,つ,2019/8/19 16:27,2-1_all_corrected,54,40,154,120,208,160
182144,30078_20190819120614.jpg,イオンスタイル仙台卸町店,6017,仙台,480,り,2019/8/19 12:05,2-1_all_corrected,46,45,144,97,190,142
182172,30144_20190819121846.jpg,イオン幕張,*207,千葉,337,そ,2019/8/19 12:18,2-1_all_corrected,85,60,345,353,430,413
183857,30060_20190819191941.jpg,関西スーパー小野原,9999,大阪,31,り,2019/8/19 19:19,2-1_all_corrected,87,65,473,281,560,346
183053,30157_20190819165805.jpg,関西スーパー中央,4984,神戸,581,ま,2019/8/19 16:57,2-1_all_corrected,56,43,163,369,219,412
182982,30111_20190819163535.jpg,イオン稲毛,*102,千葉,337,な,2019/8/19 16:35,2-1_all_corrected,76,58,274,206,350,264
182126,30039_20190819120023.jpg,イトーヨーカドー大井町,2431,品川,583,う,2019/8/19 11:59,2-1_all_corrected,71,56,261,189,332,245
183036,30072_20190819165611.jpg,関西スーパー京阪大和田１F,5779,大阪,581,ね,2019/8/19 16:55,2-1_all_corrected,50,38,352,66,402,104
181933,30073_20190819103609.jpg,関西スーパー京阪大和田２F,5137,大阪,102,あ,2019/8/19 10:35,2-1_all_corrected,49,44,289,109,338,153
182722,30072_20190819160314.jpg,関西スーパー京阪大和田１F,1117,大阪,538,の,2019/8/19 16:02,2-1_all_corrected,69,54,278,123,347,177
182174,30072_20190819121932.jpg,関西スーパー京阪大和田１F,*701,神戸,830,か,2019/8/19 12:19,2-1_all_corrected,51,42,38,109,89,151
183294,30169_20190819173719.jpg,イオン相模原ショッピングセンター,5750,相模,400,て,2019/8/19 17:36,2-1_all_corrected,51,38,127,107,178,145
183409,30073_20190819175622.jpg,関西スーパー京阪大和田２F,3980,大阪,51,い,2019/8/19 17:56,2-1_all_corrected,77,55,357,218,434,273
183856,30072_20190819191928.jpg,関西スーパー京阪大和田１F,5689,大阪,503,も,2019/8/19 19:19,2-1_all_corrected,40,30,374,46,414,76
183635,30046_20190819183500.jpg,マミーマート船橋日大[地上],*220,習志野,339,ひ,2019/8/19 18:34,2-1_all_corrected,69,55,360,118,429,173
182526,30090_20190819144509.jpg,イトーヨーカドー木場 西棟,8903,品川,300,あ,2019/8/19 14:44,2-1_all_corrected,88,57,374,393,462,450
182519,30110_20190819144250.jpg,イオン金沢八景,9510,横浜,581,え,2019/8/19 14:42,2-1_all_corrected,56,44,481,204,537,248
184428,30168_20190819223832.jpg,イオン東雲店（屋上）,5480,習志野,580,ぬ,2019/8/19 22:38,2-1_all_corrected,72,57,297,86,369,143
183833,30111_20190819191339.jpg,イオン稲毛,7183,千葉,330,う,2019/8/19 19:13,2-1_all_corrected,71,52,384,225,455,277
184027,30169_20190819202035.jpg,イオン相模原ショッピングセンター,**97,多摩,302,ま,2019/8/19 20:20,2-1_all_corrected,84,58,255,133,339,191
184215,30169_20190819211159.jpg,イオン相模原ショッピングセンター,5092,相模,580,ゆ,2019/8/19 21:11,2-1_all_corrected,75,62,186,142,261,204
181935,30072_20190819103756.jpg,関西スーパー京阪大和田１F,8126,大阪,580,ほ,2019/8/19 10:37,2-1_all_corrected,66,55,38,95,104,150
183834,30091_20190819191401.jpg,イトーヨーカドー木場 立体,9215,つくば,330,と,2019/8/19 18:46,2-1_all_corrected,51,41,279,134,330,175
183008,30111_20190819164629.jpg,イオン稲毛,3605,袖ヶ浦,100,さ,2019/8/19 16:45,2-1_all_corrected,56,44,257,160,313,204
183498,30046_20190819181212.jpg,マミーマート船橋日大[地上],7080,習志野,330,た,2019/8/19 18:11,2-1_all_corrected,83,68,481,198,564,266
182747,30144_20190819160604.jpg,イオン幕張,5458,千葉,503,そ,2019/8/19 16:05,2-1_all_corrected,53,37,351,208,404,245
183695,30144_20190819184445.jpg,イオン幕張,3686,千葉,500,も,2019/8/19 18:44,2-1_all_corrected,61,44,283,194,344,238
181903,30167_20190819101618.jpg,イオン東雲店,7411,足立,230,さ,2019/8/19 10:15,2-1_all_corrected,55,38,264,285,319,323
184011,30057_20190819201406.jpg,ライフ東府中,***6,多摩,586,ま,2019/8/19 20:13,2-1_all_corrected,71,55,371,254,442,309
183462,30072_20190819180759.jpg,関西スーパー京阪大和田１F,8816,大阪,480,れ,2019/8/19 18:07,2-1_all_corrected,50,34,346,48,396,82
183672,30111_20190819184108.jpg,イオン稲毛,*526,姫路,332,と,2019/8/19 18:40,2-1_all_corrected,68,55,314,170,382,225
183024,30168_20190819165053.jpg,イオン東雲店（屋上）,*107,足立,338,ぬ,2019/8/19 16:50,2-1_all_corrected,76,56,394,117,470,173
182753,30073_20190819160637.jpg,関西スーパー京阪大和田２F,8922,大阪,503,ほ,2019/8/19 16:06,2-1_all_corrected,37,35,516,84,553,119
181761,30167_20190819080126.jpg,イオン東雲店,9777,足立,230,さ,2019/8/19 8:01,2-1_all_corrected,56,41,266,288,322,329
181917,30062_20190819102958.jpg,ミスミモール,**18,神戸,31,ふ,2019/8/19 10:29,2-1_all_corrected,54,44,381,135,435,179
184208,30001_20190819210827.jpg,関西スーパー高石駅前,*666,和泉,431,む,2019/8/19 21:08,2-1_all_corrected,94,72,309,308,403,380
182193,30144_20190819123235.jpg,イオン幕張,6882,千葉,502,ふ,2019/8/19 12:32,2-1_all_corrected,58,43,198,158,256,201
183273,30157_20190819173330.jpg,関西スーパー中央,5787,神戸,581,の,2019/8/19 17:33,2-1_all_corrected,53,45,105,348,158,393
183874,30159_20190819192454.jpg,イオン臼井,4708,千葉,502,と,2019/8/19 19:24,2-1_all_corrected,55,43,256,193,311,236
183880,30079_20190819192626.jpg,ピットデザイン仙台卸町駅前駐車場,6066,宮城,300,う,2019/8/19 19:26,2-1_all_corrected,37,31,383,103,420,134
182999,30045_20190819164352.jpg,マックスバリュー徳川明倫,8000,名古屋,30,せ,2019/8/19 16:43,2-1_all_corrected,63,65,44,264,107,329
183083,30078_20190819170418.jpg,イオンスタイル仙台卸町店,2078,宮城,501,わ,2019/8/19 17:03,2-1_all_corrected,70,51,262,104,332,155
182151,30091_20190819120811.jpg,イトーヨーカドー木場 立体,*254,品川,302,は,2019/8/19 12:07,2-1_all_corrected,69,55,158,213,227,268
183626,30144_20190819183147.jpg,イオン幕張,*418,千葉,580,も,2019/8/19 18:31,2-1_all_corrected,54,42,178,156,232,198
184236,30169_20190819211647.jpg,イオン相模原ショッピングセンター,7787,相模,530,つ,2019/8/19 21:16,2-1_all_corrected,51,46,173,108,224,154
182132,30090_20190819120249.jpg,イトーヨーカドー木場 西棟,*822,足立,338,み,2019/8/19 12:02,2-1_all_corrected,53,41,281,174,334,215
183828,30104_20190819191211.jpg,カスミフードスクエア咲が丘,1430,習志野,300,ろ,2019/8/19 19:11,2-1_all_corrected,72,57,231,189,303,246
182931,30091_20190819162647.jpg,イトーヨーカドー木場 立体,5885,足立,331,さ,2019/8/19 16:26,2-1_all_corrected,43,40,261,38,304,78
183479,30078_20190819181009.jpg,イオンスタイル仙台卸町店,3356,仙台,500,あ,2019/8/19 18:09,2-1_all_corrected,72,56,158,135,230,191
183819,30111_20190819190955.jpg,イオン稲毛,1112,千葉,544,か,2019/8/19 19:08,2-1_all_corrected,43,35,72,98,115,133
184254,30169_20190819211827.jpg,イオン相模原ショッピングセンター,1110,春日部,536,い,2019/8/19 21:17,2-1_all_corrected,67,53,125,147,192,200
181974,30045_20190819105755.jpg,マックスバリュー徳川明倫,8008,名古屋,31,は,2019/8/19 10:57,2-1_all_corrected,44,35,344,97,388,132
183875,30072_20190819192459.jpg,関西スーパー京阪大和田１F,***1,大阪,30,と,2019/8/19 19:24,2-1_all_corrected,70,56,275,314,345,370
183076,30139_20190819170253.jpg,イオン板橋ショッピングセンター,***1,練馬,30,ね,2019/8/19 17:02,2-1_all_corrected,56,43,301,187,357,230
181989,30110_20190819110611.jpg,イオン金沢八景,2645,横浜,580,ほ,2019/8/19 11:05,2-1_all_corrected,53,42,141,108,194,150
184262,30169_20190819211943.jpg,イオン相模原ショッピングセンター,8980,横浜,504,め,2019/8/19 21:19,2-1_all_corrected,85,71,456,315,541,386
182353,30167_20190819133702.jpg,イオン東雲店,6753,足立,530,い,2019/8/19 13:36,2-1_all_corrected,74,59,227,230,301,289
181837,30045_20190819092647.jpg,マックスバリュー徳川明倫,**33,名古屋,31,み,2019/8/19 9:26,2-1_all_corrected,74,63,58,219,132,282
182817,30091_20190819161322.jpg,イトーヨーカドー木場 立体,5040,足立,530,な,2019/8/19 16:13,2-1_all_corrected,53,41,247,36,300,77
183954,30072_20190819194832.jpg,関西スーパー京阪大和田１F,***1,大阪,30,と,2019/8/19 19:48,2-1_all_corrected,55,41,375,218,430,259
182049,30110_20190819113122.jpg,イオン金沢八景,1102,横浜,548,の,2019/8/19 11:30,2-1_all_corrected,56,46,312,99,368,145
184147,30105_20190819204906.jpg,カスミフードスクエア春日部武里,**11,春日部,550,る,2019/8/19 20:48,2-1_all_corrected,48,36,215,159,263,195
183998,30144_20190819200601.jpg,イオン幕張,*686,品川,302,ひ,2019/8/19 20:05,2-1_all_corrected,70,51,262,214,332,265
184343,30090_20190819214410.jpg,イトーヨーカドー木場 西棟,8918,足立,501,の,2019/8/19 21:43,2-1_all_corrected,88,62,123,339,211,401
184171,30169_20190819205738.jpg,イオン相模原ショッピングセンター,8224,相模,580,の,2019/8/19 20:57,2-1_all_corrected,89,64,143,65,232,129
182844,30110_20190819161559.jpg,イオン金沢八景,1918,横浜,580,た,2019/8/19 16:15,2-1_all_corrected,54,42,350,159,404,201
183398,30078_20190819175402.jpg,イオンスタイル仙台卸町店,1230,仙台,333,す,2019/8/19 17:53,2-1_all_corrected,66,62,183,116,249,178
184182,30167_20190819210142.jpg,イオン東雲店,9918,足立,502,と,2019/8/19 21:01,2-1_all_corrected,54,42,346,287,400,329
182423,30144_20190819140420.jpg,イオン幕張,3026,千葉,530,ま,2019/8/19 14:04,2-1_all_corrected,52,38,116,101,168,139
182440,30066_20190819140738.jpg,ジョーシン和泉中央,*111,神戸,30,も,2019/8/19 14:07,2-1_all_corrected,74,51,248,239,322,290
183301,30078_20190819173838.jpg,イオンスタイル仙台卸町店,2370,仙台,500,な,2019/8/19 17:38,2-1_all_corrected,80,64,154,196,234,260
182218,30076_20190819124737.jpg,ヤマダ電機なんば,4252,堺,300,た,2019/8/19 12:47,2-1_all_corrected,77,57,312,216,389,273
184177,30169_20190819210051.jpg,イオン相模原ショッピングセンター,*403,相模,331,ま,2019/8/19 21:00,2-1_all_corrected,52,40,142,99,194,139
184170,30144_20190819205713.jpg,イオン幕張,1312,習志野,331,ね,2019/8/19 20:56,2-1_all_corrected,55,39,262,120,317,159
184342,30169_20190819214352.jpg,イオン相模原ショッピングセンター,2119,相模,580,と,2019/8/19 21:43,2-1_all_corrected,68,55,152,167,220,222
183731,30066_20190819185032.jpg,ジョーシン和泉中央,***3,和泉,-1,て,2019/8/19 18:49,2-1_all_corrected,43,32,414,71,457,103
183397,30078_20190819175356.jpg,イオンスタイル仙台卸町店,1230,仙台,333,る,2019/8/19 17:53,2-1_all_corrected,64,65,184,102,248,167
182887,30052_20190819162148.jpg,西友市ヶ尾,*111,横浜,30,た,2019/8/19 16:21,2-1_all_corrected,71,54,280,239,351,293
209333,30078_20190829100409.jpg,イオンスタイル仙台卸町店,7788,横浜,389,む,2019/8/29 10:03,2-1_all_corrected,57,43,296,144,353,187
211135,30144_20190829191844.jpg,イオン幕張,9696,千葉,531.0,す,2019/8/29 19:18,2-1_all_corrected,71,53,158,187,229,240
209792,30001_20190829131355.jpg,関西スーパー高石駅前,***8,和泉,30,ら,2019/8/29 13:13,2-1_all_corrected,93,65,257,211,350,276
210217,30144_20190829161258.jpg,イオン幕張,3456,千葉,480,れ,2019/8/29 16:12,2-1_all_corrected,80,61,255,348,335,409
209500,30072_20190829111625.jpg,関西スーパー京阪大和田１F,6547,なにわ,800,あ,2019/8/29 11:13,2-1_all_corrected,73,59,27,202,100,261
210616,30144_20190829175448.jpg,イオン幕張,2417,水戸,530.0,ち,2019/8/29 17:54,2-1_all_corrected,76,51,212,247,288,298
210424,30090_20190829171305.jpg,イトーヨーカドー木場 西棟,5502,足立,503,い,2019/8/29 17:12,2-1_all_corrected,74,58,152,260,226,318
211354,30139_20190829202400.jpg,イオン板橋ショッピングセンター,2254,品川,35.0,す,2019/8/29 20:23,2-1_all_corrected,88,59,305,313,393,372
209360,30072_20190829101510.jpg,関西スーパー京阪大和田１F,*563,京都,800,せ,2019/8/29 10:14,2-1_all_corrected,68,55,221,157,289,212
209536,30169_20190829112917.jpg,イオン相模原ショッピングセンター,2525,相模,550,ふ,2019/8/29 11:28,2-1_all_corrected,80,62,295,121,375,183
209358,30132_20190829101426.jpg,イオンスタイル東神奈川,6976,横浜,581,く,2019/8/29 10:14,2-1_all_corrected,79,63,267,181,346,244
210275,30136_20190829162716.jpg,イオンスタイル新百合ヶ丘,*919,川崎,332,ね,2019/8/29 16:26,2-1_all_corrected,116,79,191,225,307,304
210047,30169_20190829145557.jpg,イオン相模原ショッピングセンター,*228,相模,336,ひ,2019/8/29 14:55,2-1_all_corrected,47,39,226,106,273,145
211398,30132_20190829204316.jpg,イオンスタイル東神奈川,2628,品川,583.0,あ,2019/8/29 20:42,2-1_all_corrected,79,70,206,285,285,355
210216,30139_20190829161247.jpg,イオン板橋ショッピングセンター,*275,川口,480,り,2019/8/29 16:12,2-1_all_corrected,86,71,290,356,376,427
210818,30066_20190829183703.jpg,ジョーシン和泉中央,6916,和泉,581.0,す,2019/8/29 18:36,2-1_all_corrected,70,51,169,208,239,259
210478,30169_20190829172507.jpg,イオン相模原ショッピングセンター,8386,相模,580,と,2019/8/29 17:24,2-1_all_corrected,75,61,174,167,249,228
210829,30144_20190829183815.jpg,イオン幕張,4990,千葉,300.0,る,2019/8/29 18:37,2-1_all_corrected,82,58,284,285,366,343
210227,30006_20190829161644.jpg,スギ薬局南千里,1001,大阪,31,は,2019/8/29 16:16,2-1_all_corrected,101,62,308,104,409,166
210811,30046_20190829183541.jpg,マミーマート船橋日大[地上],7115,習志野,530.0,か,2019/8/29 18:35,2-1_all_corrected,40,33,216,55,256,88
211550,30023_20190829214535.jpg,ピットデザイン山科東野,**87,福岡,588.0,や,2019/8/29 21:45,2-1_all_corrected,86,73,131,193,217,266
211355,30169_20190829202420.jpg,イオン相模原ショッピングセンター,6543,多摩,530.0,て,2019/8/29 20:23,2-1_all_corrected,85,82,445,341,530,423
209198,30106_20190829085058.jpg,ジョーシン東大阪長田,***1,大阪,30,な,2019/8/29 8:50,2-1_all_corrected,67,59,163,124,230,183
210273,30100_20190829162655.jpg,JBM長崎三芳町,3676,長崎,33,ぬ,2019/8/29 16:26,2-1_all_corrected,54,39,271,269,325,308
211535,30167_20190829213644.jpg,イオン東雲店,4505,足立,481.0,り,2019/8/29 21:36,2-1_all_corrected,77,68,68,346,145,414
211397,30111_20190829204244.jpg,イオン稲毛,4811,千葉,530.0,ね,2019/8/29 20:42,2-1_all_corrected,53,44,173,136,226,180
211364,30167_20190829202704.jpg,イオン東雲店,4704,足立,481.0,り,2019/8/29 20:26,2-1_all_corrected,67,65,85,326,152,391
209734,30167_20190829124933.jpg,イオン東雲店,2816,足立,430,さ,2019/8/29 12:49,2-1_all_corrected,90,65,111,385,201,450
210289,30144_20190829163234.jpg,イオン幕張,4185,千葉,302,な,2019/8/29 16:32,2-1_all_corrected,52,34,188,90,240,124
210887,30144_20190829184442.jpg,イオン幕張,1173,千葉,547.0,て,2019/8/29 18:44,2-1_all_corrected,78,55,211,271,289,326
210308,30136_20190829163601.jpg,イオンスタイル新百合ヶ丘,5523,川崎,501,そ,2019/8/29 16:35,2-1_all_corrected,113,80,200,199,313,279
210798,30144_20190829183229.jpg,イオン幕張,3853,千葉,330.0,ひ,2019/8/29 18:32,2-1_all_corrected,87,62,235,323,322,385
209683,30144_20190829122725.jpg,イオン幕張,***5,千葉,30,の,2019/8/29 12:27,2-1_all_corrected,54,44,206,166,260,210
210765,30144_20190829182728.jpg,イオン幕張,*226,千葉,539.0,ね,2019/8/29 18:26,2-1_all_corrected,53,41,212,113,265,154
209670,30111_20190829121926.jpg,イオン稲毛,1473,千葉,301,ぬ,2019/8/29 12:18,2-1_all_corrected,64,59,252,151,316,210
209871,30167_20190829134410.jpg,イオン東雲店,4260,品川,502,さ,2019/8/29 13:43,2-1_all_corrected,36,32,49,28,85,60
209271,30160_20190829093446.jpg,マックスバリュ米野木店（平面）,*518,名古屋,480,い,2019/8/29 9:33,2-1_all_corrected,49,41,339,138,388,179
209142,30167_20190829080132.jpg,イオン東雲店,7411,足立,230,さ,2019/8/29 8:01,2-1_all_corrected,77,57,338,368,415,425
210364,30169_20190829165422.jpg,イオン相模原ショッピングセンター,*123,多摩,589,と,2019/8/29 16:53,2-1_all_corrected,67,55,122,141,189,196
209249,30139_20190829092325.jpg,イオン板橋ショッピングセンター,2254,品川,35,す,2019/8/29 9:22,2-1_all_corrected,50,36,226,147,276,183
210532,30078_20190829173803.jpg,イオンスタイル仙台卸町店,1068,宮城,50.0,す,2019/8/29 17:37,2-1_all_corrected,68,60,184,54,252,114
210936,30169_20190829184854.jpg,イオン相模原ショッピングセンター,*110,多摩,346.0,は,2019/8/29 18:48,2-1_all_corrected,53,44,124,71,177,115
209443,30098_20190829105442.jpg,BRANCH仙台（東棟）,7691,かしわ宮,59,ち,2019/8/29 10:54,2-1_all_corrected,42,36,203,88,245,124
210135,30110_20190829153628.jpg,イオン金沢八景,3262,横浜,583,け,2019/8/29 15:36,2-1_all_corrected,53,43,313,70,366,113
210909,30046_20190829184636.jpg,マミーマート船橋日大[地上],4652,習志野,583.0,え,2019/8/29 18:46,2-1_all_corrected,83,64,371,219,454,283
211221,30072_20190829194012.jpg,関西スーパー京阪大和田１F,*117,大阪,377.0,り,2019/8/29 19:39,2-1_all_corrected,47,36,445,62,492,98
211219,30167_20190829194003.jpg,イオン東雲店,1109,品川,363.0,け,2019/8/29 19:39,2-1_all_corrected,55,42,419,336,474,378
211642,30167_20190829221331.jpg,イオン東雲店,1069,足立,50.0,つ,2019/8/29 22:13,2-1_all_corrected,60,43,151,313,211,356
209649,30167_20190829121320.jpg,イオン東雲店,*816,足立,337,り,2019/8/29 12:12,2-1_all_corrected,51,36,337,112,388,148
210560,30144_20190829174403.jpg,イオン幕張,8748,千葉,580.0,よ,2019/8/29 17:43,2-1_all_corrected,71,52,156,206,227,258
209647,30139_20190829121224.jpg,イオン板橋ショッピングセンター,3900,練馬,480,れ,2019/8/29 12:11,2-1_all_corrected,53,44,303,198,356,242
210701,30110_20190829181510.jpg,イオン金沢八景,***1,横浜,30.0,せ,2019/8/29 18:14,2-1_all_corrected,45,36,434,101,479,137
210192,30139_20190829160516.jpg,イオン板橋ショッピングセンター,1282,越谷,480,り,2019/8/29 16:04,2-1_all_corrected,82,74,347,352,429,426
210730,30078_20190829182147.jpg,イオンスタイル仙台卸町店,5617,宮城,581.0,あ,2019/8/29 18:21,2-1_all_corrected,55,40,240,57,295,97
209428,30136_20190829105024.jpg,イオンスタイル新百合ヶ丘,*795,川崎,330,る,2019/8/29 10:49,2-1_all_corrected,55,47,266,220,321,267
210505,30144_20190829173113.jpg,イオン幕張,*738,大宮,300,て,2019/8/29 17:30,2-1_all_corrected,51,47,15,231,66,278
210195,30139_20190829160553.jpg,イオン板橋ショッピングセンター,6105,練馬,480,れ,2019/8/29 16:05,2-1_all_corrected,75,65,334,271,409,336
210188,30078_20190829160211.jpg,イオンスタイル仙台卸町店,3380,宮城,583,う,2019/8/29 16:01,2-1_all_corrected,89,61,152,318,241,379
209638,30144_20190829120823.jpg,イオン幕張,5269,千葉,302,せ,2019/8/29 12:08,2-1_all_corrected,58,44,125,159,183,203
209404,30145_20190829103707.jpg,イオン高根木戸,8001,習志野,580,の,2019/8/29 10:36,2-1_all_corrected,47,39,54,219,101,258
209255,30169_20190829092526.jpg,イオン相模原ショッピングセンター,6651,春日部,100,あ,2019/8/29 9:24,2-1_all_corrected,38,41,273,73,311,114
211053,30111_20190829190525.jpg,イオン稲毛,1020,千葉,588.0,も,2019/8/29 19:04,2-1_all_corrected,60,44,179,175,239,219
210545,30167_20190829174043.jpg,イオン東雲店,3556,足立,301.0,ら,2019/8/29 17:40,2-1_all_corrected,44,26,315,241,359,267
209830,30078_20190829133111.jpg,イオンスタイル仙台卸町店,6854,仙台,580,な,2019/8/29 13:30,2-1_all_corrected,84,56,279,246,363,302
210784,30111_20190829182955.jpg,イオン稲毛,3003,千葉,346.0,ひ,2019/8/29 18:29,2-1_all_corrected,72,57,283,204,355,261
209450,30137_20190829105647.jpg,イオンスタイル品川シーサイド,1028,品川,337,つ,2019/8/29 10:56,2-1_all_corrected,91,58,431,392,522,450
209206,30072_20190829085733.jpg,関西スーパー京阪大和田１F,*762,京都,800,せ,2019/8/29 8:57,2-1_all_corrected,57,43,212,178,269,221
211204,30072_20190829193450.jpg,関西スーパー京阪大和田１F,8845,神戸,806.0,あ,2019/8/29 19:34,2-1_all_corrected,43,37,379,42,422,79
210913,30144_20190829184703.jpg,イオン幕張,*706,千葉,301.0,ぬ,2019/8/29 18:46,2-1_all_corrected,69,54,273,195,342,249
209654,30078_20190829121439.jpg,イオンスタイル仙台卸町店,*530,仙台,583,つ,2019/8/29 12:14,2-1_all_corrected,74,50,231,145,305,195
210741,30046_20190829182336.jpg,マミーマート船橋日大[地上],5070,習志野,580.0,な,2019/8/29 18:23,2-1_all_corrected,36,24,159,41,195,65
209630,30139_20190829120612.jpg,イオン板橋ショッピングセンター,1282,越谷,480,り,2019/8/29 12:05,2-1_all_corrected,67,62,345,265,412,327
210510,30167_20190829173202.jpg,イオン東雲店,**21,大宮,431,て,2019/8/29 17:31,2-1_all_corrected,82,61,215,267,297,328
210174,30144_20190829155119.jpg,イオン幕張,1019,千葉,585,い,2019/8/29 15:50,2-1_all_corrected,54,43,186,112,240,155
210346,30045_20190829164758.jpg,マックスバリュー徳川明倫,*358,名古屋,32,と,2019/8/29 16:47,2-1_all_corrected,54,46,256,189,310,235
210725,30110_20190829182049.jpg,イオン金沢八景,*350,神戸,502.0,は,2019/8/29 18:20,2-1_all_corrected,53,45,390,100,443,145
210187,30090_20190829160113.jpg,イトーヨーカドー木場 西棟,3725,横浜,581,か,2019/8/29 16:00,2-1_all_corrected,77,58,395,305,472,363
211400,30167_20190829204345.jpg,イオン東雲店,*197,多摩,503.0,ぬ,2019/8/29 20:43,2-1_all_corrected,72,69,7,233,79,302
210384,30144_20190829170026.jpg,イオン幕張,1538,習志野,301,ぬ,2019/8/29 16:59,2-1_all_corrected,61,44,240,205,301,249
210370,30169_20190829165600.jpg,イオン相模原ショッピングセンター,1962,相模,331,た,2019/8/29 16:55,2-1_all_corrected,74,60,231,114,305,174
210740,30139_20190829182335.jpg,イオン板橋ショッピングセンター,6105,練馬,480.0,れ,2019/8/29 18:23,2-1_all_corrected,86,68,342,348,428,416
210747,30111_20190829182418.jpg,イオン稲毛,8008,千葉,352.0,わ,2019/8/29 18:23,2-1_all_corrected,49,39,116,100,165,139
210543,30090_20190829174038.jpg,イトーヨーカドー木場 西棟,***8,品川,30.0,ふ,2019/8/29 17:40,2-1_all_corrected,55,40,235,197,290,237
210785,30111_20190829183001.jpg,イオン稲毛,3003,千葉,346.0,ひ,2019/8/29 18:29,2-1_all_corrected,72,57,283,204,355,261
211233,30072_20190829194602.jpg,関西スーパー京阪大和田１F,6422,なにわ,580.0,ほ,2019/8/29 19:45,2-1_all_corrected,71,58,122,105,193,163
209663,30046_20190829121722.jpg,マミーマート船橋日大[地上],8824,習志野,580,か,2019/8/29 12:16,2-1_all_corrected,42,35,230,132,272,167
211650,30139_20190829221433.jpg,イオン板橋ショッピングセンター,3900,練馬,480.0,れ,2019/8/29 22:14,2-1_all_corrected,86,63,300,368,386,431
210099,30144_20190829151857.jpg,イオン幕張,*840,千葉,330,り,2019/8/29 15:18,2-1_all_corrected,57,40,172,130,229,170
210260,30111_20190829162511.jpg,イオン稲毛,9785,千葉,503,せ,2019/8/29 16:24,2-1_all_corrected,54,43,246,153,300,196
210604,30090_20190829175315.jpg,イトーヨーカドー木場 西棟,1398,横浜,330.0,み,2019/8/29 17:52,2-1_all_corrected,96,67,377,372,473,439
209729,30111_20190829124744.jpg,イオン稲毛,***5,千葉,30,ふ,2019/8/29 12:46,2-1_all_corrected,44,32,414,83,458,115
209375,30139_20190829102319.jpg,イオン板橋ショッピングセンター,*906,練馬,34,と,2019/8/29 10:22,2-1_all_corrected,52,44,224,178,276,222
209944,30139_20190829141213.jpg,イオン板橋ショッピングセンター,6105,練馬,480,れ,2019/8/29 14:11,2-1_all_corrected,75,65,380,323,455,388
209727,30144_20190829124709.jpg,イオン幕張,*180,千葉,502,む,2019/8/29 12:46,2-1_all_corrected,53,36,200,109,253,145
210063,30157_20190829150604.jpg,関西スーパー中央,5678,神戸,30,ら,2019/8/29 15:05,2-1_all_corrected,55,46,150,339,205,385
211111,30046_20190829191558.jpg,マミーマート船橋日大[地上],1029,習志野,336.0,り,2019/8/29 19:15,2-1_all_corrected,39,29,163,51,202,80
210657,30144_20190829180533.jpg,イオン幕張,2425,習志野,580.0,き,2019/8/29 18:04,2-1_all_corrected,73,54,146,229,219,283
210233,30167_20190829161852.jpg,イオン東雲店,7411,足立,230,さ,2019/8/29 16:18,2-1_all_corrected,70,57,412,372,482,429
210006,30169_20190829143655.jpg,イオン相模原ショッピングセンター,*228,相模,338,ひ,2019/8/29 14:36,2-1_all_corrected,52,37,173,101,225,138
211120,30111_20190829191652.jpg,イオン稲毛,*948,横浜,490.0,と,2019/8/29 19:16,2-1_all_corrected,54,42,398,159,452,201
209584,30169_20190829114648.jpg,イオン相模原ショッピングセンター,3666,相模,583,さ,2019/8/29 11:46,2-1_all_corrected,91,71,84,318,175,389
211518,30169_20190829212633.jpg,イオン相模原ショッピングセンター,4244,多摩,303.0,て,2019/8/29 21:26,2-1_all_corrected,91,71,365,347,456,418
211188,30066_20190829193049.jpg,ジョーシン和泉中央,**55,和泉,31.0,ち,2019/8/29 19:30,2-1_all_corrected,72,56,190,231,262,287
209980,30144_20190829142622.jpg,イオン幕張,**11,千葉,31,な,2019/8/29 14:25,2-1_all_corrected,45,43,84,160,129,203
210633,30111_20190829180024.jpg,イオン稲毛,9294,名古屋,503.0,ふ,2019/8/29 17:58,2-1_all_corrected,54,43,171,137,225,180
211144,30111_20190829192039.jpg,イオン稲毛,2029,千葉,302.0,わ,2019/8/29 19:20,2-1_all_corrected,53,40,155,123,208,163
210868,30144_20190829184308.jpg,イオン幕張,*819,千葉,336.0,は,2019/8/29 18:42,2-1_all_corrected,72,51,165,214,237,265
211545,30001_20190829214319.jpg,関西スーパー高石駅前,2222,和泉,593.0,ら,2019/8/29 21:43,2-1_all_corrected,93,69,187,303,280,372
210497,30078_20190829172828.jpg,イオンスタイル仙台卸町店,2668,仙台,580,よ,2019/8/29 17:28,2-1_all_corrected,62,61,136,111,198,172
209743,30001_20190829125741.jpg,関西スーパー高石駅前,2438,神戸,335,も,2019/8/29 12:57,2-1_all_corrected,77,58,311,112,388,170
210656,30072_20190829180512.jpg,関西スーパー京阪大和田１F,1840,大阪,581.0,た,2019/8/29 18:04,2-1_all_corrected,52,40,301,72,353,112
211542,30139_20190829214300.jpg,イオン板橋ショッピングセンター,1282,越谷,480.0,り,2019/8/29 21:42,2-1_all_corrected,67,61,247,316,314,377
210669,30078_20190829180757.jpg,イオンスタイル仙台卸町店,1598,徳島,580.0,な,2019/8/29 18:07,2-1_all_corrected,69,58,146,129,215,187
211580,30111_20190829215844.jpg,イオン稲毛,5884,千葉,301.0,め,2019/8/29 21:58,2-1_all_corrected,53,42,213,139,266,181
211117,30072_20190829191624.jpg,関西スーパー京阪大和田１F,*407,大阪,532.0,め,2019/8/29 19:15,2-1_all_corrected,73,61,211,158,284,219
210455,30136_20190829172152.jpg,イオンスタイル新百合ヶ丘,**30,横浜,304,つ,2019/8/29 17:21,2-1_all_corrected,111,77,181,224,292,301
209355,30046_20190829101401.jpg,マミーマート船橋日大[地上],2616,習志野,580,う,2019/8/29 10:13,2-1_all_corrected,43,30,171,85,214,115
210278,30139_20190829162821.jpg,イオン板橋ショッピングセンター,***1,練馬,30,ね,2019/8/29 16:27,2-1_all_corrected,58,47,278,131,336,178
211508,30136_20190829212240.jpg,イオンスタイル新百合ヶ丘,3993,川崎,330.0,も,2019/8/29 21:22,2-1_all_corrected,104,72,4,378,108,450
209997,30167_20190829143413.jpg,イオン東雲店,*106,足立,530,も,2019/8/29 14:33,2-1_all_corrected,41,32,278,203,319,235
210624,30144_20190829175658.jpg,イオン幕張,1103,千葉,595.0,や,2019/8/29 17:56,2-1_all_corrected,58,40,161,169,219,209
211196,30111_20190829193347.jpg,イオン稲毛,3255,千葉,531.0,く,2019/8/29 19:33,2-1_all_corrected,50,40,177,115,227,155
210088,30111_20190829151400.jpg,イオン稲毛,*222,千葉,589,も,2019/8/29 15:13,2-1_all_corrected,57,43,322,161,379,204
209595,30139_20190829114900.jpg,イオン板橋ショッピングセンター,5245,所沢,301,は,2019/8/29 11:48,2-1_all_corrected,75,64,427,305,502,369
209308,30169_20190829095339.jpg,イオン相模原ショッピングセンター,1315,相模,380,い,2019/8/29 9:53,2-1_all_corrected,49,38,335,81,384,119
211131,30144_20190829191746.jpg,イオン幕張,2601,千葉,301.0,る,2019/8/29 19:17,2-1_all_corrected,75,56,179,224,254,280
211303,30167_20190829200639.jpg,イオン東雲店,8008,相模,593.0,に,2019/8/29 20:06,2-1_all_corrected,62,67,6,241,68,308
211109,30115_20190829191530.jpg,イオン南行徳（平面）,6903,習志野,530.0,そ,2019/8/29 19:14,2-1_all_corrected,95,81,480,269,575,350
209901,30139_20190829135700.jpg,イオン板橋ショッピングセンター,*275,川口,480,り,2019/8/29 13:56,2-1_all_corrected,80,67,415,364,495,431
210646,30136_20190829180252.jpg,イオンスタイル新百合ヶ丘,3160,川崎,100.0,す,2019/8/29 18:02,2-1_all_corrected,81,61,353,72,434,133
210019,30169_20190829144206.jpg,イオン相模原ショッピングセンター,**24,品川,430,ひ,2019/8/29 14:41,2-1_all_corrected,46,40,223,97,269,137
210684,30072_20190829181140.jpg,関西スーパー京阪大和田１F,7612,大阪,302.0,ぬ,2019/8/29 18:11,2-1_all_corrected,54,42,525,108,579,150
209930,30110_20190829140939.jpg,イオン金沢八景,*240,相模,400,つ,2019/8/29 14:09,2-1_all_corrected,81,80,22,305,103,385
210445,30167_20190829172007.jpg,イオン東雲店,1987,足立,331,す,2019/8/29 17:19,2-1_all_corrected,71,52,259,195,330,247
210614,30144_20190829175426.jpg,イオン幕張,1239,習志野,330.0,み,2019/8/29 17:53,2-1_all_corrected,91,62,367,387,458,449
211351,30063_20190829202259.jpg,コーナン相模原小山モール,8614,相模,502.0,ね,2019/8/29 20:22,2-1_all_corrected,52,44,480,152,532,196
210283,30011_20190829162909.jpg,西友都賀第1駐車場,***7,千葉,531,ろ,2019/8/29 16:27,2-1_all_corrected,51,47,83,80,134,127
209701,30091_20190829123407.jpg,イトーヨーカドー木場 立体,4552,足立,481,り,2019/8/29 12:33,2-1_all_corrected,78,64,280,268,358,332
211393,30060_20190829203852.jpg,関西スーパー小野原,3976,大阪,480.0,ひ,2019/8/29 20:38,2-1_all_corrected,66,70,534,366,600,436
210884,30111_20190829184430.jpg,イオン稲毛,2317,千葉,334.0,も,2019/8/29 18:43,2-1_all_corrected,47,36,128,97,175,133
210246,30145_20190829162105.jpg,イオン高根木戸,*565,練馬,501,む,2019/8/29 16:20,2-1_all_corrected,55,42,257,195,312,237
210622,30078_20190829175644.jpg,イオンスタイル仙台卸町店,9751,千葉,533.0,つ,2019/8/29 17:56,2-1_all_corrected,50,62,134,86,184,148
210410,30078_20190829170926.jpg,イオンスタイル仙台卸町店,6900,仙台,400,り,2019/8/29 17:09,2-1_all_corrected,70,57,165,69,235,126
211199,30072_20190829193430.jpg,関西スーパー京阪大和田１F,6854,大阪,503.0,る,2019/8/29 19:34,2-1_all_corrected,87,65,4,218,91,283
210444,30167_20190829171941.jpg,イオン東雲店,1987,足立,331,す,2019/8/29 17:19,2-1_all_corrected,80,69,185,109,265,178
210018,30157_20190829144159.jpg,関西スーパー中央,5678,神戸,30,ら,2019/8/29 14:41,2-1_all_corrected,45,44,445,182,490,226
209797,30136_20190829131626.jpg,イオンスタイル新百合ヶ丘,8310,川崎,330,め,2019/8/29 13:15,2-1_all_corrected,54,48,311,151,365,199
210443,30070_20190829171908.jpg,カナートモール住道第一,**55,大阪,31,に,2019/8/29 17:18,2-1_all_corrected,88,63,150,214,238,277
211137,30144_20190829191935.jpg,イオン幕張,1383,千葉,330.0,は,2019/8/29 19:19,2-1_all_corrected,58,42,214,124,272,166
211305,30144_20190829200653.jpg,イオン幕張,**18,千葉,373.0,な,2019/8/29 20:06,2-1_all_corrected,47,34,118,78,165,112
210815,30144_20190829183605.jpg,イオン幕張,7811,野田,580.0,な,2019/8/29 18:35,2-1_all_corrected,55,38,167,156,222,194
209336,30144_20190829100528.jpg,イオン幕張,2688,習志野,480,れ,2019/8/29 10:05,2-1_all_corrected,54,38,260,191,314,229
209560,30060_20190829113628.jpg,関西スーパー小野原,3885,大阪,581,は,2019/8/29 11:36,2-1_all_corrected,77,68,347,354,424,422
211130,30144_20190829191727.jpg,イオン幕張,1310,千葉,541.0,こ,2019/8/29 19:16,2-1_all_corrected,39,48,21,199,60,247
210472,30144_20190829172442.jpg,イオン幕張,2262,千葉,503,せ,2019/8/29 17:24,2-1_all_corrected,85,54,300,308,385,362
210224,30139_20190829161409.jpg,イオン板橋ショッピングセンター,3900,練馬,480,れ,2019/8/29 16:13,2-1_all_corrected,75,60,347,298,422,358
210500,30045_20190829172931.jpg,マックスバリュー徳川明倫,**77,名古屋,31,ほ,2019/8/29 17:29,2-1_all_corrected,43,36,286,116,329,152
210735,30078_20190829182241.jpg,イオンスタイル仙台卸町店,2583,仙台,550.0,に,2019/8/29 18:22,2-1_all_corrected,80,53,205,166,285,219
209618,30139_20190829120040.jpg,イオン板橋ショッピングセンター,*275,川口,480,り,2019/8/29 12:00,2-1_all_corrected,52,45,247,232,299,277
209872,30167_20190829134440.jpg,イオン東雲店,4260,品川,502,さ,2019/8/29 13:44,2-1_all_corrected,88,69,98,313,186,382
210994,30111_20190829185909.jpg,イオン稲毛,1112,千葉,564.0,れ,2019/8/29 18:58,2-1_all_corrected,45,38,82,100,127,138
211087,30144_20190829191157.jpg,イオン幕張,4279,習志野,480.0,う,2019/8/29 19:11,2-1_all_corrected,38,42,68,187,106,229
210956,30144_20190829185126.jpg,イオン幕張,3528,袖ヶ浦,480.0,せ,2019/8/29 18:50,2-1_all_corrected,81,58,257,293,338,351
210704,30078_20190829181619.jpg,イオンスタイル仙台卸町店,9886,飛騨,580.0,ほ,2019/8/29 18:15,2-1_all_corrected,69,56,147,110,216,166
211649,30139_20190829221400.jpg,イオン板橋ショッピングセンター,3901,練馬,480.0,れ,2019/8/29 22:13,2-1_all_corrected,79,67,406,287,485,354
210750,30078_20190829182458.jpg,イオンスタイル仙台卸町店,5778,仙台,380.0,せ,2019/8/29 18:24,2-1_all_corrected,55,44,356,112,411,156
210101,30139_20190829152002.jpg,イオン板橋ショッピングセンター,***1,練馬,30,ね,2019/8/29 15:19,2-1_all_corrected,55,43,257,190,312,233
210757,30144_20190829182634.jpg,イオン幕張,9054,大宮,503.0,す,2019/8/29 18:26,2-1_all_corrected,59,41,211,150,270,191
210795,30144_20190829183147.jpg,イオン幕張,4100,福岡,331.0,せ,2019/8/29 18:31,2-1_all_corrected,87,62,253,289,340,351
210761,30091_20190829182649.jpg,イトーヨーカドー木場 立体,*219,足立,303.0,は,2019/8/29 18:26,2-1_all_corrected,49,42,289,126,338,168
210305,30103_20190829163534.jpg,八尾老原１丁目,***7,大阪,30,ひ,2019/8/29 16:35,2-1_all_corrected,57,45,276,158,333,203
209674,30078_20190829122058.jpg,イオンスタイル仙台卸町店,2431,山形,580,わ,2019/8/29 12:20,2-1_all_corrected,58,41,240,58,298,99
210766,30063_20190829182733.jpg,コーナン相模原小山モール,6345,相模,501.0,み,2019/8/29 18:27,2-1_all_corrected,91,73,113,346,204,419
210554,30144_20190829174154.jpg,イオン幕張,2525,袖ヶ浦,337.0,や,2019/8/29 17:41,2-1_all_corrected,81,47,231,258,312,305
209617,30078_20190829120025.jpg,イオンスタイル仙台卸町店,*526,郡山,310,さ,2019/8/29 11:59,2-1_all_corrected,98,53,292,397,390,450
209619,30132_20190829120040.jpg,イオンスタイル東神奈川,7966,横浜,580,に,2019/8/29 12:00,2-1_all_corrected,76,61,242,289,318,350
210165,30169_20190829154547.jpg,イオン相模原ショッピングセンター,1010,多摩,339,て,2019/8/29 15:45,2-1_all_corrected,48,36,273,140,321,176
210501,30137_20190829172945.jpg,イオンスタイル品川シーサイド,3441,品川,530,せ,2019/8/29 17:29,2-1_all_corrected,104,63,303,387,407,450
209245,30159_20190829092224.jpg,イオン臼井,*606,千葉,331,め,2019/8/29 9:21,2-1_all_corrected,56,46,204,157,260,203
211088,30138_20190829191159.jpg,イオンスタイル湘南茅ヶ崎,2402,湘南,502.0,と,2019/8/29 19:11,2-1_all_corrected,57,45,264,108,321,153
210758,30072_20190829182639.jpg,関西スーパー京阪大和田１F,1123,大阪,568.0,た,2019/8/29 18:26,2-1_all_corrected,40,30,405,12,445,42
211473,30139_20190829210836.jpg,イオン板橋ショッピングセンター,6105,練馬,480.0,れ,2019/8/29 21:08,2-1_all_corrected,73,57,222,263,295,320
209216,30078_20190829090611.jpg,イオンスタイル仙台卸町店,1355,仙台,330,つ,2019/8/29 9:05,2-1_all_corrected,58,42,304,126,362,168
210599,30078_20190829175259.jpg,イオンスタイル仙台卸町店,1250,相模,901.0,ら,2019/8/29 17:52,2-1_all_corrected,71,50,312,118,383,168
209476,30137_20190829110801.jpg,イオンスタイル品川シーサイド,*549,品川,330,な,2019/8/29 11:07,2-1_all_corrected,73,58,82,114,155,172
210769,30139_20190829182808.jpg,イオン板橋ショッピングセンター,3901,練馬,480.0,れ,2019/8/29 18:27,2-1_all_corrected,71,57,261,276,332,333
210564,30078_20190829174434.jpg,イオンスタイル仙台卸町店,6091,仙台,480.0,て,2019/8/29 17:44,2-1_all_corrected,57,43,274,67,331,110
211670,30079_20190829221837.jpg,ピットデザイン仙台卸町駅前駐車場,8295,仙台,580.0,と,2019/8/29 22:18,2-1_all_corrected,86,70,227,340,313,410
210904,30167_20190829184615.jpg,イオン東雲店,*311,足立,340.0,み,2019/8/29 18:45,2-1_all_corrected,70,56,396,343,466,399
209816,30091_20190829132553.jpg,イトーヨーカドー木場 立体,1588,足立,583,き,2019/8/29 13:25,2-1_all_corrected,56,42,199,47,255,89
211467,30167_20190829210520.jpg,イオン東雲店,1000,足立,505.0,ふ,2019/8/29 21:04,2-1_all_corrected,56,42,282,310,338,352
210328,30072_20190829163957.jpg,関西スーパー京阪大和田１F,*731,大阪,342,た,2019/8/29 16:39,2-1_all_corrected,66,55,393,141,459,196
210926,30072_20190829184758.jpg,関西スーパー京阪大和田１F,*920,なにわ,533.0,く,2019/8/29 18:47,2-1_all_corrected,44,33,392,64,436,97
209659,30091_20190829121610.jpg,イトーヨーカドー木場 立体,*811,世田谷,312,さ,2019/8/29 12:15,2-1_all_corrected,53,38,253,54,306,92
211004,30111_20190829185954.jpg,イオン稲毛,3456,香川,330.0,ち,2019/8/29 18:59,2-1_all_corrected,49,40,128,105,177,145
210921,30167_20190829184744.jpg,イオン東雲店,4505,足立,401.0,り,2019/8/29 18:47,2-1_all_corrected,36,32,366,102,402,134
211209,30078_20190829193548.jpg,イオンスタイル仙台卸町店,1001,宮城,346.0,む,2019/8/29 19:35,2-1_all_corrected,90,67,168,303,258,370
210326,30072_20190829163938.jpg,関西スーパー京阪大和田１F,2217,大阪,581,は,2019/8/29 16:39,2-1_all_corrected,39,29,248,80,287,109
210789,30139_20190829183018.jpg,イオン板橋ショッピングセンター,3900,練馬,480.0,れ,2019/8/29 18:29,2-1_all_corrected,68,58,321,237,389,295
209657,30139_20190829121600.jpg,イオン板橋ショッピングセンター,5024,練馬,480,れ,2019/8/29 12:15,2-1_all_corrected,73,56,283,277,356,333
209869,30078_20190829134354.jpg,イオンスタイル仙台卸町店,*888,仙台,315,さ,2019/8/29 13:43,2-1_all_corrected,91,68,202,320,293,388
209258,30070_20190829092552.jpg,カナートモール住道第一,***5,なにわ,30,な,2019/8/29 9:25,2-1_all_corrected,94,72,70,315,164,387
210375,30144_20190829165819.jpg,イオン幕張,6377,千葉,581,く,2019/8/29 16:57,2-1_all_corrected,76,55,176,279,252,334
211254,30110_20190829195133.jpg,イオン金沢八景,1188,横浜,339.0,は,2019/8/29 19:51,2-1_all_corrected,67,55,366,73,433,128
210981,30169_20190829185625.jpg,イオン相模原ショッピングセンター,1108,相模,340.0,あ,2019/8/29 18:55,2-1_all_corrected,53,47,154,107,207,154
211433,30157_20190829205211.jpg,関西スーパー中央,*314,神戸,547.0,た,2019/8/29 20:51,2-1_all_corrected,59,43,338,278,397,321
209438,30058_20190829105408.jpg,ライフ東府中（隔地）,***1,多摩,30,て,2019/8/29 10:53,2-1_all_corrected,92,69,336,292,428,361
210576,30144_20190829174823.jpg,イオン幕張,1280,習志野,583.0,え,2019/8/29 17:47,2-1_all_corrected,88,65,327,316,415,381
210744,30139_20190829182359.jpg,イオン板橋ショッピングセンター,5024,練馬,480.0,れ,2019/8/29 18:23,2-1_all_corrected,77,62,313,353,390,415
211201,30072_20190829193442.jpg,関西スーパー京阪大和田１F,8845,神戸,84.0,あ,2019/8/29 19:34,2-1_all_corrected,47,39,166,84,213,123
210743,30046_20190829182357.jpg,マミーマート船橋日大[地上],1651,習志野,330.0,め,2019/8/29 18:23,2-1_all_corrected,38,32,168,38,206,70
210571,30078_20190829174621.jpg,イオンスタイル仙台卸町店,3588,富山,310.0,も,2019/8/29 17:45,2-1_all_corrected,63,59,182,95,245,154
210578,30014_20190829174916.jpg,フォルテ蘇我ベルク棟,**11,千葉,31.0,せ,2019/8/29 17:48,2-1_all_corrected,79,62,315,136,394,198
210316,30136_20190829163713.jpg,イオンスタイル新百合ヶ丘,1107,川崎,342,の,2019/8/29 16:36,2-1_all_corrected,82,66,346,55,428,121
210918,30125_20190829184737.jpg,カスミ柏たなか駅前店,2450,野田,55.0,さ,2019/8/29 18:47,2-1_all_corrected,68,34,238,337,306,371
209634,30139_20190829120652.jpg,イオン板橋ショッピングセンター,6105,練馬,480,れ,2019/8/29 12:06,2-1_all_corrected,69,60,269,205,338,265
211056,30045_20190829190548.jpg,マックスバリュー徳川明倫,*358,名古屋,32.0,つ,2019/8/29 19:05,2-1_all_corrected,54,47,124,195,178,242
211435,30079_20190829205251.jpg,ピットデザイン仙台卸町駅前駐車場,8918,所沢,501.0,ち,2019/8/29 20:52,2-1_all_corrected,85,64,251,212,336,276
210513,30078_20190829173220.jpg,イオンスタイル仙台卸町店,3298,静岡,532,り,2019/8/29 17:31,2-1_all_corrected,66,37,269,119,335,156
210345,30111_20190829164739.jpg,イオン稲毛,3605,袖ヶ浦,100,さ,2019/8/29 16:46,2-1_all_corrected,54,44,245,138,299,182
210728,30046_20190829182128.jpg,マミーマート船橋日大[地上],*303,習志野,580.0,ふ,2019/8/29 18:20,2-1_all_corrected,39,32,201,32,240,64
210525,30090_20190829173603.jpg,イトーヨーカドー木場 西棟,2213,足立,530.0,ふ,2019/8/29 17:35,2-1_all_corrected,55,41,161,171,216,212
211060,30052_20190829190627.jpg,西友市ヶ尾,1000,横浜,30.0,な,2019/8/29 19:05,2-1_all_corrected,87,70,162,317,249,387
210034,30169_20190829145130.jpg,イオン相模原ショッピングセンター,3223,相模,580,ま,2019/8/29 14:51,2-1_all_corrected,86,62,269,233,355,295
210239,30144_20190829161936.jpg,イオン幕張,8705,千葉,330,に,2019/8/29 16:19,2-1_all_corrected,54,37,179,101,233,138
210830,30060_20190829183835.jpg,関西スーパー小野原,9510,大阪,400.0,ふ,2019/8/29 18:38,2-1_all_corrected,70,64,479,244,549,308
210653,30111_20190829180423.jpg,イオン稲毛,8695,千葉,330.0,と,2019/8/29 18:03,2-1_all_corrected,71,55,238,182,309,237
211578,30144_20190829215747.jpg,イオン幕張,5176,佐賀,501.0,せ,2019/8/29 21:57,2-1_all_corrected,76,63,336,288,412,351
211316,30078_20190829201000.jpg,イオンスタイル仙台卸町店,**32,青森,334.0,ぬ,2019/8/29 20:09,2-1_all_corrected,55,45,328,84,383,129
210492,30046_20190829172745.jpg,マミーマート船橋日大[地上],9794,習志野,330,さ,2019/8/29 17:27,2-1_all_corrected,44,34,195,74,239,108
210466,30137_20190829172318.jpg,イオンスタイル品川シーサイド,*314,千葉,342,て,2019/8/29 17:22,2-1_all_corrected,85,74,450,329,535,403
210801,30144_20190829183356.jpg,イオン幕張,1125,千葉,346.0,ひ,2019/8/29 18:33,2-1_all_corrected,58,41,218,174,276,215
209746,30144_20190829125813.jpg,イオン幕張,6074,水戸,580,ほ,2019/8/29 12:57,2-1_all_corrected,58,42,203,173,261,215
210855,30110_20190829184146.jpg,イオン金沢八景,*612,つくば,333.0,ひ,2019/8/29 18:41,2-1_all_corrected,69,63,502,252,571,315
211177,30111_20190829192800.jpg,イオン稲毛,4786,静岡,300.0,ち,2019/8/29 19:27,2-1_all_corrected,55,44,182,136,237,180
210897,30144_20190829184542.jpg,イオン幕張,1337,習志野,330.0,な,2019/8/29 18:45,2-1_all_corrected,73,49,235,211,308,260
210609,30009_20190829175352.jpg,西友新北習志野,*108,千葉,334.0,さ,2019/8/29 17:53,2-1_all_corrected,173,96,219,0,392,96
211541,30139_20190829214254.jpg,イオン板橋ショッピングセンター,5024,練馬,480.0,れ,2019/8/29 21:42,2-1_all_corrected,84,64,336,374,420,438
211122,30157_20190829191700.jpg,関西スーパー中央,**77,神戸,31.0,の,2019/8/29 19:16,2-1_all_corrected,50,49,49,394,99,443
210460,30110_20190829172216.jpg,イオン金沢八景,*181,横浜,333,ま,2019/8/29 17:21,2-1_all_corrected,80,86,26,254,106,340
209923,30139_20190829140717.jpg,イオン板橋ショッピングセンター,1282,越谷,480,り,2019/8/29 14:06,2-1_all_corrected,81,66,316,319,397,385
210809,30144_20190829183522.jpg,イオン幕張,3939,千葉,587.0,き,2019/8/29 18:34,2-1_all_corrected,35,33,228,125,263,158
210663,30078_20190829180627.jpg,イオンスタイル仙台卸町店,*527,仙台,530.0,ろ,2019/8/29 18:05,2-1_all_corrected,90,68,192,263,282,331
210697,30111_20190829181350.jpg,イオン稲毛,8090,千葉,500.0,ち,2019/8/29 18:12,2-1_all_corrected,40,80,560,327,600,407
209771,30110_20190829130700.jpg,イオン金沢八景,1818,横浜,335,ね,2019/8/29 13:06,2-1_all_corrected,50,41,487,83,537,124
209785,30086_20190829131208.jpg,テックランド大阪りんくう,***8,和泉,30,ま,2019/8/29 13:11,2-1_all_corrected,49,36,190,110,239,146
210298,30144_20190829163440.jpg,イオン幕張,6209,習志野,502,た,2019/8/29 16:34,2-1_all_corrected,57,41,194,126,251,167
210405,30045_20190829170734.jpg,マックスバリュー徳川明倫,**23,名古屋,31,み,2019/8/29 17:07,2-1_all_corrected,74,62,105,215,179,277
211523,30167_20190829212812.jpg,イオン東雲店,**28,名古屋,347.0,た,2019/8/29 21:27,2-1_all_corrected,75,59,144,269,219,328
209984,30169_20190829142718.jpg,イオン相模原ショッピングセンター,3223,相模,580,ま,2019/8/29 14:26,2-1_all_corrected,81,74,125,146,206,220
211375,30039_20190829203043.jpg,イトーヨーカドー大井町,1080,品川,330.0,ね,2019/8/29 20:30,2-1_all_corrected,57,46,285,108,342,154
210865,30144_20190829184235.jpg,イオン幕張,*611,千葉,340.0,す,2019/8/29 18:42,2-1_all_corrected,89,64,372,322,461,386
210630,30144_20190829175913.jpg,イオン幕張,*329,千葉,536.0,そ,2019/8/29 17:58,2-1_all_corrected,62,45,224,176,286,221
209189,30169_20190829084527.jpg,イオン相模原ショッピングセンター,6651,春日部,100,あ,2019/8/29 8:44,2-1_all_corrected,78,60,155,123,233,183
211182,30111_20190829192843.jpg,イオン稲毛,3008,千葉,301.0,あ,2019/8/29 19:27,2-1_all_corrected,45,34,94,90,139,124
209377,30167_20190829102442.jpg,イオン東雲店,6669,豊橋,301,と,2019/8/29 10:24,2-1_all_corrected,90,64,203,305,293,369
211171,30114_20190829192627.jpg,イオン南行徳（立体）,*541,習志野,500.0,に,2019/8/29 19:26,2-1_all_corrected,66,58,161,140,227,198
180338,30045_20190818121739.jpg,マックスバリュー徳川明倫,**77,名古屋,31,ゆ,2019/8/18 12:17,2-1_all_corrected,67,60,100,214,167,274
180936,30167_20190818161127.jpg,イオン東雲店,9791,足立,301,ぬ,2019/8/18 16:10,2-1_all_corrected,40,33,410,49,450,82
181448,30167_20190818194205.jpg,イオン東雲店,*623,足立,337,す,2019/8/18 19:41,2-1_all_corrected,46,44,434,304,480,348
180909,30001_20190818160057.jpg,関西スーパー高石駅前,7718,和泉,301,ね,2019/8/18 16:00,2-1_all_corrected,76,53,397,123,473,176
181228,30086_20190818175954.jpg,テックランド大阪りんくう,1000,和泉,30,り,2019/8/18 17:59,2-1_all_corrected,58,44,241,156,299,200
181025,30110_20190818164641.jpg,イオン金沢八景,**33,横浜,31,ひ,2019/8/18 16:46,2-1_all_corrected,70,67,491,203,561,270
181244,30167_20190818180542.jpg,イオン東雲店,9098,足立,502,わ,2019/8/18 18:05,2-1_all_corrected,75,67,91,116,166,183
181082,30110_20190818170825.jpg,イオン金沢八景,*512,福岡,336,な,2019/8/18 17:07,2-1_all_corrected,50,47,30,151,80,198
181424,30078_20190818192653.jpg,イオンスタイル仙台卸町店,2674,宮城,-1,さ,2019/8/18 19:26,2-1_all_corrected,81,56,249,234,330,290
180730,30169_20190818145448.jpg,イオン相模原ショッピングセンター,1105,相模,537,ね,2019/8/18 14:54,2-1_all_corrected,91,70,259,157,350,227
180708,30039_20190818144543.jpg,イトーヨーカドー大井町,2213,品川,580,く,2019/8/18 14:45,2-1_all_corrected,64,60,185,109,249,169
180754,30145_20190818150318.jpg,イオン高根木戸,*565,練馬,501,む,2019/8/18 15:02,2-1_all_corrected,65,54,211,193,276,247
180308,30110_20190818115821.jpg,イオン金沢八景,7022,横浜,580,そ,2019/8/18 11:57,2-1_all_corrected,54,39,329,134,383,173
180798,30078_20190818151647.jpg,イオンスタイル仙台卸町店,1188,仙台,536,も,2019/8/18 15:16,2-1_all_corrected,98,74,177,376,275,450
181211,30072_20190818175209.jpg,関西スーパー京阪大和田１F,9694,大阪,501,ら,2019/8/18 17:51,2-1_all_corrected,78,61,33,238,111,299
180930,30169_20190818160918.jpg,イオン相模原ショッピングセンター,*112,多摩,301,ろ,2019/8/18 16:08,2-1_all_corrected,86,71,365,313,451,384
181482,30090_20190818200404.jpg,イトーヨーカドー木場 西棟,*460,世田谷,100,あ,2019/8/18 20:03,2-1_all_corrected,50,41,253,162,303,203
180762,30110_20190818150654.jpg,イオン金沢八景,2567,横浜,504,ひ,2019/8/18 15:06,2-1_all_corrected,70,57,222,232,292,289
181079,30167_20190818170746.jpg,イオン東雲店,1447,野田,500,ろ,2019/8/18 17:07,2-1_all_corrected,41,34,315,204,356,238
181287,30111_20190818182302.jpg,イオン稲毛,4060,千葉,503,と,2019/8/18 18:22,2-1_all_corrected,46,34,71,98,117,132
181617,30167_20190818223736.jpg,イオン東雲店,8470,八戸,500,ま,2019/8/18 22:37,2-1_all_corrected,61,43,394,346,455,389
181273,30060_20190818181912.jpg,関西スーパー小野原,4333,大阪,302,ゆ,2019/8/18 18:18,2-1_all_corrected,64,70,535,288,599,358
180707,30103_20190818144523.jpg,八尾老原１丁目,***7,大阪,30,ひ,2019/8/18 14:45,2-1_all_corrected,64,59,63,192,127,251
181083,30144_20190818170833.jpg,イオン幕張,*211,千葉,340,そ,2019/8/18 17:08,2-1_all_corrected,59,42,234,170,293,212
180738,30169_20190818145709.jpg,イオン相模原ショッピングセンター,1001,八王子,357,も,2019/8/18 14:56,2-1_all_corrected,85,64,316,74,401,138
181070,30144_20190818170411.jpg,イオン幕張,4507,足立,302,ね,2019/8/18 17:03,2-1_all_corrected,73,52,196,216,269,268
181289,30169_20190818182351.jpg,イオン相模原ショッピングセンター,1237,相模,331,ち,2019/8/18 18:23,2-1_all_corrected,71,57,366,180,437,237
180216,30169_20190818111641.jpg,イオン相模原ショッピングセンター,6493,相模,580,め,2019/8/18 11:16,2-1_all_corrected,93,74,265,261,358,335
180686,30110_20190818143733.jpg,イオン金沢八景,1225,横浜,563,ひ,2019/8/18 14:37,2-1_all_corrected,55,47,162,211,217,258
181308,30111_20190818183111.jpg,イオン稲毛,6911,千葉,530,に,2019/8/18 18:30,2-1_all_corrected,58,38,336,133,394,171
181133,30070_20190818172259.jpg,カナートモール住道第一,***8,大阪,30,ま,2019/8/18 17:22,2-1_all_corrected,81,59,464,277,545,336
180643,30144_20190818142558.jpg,イオン幕張,4356,千葉,580,の,2019/8/18 14:25,2-1_all_corrected,48,43,95,165,143,208
180227,30144_20190818112246.jpg,イオン幕張,5385,千葉,302,ぬ,2019/8/18 11:22,2-1_all_corrected,54,38,154,128,208,166
180811,30144_20190818152532.jpg,イオン幕張,2227,千葉,332,は,2019/8/18 15:25,2-1_all_corrected,47,35,151,85,198,120
180220,30110_20190818111755.jpg,イオン金沢八景,**77,横浜,547,み,2019/8/18 11:17,2-1_all_corrected,64,60,132,201,196,261
181134,30144_20190818172326.jpg,イオン幕張,8526,横浜,330,の,2019/8/18 17:23,2-1_all_corrected,78,60,342,282,420,342
181355,30091_20190818185423.jpg,イトーヨーカドー木場 立体,*203,足立,334,て,2019/8/18 18:53,2-1_all_corrected,71,60,345,157,416,217
181535,30110_20190818204028.jpg,イオン金沢八景,7535,横浜,583,つ,2019/8/18 20:39,2-1_all_corrected,56,45,394,106,450,151
181363,30110_20190818185751.jpg,イオン金沢八景,*213,横浜,339,す,2019/8/18 18:57,2-1_all_corrected,74,94,4,326,78,420
181364,30078_20190818185832.jpg,イオンスタイル仙台卸町店,**18,仙台,584,を,2019/8/18 18:58,2-1_all_corrected,83,63,159,225,242,288
181551,30111_20190818205801.jpg,イオン稲毛,2459,千葉,302,ね,2019/8/18 20:57,2-1_all_corrected,48,37,117,118,165,155
180828,30110_20190818153440.jpg,イオン金沢八景,***8,横浜,386,と,2019/8/18 15:34,2-1_all_corrected,53,46,501,96,554,142
180484,30045_20190818132926.jpg,マックスバリュー徳川明倫,**11,名古屋,31,め,2019/8/18 13:28,2-1_all_corrected,68,59,125,203,193,262
181556,30103_20190818210220.jpg,八尾老原１丁目,*855,なにわ,301,ひ,2019/8/18 21:01,2-1_all_corrected,58,42,307,208,365,250
181103,30167_20190818171434.jpg,イオン東雲店,*313,野田,583,み,2019/8/18 17:14,2-1_all_corrected,75,60,165,227,240,287
181567,30078_20190818211010.jpg,イオンスタイル仙台卸町店,7000,仙台,336,ゆ,2019/8/18 21:09,2-1_all_corrected,83,55,278,237,361,292
180441,30110_20190818130828.jpg,イオン金沢八景,*320,横浜,363,る,2019/8/18 13:08,2-1_all_corrected,73,55,260,195,333,250
180819,30110_20190818152834.jpg,イオン金沢八景,3885,横浜,304,ひ,2019/8/18 15:28,2-1_all_corrected,45,37,156,155,201,192
181533,30169_20190818203942.jpg,イオン相模原ショッピングセンター,***5,相模,361,ゆ,2019/8/18 20:39,2-1_all_corrected,97,86,76,326,173,412
180881,30041_20190818155102.jpg,ライフ宮内,*620,川崎,335,ね,2019/8/18 15:50,2-1_all_corrected,67,61,430,260,497,321
180424,30169_20190818130138.jpg,イオン相模原ショッピングセンター,2008,相模,502,ち,2019/8/18 13:01,2-1_all_corrected,89,68,265,147,354,215
180272,30110_20190818113910.jpg,イオン金沢八景,2169,横浜,580,も,2019/8/18 11:38,2-1_all_corrected,45,33,477,136,522,169
180286,30144_20190818114644.jpg,イオン幕張,1717,千葉,368,と,2019/8/18 11:46,2-1_all_corrected,53,38,194,122,247,160
180275,30091_20190818114017.jpg,イトーヨーカドー木場 立体,1337,足立,302,ひ,2019/8/18 11:39,2-1_all_corrected,70,55,188,214,258,269
180423,30167_20190818130125.jpg,イオン東雲店,8000,足立,505,ひ,2019/8/18 13:00,2-1_all_corrected,56,44,309,167,365,211
181398,30045_20190818191529.jpg,マックスバリュー徳川明倫,**77,名古屋,31,ほ,2019/8/18 19:15,2-1_all_corrected,82,63,191,223,273,286
180257,30111_20190818113248.jpg,イオン稲毛,7908,千葉,581,ち,2019/8/18 11:32,2-1_all_corrected,66,57,209,176,275,233
181520,30039_20190818202708.jpg,イトーヨーカドー大井町,***2,足立,343,せ,2019/8/18 20:26,2-1_all_corrected,69,60,228,197,297,257
181144,30144_20190818172804.jpg,イオン幕張,1211,千葉,536,ゆ,2019/8/18 17:27,2-1_all_corrected,81,58,312,318,393,376
180430,30167_20190818130310.jpg,イオン東雲店,7367,足立,302,た,2019/8/18 13:02,2-1_all_corrected,93,73,28,333,121,406
180850,30144_20190818154348.jpg,イオン幕張,1417,千葉,580,ぬ,2019/8/18 15:43,2-1_all_corrected,77,56,178,254,255,310
181121,30144_20190818171924.jpg,イオン幕張,7215,千葉,331,に,2019/8/18 17:18,2-1_all_corrected,72,49,282,240,354,289
180499,30066_20190818133239.jpg,ジョーシン和泉中央,**55,和泉,31,ち,2019/8/18 13:32,2-1_all_corrected,68,59,205,193,273,252
180667,30144_20190818143424.jpg,イオン幕張,***7,野田,586,を,2019/8/18 14:34,2-1_all_corrected,59,39,218,187,277,226
180832,30169_20190818153723.jpg,イオン相模原ショッピングセンター,***1,相模,803,と,2019/8/18 15:36,2-1_all_corrected,71,52,305,149,376,201
180436,30144_20190818130558.jpg,イオン幕張,1120,千葉,349,り,2019/8/18 13:05,2-1_all_corrected,53,37,162,85,215,122
181341,30156_20190818184629.jpg,万代 西神中央店,1123,神戸,360,ら,2019/8/18 18:46,2-1_all_corrected,54,43,374,251,428,294
180431,30086_20190818130328.jpg,テックランド大阪りんくう,***3,和泉,30,と,2019/8/18 13:03,2-1_all_corrected,50,38,348,164,398,202
181187,30169_20190818174213.jpg,イオン相模原ショッピングセンター,8585,多摩,580,も,2019/8/18 17:41,2-1_all_corrected,93,70,260,268,353,338
181348,30144_20190818185107.jpg,イオン幕張,4902,千葉,503,せ,2019/8/18 18:50,2-1_all_corrected,59,44,230,167,289,211
181383,30169_20190818190907.jpg,イオン相模原ショッピングセンター,6886,多摩,583,こ,2019/8/18 19:08,2-1_all_corrected,56,43,106,117,162,160
180632,30078_20190818142046.jpg,イオンスタイル仙台卸町店,2799,いわき,330,さ,2019/8/18 14:20,2-1_all_corrected,84,60,333,304,417,364
180256,30144_20190818113154.jpg,イオン幕張,7246,習志野,530,さ,2019/8/18 11:31,2-1_all_corrected,61,43,253,154,314,197
180692,30078_20190818144015.jpg,イオンスタイル仙台卸町店,4235,仙台,580,あ,2019/8/18 14:39,2-1_all_corrected,69,48,279,112,348,160
180661,30144_20190818143214.jpg,イオン幕張,1008,千葉,541,た,2019/8/18 14:31,2-1_all_corrected,69,51,225,194,294,245
180498,30111_20190818133215.jpg,イオン稲毛,2631,袖ヶ浦,583,き,2019/8/18 13:31,2-1_all_corrected,44,35,52,105,96,140
180802,30038_20190818151752.jpg,ザ・ダイソー東大和,*612,多摩,584,ま,2019/8/18 15:17,2-1_all_corrected,50,44,324,125,374,169
180379,30169_20190818124020.jpg,イオン相模原ショッピングセンター,3484,相模,580,も,2019/8/18 12:39,2-1_all_corrected,82,66,269,116,351,182
181258,30078_20190818180917.jpg,イオンスタイル仙台卸町店,1210,仙台,332,と,2019/8/18 18:08,2-1_all_corrected,97,69,384,378,481,447
180517,30167_20190818133809.jpg,イオン東雲店,1122,足立,564,ゆ,2019/8/18 13:36,2-1_all_corrected,73,56,219,214,292,270
181431,30111_20190818192943.jpg,イオン稲毛,9078,千葉,580,ゆ,2019/8/18 19:29,2-1_all_corrected,51,39,126,119,177,158
181407,30157_20190818191907.jpg,関西スーパー中央,*314,神戸,547,な,2019/8/18 19:18,2-1_all_corrected,70,55,231,327,301,382
180941,30144_20190818161313.jpg,イオン幕張,8686,千葉,338,み,2019/8/18 16:12,2-1_all_corrected,44,33,179,55,223,88
180575,30151_20190818140419.jpg,テックランド今福東店,*117,なにわ,538,り,2019/8/18 14:03,2-1_all_corrected,72,52,238,132,310,184
180747,30083_20190818150108.jpg,フォーエルナゴヤドーム駅前,**23,名古屋,31,さ,2019/8/18 15:00,2-1_all_corrected,41,45,294,181,335,226
181037,30078_20190818165118.jpg,イオンスタイル仙台卸町店,***5,仙台,346,そ,2019/8/18 16:50,2-1_all_corrected,82,61,426,306,508,367
180778,30066_20190818151212.jpg,ジョーシン和泉中央,**33,和泉,31,も,2019/8/18 15:11,2-1_all_corrected,76,64,173,258,249,322
181233,30091_20190818180129.jpg,イトーヨーカドー木場 立体,7777,神戸,361,ゆ,2019/8/18 18:01,2-1_all_corrected,86,65,481,250,567,315
180776,30041_20190818151056.jpg,ライフ宮内,8888,川崎,510,す,2019/8/18 15:10,2-1_all_corrected,65,60,514,257,579,317
181039,30001_20190818165135.jpg,関西スーパー高石駅前,4932,和泉,580,よ,2019/8/18 16:51,2-1_all_corrected,80,54,255,159,335,213
180923,30167_20190818160514.jpg,イオン東雲店,*673,春日部,880,り,2019/8/18 16:04,2-1_all_corrected,69,62,88,235,157,297
181065,30169_20190818170033.jpg,イオン相模原ショッピングセンター,**11,多摩,368,ほ,2019/8/18 17:00,2-1_all_corrected,53,40,248,187,301,227
181439,30079_20190818193437.jpg,ピットデザイン仙台卸町駅前駐車場,8000,相模,343,ふ,2019/8/18 19:34,2-1_all_corrected,74,84,15,262,89,346
180985,30110_20190818163044.jpg,イオン金沢八景,1322,横浜,531,む,2019/8/18 16:30,2-1_all_corrected,44,33,295,56,339,89
181259,30144_20190818181103.jpg,イオン幕張,*115,千葉,349,も,2019/8/18 18:10,2-1_all_corrected,44,33,168,48,212,81
181430,30111_20190818192937.jpg,イオン稲毛,2657,千葉,503,せ,2019/8/18 19:28,2-1_all_corrected,47,38,95,115,142,153
181292,30085_20190818182609.jpg,業務スーパー南津守,1001,なにわ,31,ね,2019/8/18 18:25,2-1_all_corrected,57,44,292,227,349,271
180723,30169_20190818145312.jpg,イオン相模原ショッピングセンター,*104,相模,580,け,2019/8/18 14:52,2-1_all_corrected,81,70,263,111,344,181
181261,30105_20190818181121.jpg,カスミフードスクエア春日部武里,6689,春日部,301,ふ,2019/8/18 18:10,2-1_all_corrected,57,30,208,188,265,218
180922,30169_20190818160451.jpg,イオン相模原ショッピングセンター,6165,相模,502,ね,2019/8/18 16:04,2-1_all_corrected,72,62,256,174,328,236
180589,30090_20190818140640.jpg,イトーヨーカドー木場 西棟,7088,足立,330,み,2019/8/18 14:06,2-1_all_corrected,81,59,103,317,184,376
180779,30090_20190818151215.jpg,イトーヨーカドー木場 西棟,1000,横浜,30,ひ,2019/8/18 15:11,2-1_all_corrected,59,42,204,199,263,241
181203,30144_20190818174938.jpg,イオン幕張,7979,千葉,530,そ,2019/8/18 17:49,2-1_all_corrected,83,66,306,328,389,394
180914,30144_20190818160216.jpg,イオン幕張,7162,千葉,502,ら,2019/8/18 16:01,2-1_all_corrected,82,64,308,329,390,393
180395,30110_20190818124755.jpg,イオン金沢八景,2722,福岡,301,ま,2019/8/18 12:47,2-1_all_corrected,75,57,237,210,312,267
180361,30110_20190818122902.jpg,イオン金沢八景,4544,横浜,581,い,2019/8/18 12:28,2-1_all_corrected,69,56,251,140,320,196
181278,30078_20190818182006.jpg,イオンスタイル仙台卸町店,*328,仙台,330,て,2019/8/18 18:19,2-1_all_corrected,85,72,123,334,208,406
180950,30110_20190818161630.jpg,イオン金沢八景,4609,横浜,580,も,2019/8/18 16:16,2-1_all_corrected,49,41,450,115,499,156
180961,30110_20190818162142.jpg,イオン金沢八景,2958,横浜,530,と,2019/8/18 16:21,2-1_all_corrected,81,57,274,299,355,356
180357,30078_20190818122611.jpg,イオンスタイル仙台卸町店,9789,仙台,500,ね,2019/8/18 12:25,2-1_all_corrected,79,55,295,213,374,268
180959,30111_20190818162054.jpg,イオン稲毛,8298,千葉,500,て,2019/8/18 16:20,2-1_all_corrected,36,31,44,68,80,99
181088,30110_20190818171003.jpg,イオン金沢八景,1225,横浜,547,せ,2019/8/18 17:09,2-1_all_corrected,43,34,322,53,365,87
180935,30110_20190818161123.jpg,イオン金沢八景,4045,横浜,504,ふ,2019/8/18 16:10,2-1_all_corrected,48,42,40,162,88,204
180599,30167_20190818140903.jpg,イオン東雲店,2519,足立,530,た,2019/8/18 14:08,2-1_all_corrected,68,54,224,180,292,234
180760,30070_20190818150622.jpg,カナートモール住道第一,**55,大阪,31,す,2019/8/18 15:05,2-1_all_corrected,72,54,423,166,495,220
180769,30062_20190818150914.jpg,ミスミモール,***3,神戸,30,ふ,2019/8/18 15:08,2-1_all_corrected,73,59,218,193,291,252
180332,30144_20190818121107.jpg,イオン幕張,3272,千葉,503,ち,2019/8/18 12:10,2-1_all_corrected,87,63,244,322,331,385
180756,30144_20190818150342.jpg,イオン幕張,8178,千葉,530,の,2019/8/18 15:03,2-1_all_corrected,88,65,309,356,397,421
180751,30169_20190818150233.jpg,イオン相模原ショッピングセンター,9192,相模,301,ふ,2019/8/18 15:02,2-1_all_corrected,80,62,303,82,383,144
180500,30091_20190818133244.jpg,イトーヨーカドー木場 立体,***5,千葉,381,ら,2019/8/18 13:32,2-1_all_corrected,87,66,110,316,197,382
180993,30041_20190818163337.jpg,ライフ宮内,*316,川崎,336,つ,2019/8/18 16:33,2-1_all_corrected,88,68,482,360,570,428
181073,30144_20190818170617.jpg,イオン幕張,7675,千葉,330,と,2019/8/18 17:05,2-1_all_corrected,53,39,188,94,241,133
180367,30144_20190818123318.jpg,イオン幕張,*867,千葉,580,ほ,2019/8/18 12:32,2-1_all_corrected,54,42,150,116,204,158
181246,30167_20190818180605.jpg,イオン東雲店,9098,足立,502,わ,2019/8/18 18:05,2-1_all_corrected,83,65,45,319,128,384
181622,30167_20190818225049.jpg,イオン東雲店,9632,足立,503,わ,2019/8/18 22:50,2-1_all_corrected,50,39,299,247,349,286
181410,30167_20190818192120.jpg,イオン東雲店,**11,足立,31,ら,2019/8/18 19:20,2-1_all_corrected,69,52,388,330,457,382
180334,30110_20190818121253.jpg,イオン金沢八景,5927,横浜,505,に,2019/8/18 12:12,2-1_all_corrected,52,44,160,126,212,170
181018,30072_20190818164424.jpg,関西スーパー京阪大和田１F,2525,大阪,784,く,2019/8/18 16:43,2-1_all_corrected,46,37,332,25,378,62
180591,30111_20190818140724.jpg,イオン稲毛,8882,千葉,581,う,2019/8/18 14:06,2-1_all_corrected,55,41,328,151,383,192
180757,30091_20190818150431.jpg,イトーヨーカドー木場 立体,3696,習志野,330,さ,2019/8/18 15:04,2-1_all_corrected,47,34,298,148,345,182
180934,30167_20190818161121.jpg,イオン東雲店,*530,足立,338,せ,2019/8/18 16:10,2-1_all_corrected,50,38,296,155,346,193
180933,30144_20190818161103.jpg,イオン幕張,*124,千葉,535,と,2019/8/18 16:10,2-1_all_corrected,59,38,198,152,257,190
180792,30144_20190818151513.jpg,イオン幕張,7777,習志野,328,ち,2019/8/18 15:14,2-1_all_corrected,69,53,233,208,302,261
181190,30111_20190818174401.jpg,イオン稲毛,*912,千葉,333,ろ,2019/8/18 17:43,2-1_all_corrected,55,46,211,141,266,187
180613,30169_20190818141351.jpg,イオン相模原ショッピングセンター,7310,横浜,583,い,2019/8/18 14:13,2-1_all_corrected,85,66,289,225,374,291
181163,30144_20190818173427.jpg,イオン幕張,8883,千葉,502,は,2019/8/18 17:34,2-1_all_corrected,61,43,249,204,310,247
180846,30111_20190818154248.jpg,イオン稲毛,1032,千葉,503,た,2019/8/18 15:41,2-1_all_corrected,46,35,109,95,155,130
181367,30063_20190818190135.jpg,コーナン相模原小山モール,8207,相模,301,め,2019/8/18 19:00,2-1_all_corrected,61,59,506,157,567,216
181152,30167_20190818173109.jpg,イオン東雲店,9886,足立,301,ゆ,2019/8/18 17:30,2-1_all_corrected,85,66,170,289,255,355
180279,30090_20190818114301.jpg,イトーヨーカドー木場 西棟,*340,足立,502,す,2019/8/18 11:42,2-1_all_corrected,77,56,314,277,391,333
180443,30078_20190818130928.jpg,イオンスタイル仙台卸町店,***1,仙台,582,い,2019/8/18 13:08,2-1_all_corrected,53,40,260,142,313,182
180815,30144_20190818152716.jpg,イオン幕張,8734,千葉,330,に,2019/8/18 15:26,2-1_all_corrected,57,42,182,140,239,182
180640,30044_20190818142448.jpg,ココス横浜港南台,***7,横浜,30,て,2019/8/18 14:24,2-1_all_corrected,101,59,361,275,462,334
180411,30144_20190818125503.jpg,イオン幕張,1976,千葉,531,ほ,2019/8/18 12:54,2-1_all_corrected,58,42,158,141,216,183
181361,30144_20190818185733.jpg,イオン幕張,*917,千葉,537,つ,2019/8/18 18:57,2-1_all_corrected,71,55,174,170,245,225
180416,30091_20190818125820.jpg,イトーヨーカドー木場 立体,3696,習志野,330,さ,2019/8/18 12:57,2-1_all_corrected,52,38,361,158,413,196
180624,30167_20190818141853.jpg,イオン東雲店,5392,足立,302,て,2019/8/18 14:18,2-1_all_corrected,83,65,152,289,235,354
180871,30144_20190818154921.jpg,イオン幕張,5827,練馬,330,た,2019/8/18 15:48,2-1_all_corrected,50,40,149,123,199,163
180271,30110_20190818113847.jpg,イオン金沢八景,1261,横浜,71,め,2019/8/18 11:38,2-1_all_corrected,77,65,148,195,225,260
180418,30110_20190818125942.jpg,イオン金沢八景,5961,横浜,304,て,2019/8/18 12:59,2-1_all_corrected,79,63,230,210,309,273
180641,30144_20190818142453.jpg,イオン幕張,8483,多摩,300,て,2019/8/18 14:24,2-1_all_corrected,81,52,257,249,338,301
181131,30167_20190818172136.jpg,イオン東雲店,9699,足立,501,ほ,2019/8/18 17:21,2-1_all_corrected,95,73,78,352,173,425
180646,30144_20190818142647.jpg,イオン幕張,***5,千葉,389,ふ,2019/8/18 14:26,2-1_all_corrected,58,43,228,167,286,210
180684,30169_20190818143726.jpg,イオン相模原ショッピングセンター,7667,相模,580,つ,2019/8/18 14:37,2-1_all_corrected,56,43,435,15,491,58
180670,30078_20190818143438.jpg,イオンスタイル仙台卸町店,***1,仙台,582,ひ,2019/8/18 14:34,2-1_all_corrected,74,55,221,172,295,227
181590,30169_20190818214006.jpg,イオン相模原ショッピングセンター,1104,相模,583,く,2019/8/18 21:39,2-1_all_corrected,84,64,274,131,358,195
180213,30014_20190818111409.jpg,フォルテ蘇我ベルク棟,***3,千葉,30,ち,2019/8/18 11:13,2-1_all_corrected,77,57,257,114,334,171
181335,30144_20190818184421.jpg,イオン幕張,4970,千葉,580,す,2019/8/18 18:43,2-1_all_corrected,40,33,204,121,244,154
181125,30110_20190818171942.jpg,イオン金沢八景,5056,足立,580,く,2019/8/18 17:19,2-1_all_corrected,55,43,265,147,320,190
181546,30072_20190818205150.jpg,関西スーパー京阪大和田１F,**15,大阪,546,ら,2019/8/18 20:51,2-1_all_corrected,54,43,184,137,238,180
181122,30045_20190818171928.jpg,マックスバリュー徳川明倫,*358,名古屋,32,と,2019/8/18 17:19,2-1_all_corrected,47,38,332,146,379,184
180236,30144_20190818112544.jpg,イオン幕張,9920,千葉,300,ふ,2019/8/18 11:25,2-1_all_corrected,89,61,225,358,314,419
180209,30144_20190818111221.jpg,イオン幕張,4693,習志野,501,ぬ,2019/8/18 11:11,2-1_all_corrected,50,33,84,106,134,139
181570,30105_20190818211353.jpg,カスミフードスクエア春日部武里,**21,春日部,587,ふ,2019/8/18 21:13,2-1_all_corrected,70,63,136,278,206,341
181319,30103_20190818183704.jpg,八尾老原１丁目,8008,和泉,31,は,2019/8/18 18:36,2-1_all_corrected,88,60,322,312,410,372
181577,30090_20190818211809.jpg,イトーヨーカドー木場 西棟,*724,足立,533,せ,2019/8/18 21:17,2-1_all_corrected,83,64,330,334,413,398
180405,30090_20190818124928.jpg,イトーヨーカドー木場 西棟,2901,足立,301,る,2019/8/18 12:49,2-1_all_corrected,56,44,305,177,361,221
180637,30090_20190818142151.jpg,イトーヨーカドー木場 西棟,5918,品川,330,ま,2019/8/18 14:21,2-1_all_corrected,73,54,281,208,354,262
181375,30090_20190818190348.jpg,イトーヨーカドー木場 西棟,1818,品川,363,せ,2019/8/18 19:03,2-1_all_corrected,67,58,365,223,432,281
181176,30167_20190818173734.jpg,イオン東雲店,6086,横浜,304,ほ,2019/8/18 17:37,2-1_all_corrected,49,35,316,128,365,163
181182,30110_20190818174108.jpg,イオン金沢八景,1221,横浜,360,や,2019/8/18 17:40,2-1_all_corrected,52,49,49,174,101,223
180854,30144_20190818154538.jpg,イオン幕張,4159,千葉,300,み,2019/8/18 15:45,2-1_all_corrected,54,40,187,106,241,146
181388,30167_20190818191121.jpg,イオン東雲店,5640,足立,302,ら,2019/8/18 19:10,2-1_all_corrected,46,36,295,243,341,279
181343,30078_20190818184733.jpg,イオンスタイル仙台卸町店,9119,仙台,530,そ,2019/8/18 18:47,2-1_all_corrected,95,68,198,355,293,423
181515,30169_20190818202312.jpg,イオン相模原ショッピングセンター,1277,相模,301,ぬ,2019/8/18 20:22,2-1_all_corrected,78,71,439,275,517,346
181112,30157_20190818171718.jpg,関西スーパー中央,*492,神戸,481,り,2019/8/18 17:16,2-1_all_corrected,52,42,161,362,213,404
180206,30110_20190818111046.jpg,イオン金沢八景,*867,横浜,303,と,2019/8/18 11:10,2-1_all_corrected,41,32,514,74,555,106
181549,30105_20190818205541.jpg,カスミフードスクエア春日部武里,8463,春日部,300,ろ,2019/8/18 20:55,2-1_all_corrected,52,40,163,162,215,202
181571,30111_20190818211437.jpg,イオン稲毛,2506,千葉,330,や,2019/8/18 21:14,2-1_all_corrected,52,41,140,103,192,144
181123,30144_20190818171933.jpg,イオン幕張,2014,千葉,533,ゆ,2019/8/18 17:19,2-1_all_corrected,67,41,173,153,240,194
181311,30045_20190818183245.jpg,マックスバリュー徳川明倫,***3,名古屋,30,は,2019/8/18 18:32,2-1_all_corrected,54,44,229,154,283,198
181316,30144_20190818183535.jpg,イオン幕張,*882,千葉,330,の,2019/8/18 18:35,2-1_all_corrected,87,58,320,351,407,409
181329,30110_20190818184144.jpg,イオン金沢八景,7378,横浜,303,や,2019/8/18 18:41,2-1_all_corrected,75,63,357,281,432,344
180264,30110_20190818113600.jpg,イオン金沢八景,1827,横浜,304,に,2019/8/18 11:35,2-1_all_corrected,41,32,356,90,397,122
180435,30110_20190818130451.jpg,イオン金沢八景,*148,横浜,503,さ,2019/8/18 13:04,2-1_all_corrected,41,33,461,87,502,120
181345,30169_20190818184834.jpg,イオン相模原ショッピングセンター,3833,いわき,330,あ,2019/8/18 18:48,2-1_all_corrected,46,42,146,64,192,106
180403,30079_20190818124922.jpg,ピットデザイン仙台卸町駅前駐車場,3330,仙台,580,な,2019/8/18 12:49,2-1_all_corrected,44,29,372,68,416,97
181522,30078_20190818202726.jpg,イオンスタイル仙台卸町店,*721,仙台,332,つ,2019/8/18 20:26,2-1_all_corrected,54,40,251,5,305,45
181146,30078_20190818172925.jpg,イオンスタイル仙台卸町店,6597,仙台,580,に,2019/8/18 17:29,2-1_all_corrected,86,53,374,397,460,450
180744,30167_20190818145949.jpg,イオン東雲店,*222,品川,350,て,2019/8/18 14:59,2-1_all_corrected,70,54,233,201,303,255
181034,30144_20190818165032.jpg,イオン幕張,*178,習志野,338,ね,2019/8/18 16:50,2-1_all_corrected,70,51,134,185,204,236
181033,30144_20190818165026.jpg,イオン幕張,2009,千葉,331,ぬ,2019/8/18 16:50,2-1_all_corrected,89,54,310,253,399,307
181461,30045_20190818195112.jpg,マックスバリュー徳川明倫,**77,名古屋,31,ほ,2019/8/18 19:50,2-1_all_corrected,82,64,148,236,230,300
180547,30078_20190818134913.jpg,イオンスタイル仙台卸町店,3398,岩,56,て,2019/8/18 13:48,2-1_all_corrected,62,35,261,62,323,97
180775,30167_20190818151032.jpg,イオン東雲店,1628,足立,331,に,2019/8/18 15:10,2-1_all_corrected,85,67,115,286,200,353
181492,30167_20190818200759.jpg,イオン東雲店,8083,神戸,503,ゆ,2019/8/18 20:07,2-1_all_corrected,55,42,345,275,400,317
180540,30137_20190818134625.jpg,イオンスタイル品川シーサイド,**35,品川,-1,や,2019/8/18 13:45,2-1_all_corrected,57,41,228,21,285,62
180514,30110_20190818133722.jpg,イオン金沢八景,6044,横浜,581,こ,2019/8/18 13:36,2-1_all_corrected,69,56,347,212,416,268
181264,30167_20190818181322.jpg,イオン東雲店,7819,品川,330,の,2019/8/18 18:12,2-1_all_corrected,62,44,270,198,332,242
180345,30111_20190818121838.jpg,イオン稲毛,3543,大阪,503,ひ,2019/8/18 12:17,2-1_all_corrected,47,33,79,94,126,127
181058,30169_20190818165806.jpg,イオン相模原ショッピングセンター,**12,相模,339,の,2019/8/18 16:57,2-1_all_corrected,84,65,339,89,423,154
180942,30070_20190818161332.jpg,カナートモール住道第一,**55,大阪,31,す,2019/8/18 16:13,2-1_all_corrected,55,44,247,98,302,142
181403,30079_20190818191823.jpg,ピットデザイン仙台卸町駅前駐車場,***1,仙台,335,を,2019/8/18 19:17,2-1_all_corrected,50,40,435,94,485,134
180945,30090_20190818161422.jpg,イトーヨーカドー木場 西棟,*515,品川,366,の,2019/8/18 16:13,2-1_all_corrected,58,46,203,199,261,245
181252,30110_20190818180821.jpg,イオン金沢八景,6549,横浜,505,ち,2019/8/18 18:07,2-1_all_corrected,44,32,365,44,409,76
181003,30144_20190818163703.jpg,イオン幕張,4040,千葉,330,め,2019/8/18 16:36,2-1_all_corrected,54,40,189,119,243,159
180773,30167_20190818151011.jpg,イオン東雲店,1628,足立,331,に,2019/8/18 15:09,2-1_all_corrected,73,63,159,46,232,109
180546,30078_20190818134908.jpg,イオンスタイル仙台卸町店,3398,柏,56,て,2019/8/18 13:48,2-1_all_corrected,52,24,249,0,301,24
180579,30078_20190818140512.jpg,イオンスタイル仙台卸町店,3333,宮城,319,や,2019/8/18 14:04,2-1_all_corrected,54,43,178,56,232,99
180917,30022_20190818160255.jpg,業務スーパー平野駅前,**88,なにわ,31,と,2019/8/18 16:02,2-1_all_corrected,81,74,18,204,99,278
181238,30086_20190818180418.jpg,テックランド大阪りんくう,**33,和泉,31,に,2019/8/18 18:03,2-1_all_corrected,57,43,131,312,188,355
181061,30045_20190818165922.jpg,マックスバリュー徳川明倫,***8,名古屋,30,め,2019/8/18 16:58,2-1_all_corrected,52,39,283,133,335,172
180381,30078_20190818124057.jpg,イオンスタイル仙台卸町店,3657,仙台,580,き,2019/8/18 12:40,2-1_all_corrected,82,59,193,197,275,256
181092,30145_20190818171132.jpg,イオン高根木戸,*565,練馬,501,む,2019/8/18 17:11,2-1_all_corrected,58,43,240,197,298,240
180716,30066_20190818145110.jpg,ジョーシン和泉中央,8008,和泉,31,の,2019/8/18 14:50,2-1_all_corrected,83,63,158,274,241,337
181066,30144_20190818170102.jpg,イオン幕張,**12,足立,347,み,2019/8/18 17:00,2-1_all_corrected,57,42,180,159,237,201
180975,30110_20190818162626.jpg,イオン金沢八景,6886,横浜,303,も,2019/8/18 16:26,2-1_all_corrected,48,39,110,126,158,165
180720,30169_20190818145236.jpg,イオン相模原ショッピングセンター,*691,相模,501,み,2019/8/18 14:51,2-1_all_corrected,85,65,305,106,390,171
181434,30169_20190818193100.jpg,イオン相模原ショッピングセンター,*825,多摩,535,す,2019/8/18 19:30,2-1_all_corrected,88,70,460,377,548,447
180205,30085_20190818110944.jpg,業務スーパー南津守,*111,なにわ,30,は,2019/8/18 11:09,2-1_all_corrected,51,38,177,198,228,236
180986,30110_20190818163051.jpg,イオン金沢八景,*126,横浜,346,ち,2019/8/18 16:30,2-1_all_corrected,71,69,53,176,124,245
181057,30144_20190818165750.jpg,イオン幕張,7660,八戸,300,す,2019/8/18 16:57,2-1_all_corrected,75,53,304,284,379,337
181265,30090_20190818181422.jpg,イトーヨーカドー木場 西棟,***1,練馬,30,ぬ,2019/8/18 18:13,2-1_all_corrected,55,39,245,179,300,218
217699,30144_20190831181326.jpg,イオン幕張,7582,千葉,302.0,に,2019/8/31 18:13,2-1_all_corrected,82,55,228,299,310,354
217494,30110_20190831172452.jpg,イオン金沢八景,1515,富士山,500.0,す,2019/8/31 17:24,2-1_all_corrected,54,39,406,109,460,148
216546,30167_20190831140712.jpg,イオン東雲店,4704,足立,481.0,り,2019/8/31 14:06,2-1_all_corrected,66,60,225,237,291,297
218410,30144_20190831220733.jpg,イオン幕張,*560,千葉,301.0,ろ,2019/8/31 22:07,2-1_all_corrected,43,36,234,87,277,123
215901,30139_20190831105601.jpg,イオン板橋ショッピングセンター,***1,練馬,30.0,ね,2019/8/31 10:55,2-1_all_corrected,39,29,390,75,429,104
216317,30144_20190831125107.jpg,イオン幕張,2930,習志野,330.0,の,2019/8/31 12:50,2-1_all_corrected,73,56,174,227,247,283
218270,30090_20190831205051.jpg,イトーヨーカドー木場 西棟,*757,足立,330.0,は,2019/8/31 20:50,2-1_all_corrected,53,40,240,163,293,203
218284,30139_20190831210022.jpg,イオン板橋ショッピングセンター,1793,練馬,580.0,か,2019/8/31 20:59,2-1_all_corrected,100,76,357,306,457,382
216113,30139_20190831114902.jpg,イオン板橋ショッピングセンター,5024,練馬,480.0,れ,2019/8/31 11:48,2-1_all_corrected,81,67,378,356,459,423
216742,30110_20190831145020.jpg,イオン金沢八景,*534,横浜,530.0,と,2019/8/31 14:49,2-1_all_corrected,65,53,250,109,315,162
217630,30001_20190831180019.jpg,関西スーパー高石駅前,4932,和泉,580.0,よ,2019/8/31 18:00,2-1_all_corrected,65,42,285,106,350,148
217066,30144_20190831154943.jpg,イオン幕張,*346,千葉,302.0,つ,2019/8/31 15:49,2-1_all_corrected,60,42,230,128,290,170
215731,30167_20190831100320.jpg,イオン東雲店,4704,足立,481.0,り,2019/8/31 10:02,2-1_all_corrected,27,25,77,42,104,67
216375,30139_20190831130849.jpg,イオン板橋ショッピングセンター,*424,練馬,330.0,や,2019/8/31 13:08,2-1_all_corrected,74,59,229,208,303,267
216147,30110_20190831115607.jpg,イオン金沢八景,1601,横浜,502.0,ふ,2019/8/31 11:55,2-1_all_corrected,54,43,309,142,363,185
217433,30060_20190831171007.jpg,関西スーパー小野原,8196,神戸,503.0,せ,2019/8/31 17:09,2-1_all_corrected,67,58,454,233,521,291
217068,30072_20190831155002.jpg,関西スーパー京阪大和田１F,8189,大阪,581.0,ぬ,2019/8/31 15:48,2-1_all_corrected,112,88,88,310,200,398
218212,30063_20190831203147.jpg,コーナン相模原小山モール,4223,相模,300.0,ゆ,2019/8/31 20:31,2-1_all_corrected,68,59,152,135,220,194
215955,30167_20190831111645.jpg,イオン東雲店,*268,足立,330.0,り,2019/8/31 11:16,2-1_all_corrected,96,78,107,319,203,397
216720,30144_20190831144522.jpg,イオン幕張,3120,千葉,531.0,に,2019/8/31 14:44,2-1_all_corrected,59,41,232,150,291,191
217296,30144_20190831164348.jpg,イオン幕張,7156,足立,580.0,て,2019/8/31 16:43,2-1_all_corrected,59,39,145,172,204,211
216182,30046_20190831120249.jpg,マミーマート船橋日大[地上],*626,習志野,333.0,ほ,2019/8/31 12:02,2-1_all_corrected,56,41,252,174,308,215
218420,30103_20190831221239.jpg,八尾老原１丁目,**77,大阪,-1.0,ね,2019/8/31 22:12,2-1_all_corrected,97,67,398,311,495,378
217201,30110_20190831162308.jpg,イオン金沢八景,**18,横浜,555.0,さ,2019/8/31 16:22,2-1_all_corrected,50,40,247,88,297,128
215936,30144_20190831111047.jpg,イオン幕張,*987,千葉,480.0,れ,2019/8/31 11:10,2-1_all_corrected,83,63,316,336,399,399
216320,30144_20190831125128.jpg,イオン幕張,3988,千葉,532.0,は,2019/8/31 12:51,2-1_all_corrected,77,57,318,259,395,316
218088,30167_20190831194907.jpg,イオン東雲店,1098,多摩,500.0,ぬ,2019/8/31 19:48,2-1_all_corrected,74,62,106,230,180,292
218418,30111_20190831221049.jpg,イオン稲毛,1526,千葉,330.0,け,2019/8/31 22:10,2-1_all_corrected,51,40,169,99,220,139
218081,30167_20190831194542.jpg,イオン東雲店,*155,足立,331.0,ね,2019/8/31 19:45,2-1_all_corrected,73,55,210,240,283,295
216329,30144_20190831125423.jpg,イオン幕張,**66,千葉,345.0,ぬ,2019/8/31 12:53,2-1_all_corrected,55,41,177,125,232,166
215567,30114_20190831085608.jpg,イオン南行徳（立体）,1203,習志野,483.0,あ,2019/8/31 8:55,2-1_all_corrected,99,73,420,346,519,419
215799,30039_20190831102612.jpg,イトーヨーカドー大井町,1216,千葉,542.0,つ,2019/8/31 10:25,2-1_all_corrected,58,44,227,175,285,219
215938,30167_20190831111123.jpg,イオン東雲店,7411,足立,230.0,さ,2019/8/31 11:10,2-1_all_corrected,75,54,403,390,478,444
216781,30110_20190831145945.jpg,イオン金沢八景,3914,横浜,504.0,と,2019/8/31 14:59,2-1_all_corrected,75,58,221,178,296,236
216311,30078_20190831124933.jpg,イオンスタイル仙台卸町店,1122,仙台,347.0,む,2019/8/31 12:49,2-1_all_corrected,75,64,198,172,273,236
216513,30139_20190831135515.jpg,イオン板橋ショッピングセンター,5024,練馬,480.0,れ,2019/8/31 13:54,2-1_all_corrected,84,69,300,357,384,426
216177,30167_20190831120017.jpg,イオン東雲店,9515,足立,502.0,わ,2019/8/31 11:59,2-1_all_corrected,52,40,300,137,352,177
215739,30167_20190831100343.jpg,イオン東雲店,4704,足立,481.0,り,2019/8/31 10:03,2-1_all_corrected,56,44,259,228,315,272
217290,30144_20190831164217.jpg,イオン幕張,5419,千葉,302.0,せ,2019/8/31 16:41,2-1_all_corrected,55,39,110,132,165,171
217432,30168_20190831171000.jpg,イオン東雲店（屋上）,1125,横浜,554.0,ゆ,2019/8/31 17:09,2-1_all_corrected,77,57,401,124,478,181
217264,30070_20190831163703.jpg,カナートモール住道第一,1122,大阪,31.0,た,2019/8/31 16:36,2-1_all_corrected,51,43,161,113,212,156
216389,30114_20190831131256.jpg,イオン南行徳（立体）,**45,習志野,430.0,の,2019/8/31 13:12,2-1_all_corrected,81,61,100,335,181,396
218213,30168_20190831203151.jpg,イオン東雲店（屋上）,**33,足立,133.0,た,2019/8/31 20:31,2-1_all_corrected,48,40,214,63,262,103
215954,30072_20190831111630.jpg,関西スーパー京阪大和田１F,7139,大阪,530.0,つ,2019/8/31 11:16,2-1_all_corrected,36,24,214,0,250,24
216179,30144_20190831120146.jpg,イオン幕張,7604,千葉,580.0,む,2019/8/31 12:01,2-1_all_corrected,52,38,166,127,218,165
217897,30144_20190831185333.jpg,イオン幕張,**27,練馬,430.0,ゆ,2019/8/31 18:53,2-1_all_corrected,81,62,348,346,429,408
215708,30071_20190831095829.jpg,カナートモール住道第二,8888,大阪,30.0,た,2019/8/31 9:57,2-1_all_corrected,68,55,362,269,430,324
216525,30072_20190831140021.jpg,関西スーパー京阪大和田１F,1520,大阪,303.0,そ,2019/8/31 13:59,2-1_all_corrected,40,30,365,179,405,209
218162,30046_20190831201125.jpg,マミーマート船橋日大[地上],*529,習志野,502.0,そ,2019/8/31 20:10,2-1_all_corrected,43,35,258,47,301,82
217318,30169_20190831164721.jpg,イオン相模原ショッピングセンター,9374,相模,330.0,さ,2019/8/31 16:46,2-1_all_corrected,78,61,302,84,380,145
216457,30169_20190831133818.jpg,イオン相模原ショッピングセンター,*816,相模,583.0,ほ,2019/8/31 13:37,2-1_all_corrected,67,59,322,47,389,106
217929,30115_20190831190224.jpg,イオン南行徳（平面）,*714,習志野,584.0,い,2019/8/31 19:01,2-1_all_corrected,72,68,488,193,560,261
217571,30167_20190831174517.jpg,イオン東雲店,4886,足立,502.0,ね,2019/8/31 17:44,2-1_all_corrected,41,29,321,104,362,133
216239,30169_20190831122821.jpg,イオン相模原ショッピングセンター,7210,相模,530.0,ね,2019/8/31 12:27,2-1_all_corrected,89,67,281,112,370,179
218368,30067_20190831214232.jpg,ピットデザイン茨木宮島,8888,大阪,-1.0,ま,2019/8/31 21:42,2-1_all_corrected,56,43,247,124,303,167
217316,30144_20190831164658.jpg,イオン幕張,8518,千葉,330.0,な,2019/8/31 16:46,2-1_all_corrected,47,35,197,74,244,109
217786,30046_20190831182909.jpg,マミーマート船橋日大[地上],*821,習志野,534.0,む,2019/8/31 18:28,2-1_all_corrected,82,62,367,177,449,239
216005,30111_20190831112801.jpg,イオン稲毛,3364,千葉,500.0,つ,2019/8/31 11:25,2-1_all_corrected,42,35,61,82,103,117
216051,30111_20190831113533.jpg,イオン稲毛,4235,千葉,502.0,ふ,2019/8/31 11:33,2-1_all_corrected,53,43,205,148,258,191
217513,30111_20190831172916.jpg,イオン稲毛,*325,千葉,344.0,の,2019/8/31 17:26,2-1_all_corrected,65,54,283,169,348,223
218332,30169_20190831212045.jpg,イオン相模原ショッピングセンター,1045,多摩,553.0,て,2019/8/31 21:20,2-1_all_corrected,43,34,39,56,82,90
217342,30046_20190831165146.jpg,マミーマート船橋日大[地上],5678,習志野,400.0,と,2019/8/31 16:51,2-1_all_corrected,75,59,350,250,425,309
216056,30072_20190831113639.jpg,関西スーパー京阪大和田１F,**33,大阪,317.0,た,2019/8/31 11:35,2-1_all_corrected,83,71,421,302,504,373
217184,30139_20190831162015.jpg,イオン板橋ショッピングセンター,5665,練馬,501.0,も,2019/8/31 16:19,2-1_all_corrected,77,55,255,263,332,318
216069,30070_20190831114007.jpg,カナートモール住道第一,1212,大阪,31.0,ち,2019/8/31 11:39,2-1_all_corrected,79,57,201,161,280,218
217522,30144_20190831173146.jpg,イオン幕張,*632,千葉,330.0,ぬ,2019/8/31 17:31,2-1_all_corrected,71,50,166,195,237,245
216094,30139_20190831114536.jpg,イオン板橋ショッピングセンター,***1,練馬,30.0,ね,2019/8/31 11:45,2-1_all_corrected,57,43,259,120,316,163
217380,30103_20190831170038.jpg,八尾老原１丁目,9999,大阪,31.0,む,2019/8/31 17:00,2-1_all_corrected,80,58,275,247,355,305
216609,30072_20190831141957.jpg,関西スーパー京阪大和田１F,3270,大阪,581.0,に,2019/8/31 14:19,2-1_all_corrected,50,32,204,40,254,72
216631,30139_20190831142349.jpg,イオン板橋ショッピングセンター,***1,練馬,30.0,に,2019/8/31 14:23,2-1_all_corrected,72,53,211,262,283,315
217387,30115_20190831170159.jpg,イオン南行徳（平面）,*358,習志野,345.0,も,2019/8/31 17:01,2-1_all_corrected,42,31,265,74,307,105
216255,30072_20190831123310.jpg,関西スーパー京阪大和田１F,*111,大阪,782.0,ま,2019/8/31 12:32,2-1_all_corrected,80,63,22,153,102,216
218304,30136_20190831210658.jpg,イオンスタイル新百合ヶ丘,*100,多摩,337.0,た,2019/8/31 21:06,2-1_all_corrected,72,61,166,246,238,307
217926,30111_20190831190215.jpg,イオン稲毛,*309,千葉,503.0,ち,2019/8/31 19:01,2-1_all_corrected,56,46,233,165,289,211
216003,30062_20190831112801.jpg,ミスミモール,**18,神戸,31.0,ふ,2019/8/31 11:27,2-1_all_corrected,72,62,181,206,253,268
218356,30169_20190831213437.jpg,イオン相模原ショッピングセンター,3936,相模,502.0,そ,2019/8/31 21:34,2-1_all_corrected,86,75,397,333,483,408
216035,30072_20190831113148.jpg,関西スーパー京阪大和田１F,4134,堺,480.0,り,2019/8/31 11:30,2-1_all_corrected,82,66,193,305,275,371
217113,30001_20190831160118.jpg,関西スーパー高石駅前,2438,神戸,335.0,も,2019/8/31 16:00,2-1_all_corrected,87,64,281,161,368,225
217570,30072_20190831174516.jpg,関西スーパー京阪大和田１F,9764,大阪,300.0,わ,2019/8/31 17:44,2-1_all_corrected,84,67,8,204,92,271
217716,30167_20190831181707.jpg,イオン東雲店,*106,足立,530.0,く,2019/8/31 18:16,2-1_all_corrected,49,36,318,243,367,279
216630,30139_20190831142343.jpg,イオン板橋ショッピングセンター,*111,練馬,366.0,せ,2019/8/31 14:23,2-1_all_corrected,72,51,191,247,263,298
218305,30103_20190831210751.jpg,八尾老原１丁目,2868,ないわ,-1.0,ろ,2019/8/31 21:07,2-1_all_corrected,52,46,168,146,220,192
217711,30001_20190831181531.jpg,関西スーパー高石駅前,1208,和泉,586.0,さ,2019/8/31 18:15,2-1_all_corrected,58,41,431,59,489,100
217147,30139_20190831161045.jpg,イオン板橋ショッピングセンター,1515,練馬,347.0,そ,2019/8/31 16:10,2-1_all_corrected,94,66,317,372,411,438
216608,30136_20190831141931.jpg,イオンスタイル新百合ヶ丘,1200,品川,301.0,ぬ,2019/8/31 14:19,2-1_all_corrected,82,63,423,81,505,144
216298,30110_20190831124643.jpg,イオン金沢八景,7408,横浜,502.0,た,2019/8/31 12:46,2-1_all_corrected,73,60,247,197,320,257
217944,30111_20190831190600.jpg,イオン稲毛,1236,千葉,532.0,む,2019/8/31 19:05,2-1_all_corrected,68,55,397,211,465,266
215845,30163_20190831104037.jpg,コープ葛飾白鳥店(地上),***8,足立,30.0,す,2019/8/31 10:40,2-1_all_corrected,57,47,220,108,277,155
216433,30014_20190831132821.jpg,フォルテ蘇我ベルク棟,***1,千葉,30.0,も,2019/8/31 13:27,2-1_all_corrected,54,49,160,64,214,113
217185,30110_20190831162028.jpg,イオン金沢八景,7285,横浜,583.0,え,2019/8/31 16:20,2-1_all_corrected,73,59,338,267,411,326
217171,30144_20190831161650.jpg,イオン幕張,7520,千葉,502.0,た,2019/8/31 16:16,2-1_all_corrected,50,34,208,87,258,121
217727,30139_20190831182001.jpg,イオン板橋ショッピングセンター,4725,練馬,501.0,め,2019/8/31 18:19,2-1_all_corrected,74,56,245,248,319,304
217515,30137_20190831172922.jpg,イオンスタイル品川シーサイド,*314,千葉,342.0,て,2019/8/31 17:28,2-1_all_corrected,81,70,514,371,595,441
217512,30062_20190831172902.jpg,ミスミモール,1010,神戸,31.0,ひ,2019/8/31 17:28,2-1_all_corrected,73,62,168,205,241,267
216296,30111_20190831124600.jpg,イオン稲毛,9077,千葉,300.0,つ,2019/8/31 12:45,2-1_all_corrected,54,47,245,145,299,192
217176,30078_20190831161816.jpg,イオンスタイル仙台卸町店,*310,仙台,341.0,む,2019/8/31 16:17,2-1_all_corrected,77,58,314,193,391,251
218101,30169_20190831195304.jpg,イオン相模原ショッピングセンター,***3,多摩,30.0,の,2019/8/31 19:52,2-1_all_corrected,48,34,251,172,299,206
218311,30145_20190831210959.jpg,イオン高根木戸,1121,横浜,530.0,ら,2019/8/31 21:09,2-1_all_corrected,57,39,287,123,344,162
217530,30144_20190831173246.jpg,イオン幕張,3038,千葉,530.0,ち,2019/8/31 17:32,2-1_all_corrected,84,52,209,304,293,356
217508,30111_20190831172811.jpg,イオン稲毛,3605,袖ヶ浦,100.0,さ,2019/8/31 17:25,2-1_all_corrected,53,42,212,133,265,175
216075,30139_20190831114211.jpg,イオン板橋ショッピングセンター,6105,練馬,480.0,れ,2019/8/31 11:41,2-1_all_corrected,76,65,328,293,404,358
216623,30136_20190831142228.jpg,イオンスタイル新百合ヶ丘,4820,川崎,300.0,る,2019/8/31 14:21,2-1_all_corrected,69,55,516,48,585,103
216427,30114_20190831132709.jpg,イオン南行徳（立体）,8008,習志野,394.0,と,2019/8/31 13:26,2-1_all_corrected,73,57,158,257,231,314
217501,30110_20190831172604.jpg,イオン金沢八景,7256,横浜,503.0,つ,2019/8/31 17:25,2-1_all_corrected,86,67,287,226,373,293
217733,30144_20190831182156.jpg,イオン幕張,5115,千葉,301.0,め,2019/8/31 18:21,2-1_all_corrected,91,68,360,378,451,446
215858,30137_20190831104441.jpg,イオンスタイル品川シーサイド,**54,品川,341.0,た,2019/8/31 10:44,2-1_all_corrected,75,62,310,189,385,251
218327,30139_20190831211704.jpg,イオン板橋ショッピングセンター,6105,練馬,480.0,れ,2019/8/31 21:16,2-1_all_corrected,85,70,251,341,336,411
218115,30132_20190831195746.jpg,イオンスタイル東神奈川,1000,横浜,591.0,す,2019/8/31 19:57,2-1_all_corrected,55,41,372,190,427,231
216847,30157_20190831150943.jpg,関西スーパー中央,*119,神戸,130.0,ね,2019/8/31 15:09,2-1_all_corrected,58,45,241,270,299,315
217196,30167_20190831162224.jpg,イオン東雲店,8724,練馬,500.0,う,2019/8/31 16:22,2-1_all_corrected,49,38,294,164,343,202
215661,30006_20190831094122.jpg,スギ薬局南千里,1025,大阪,351.0,に,2019/8/31 9:41,2-1_all_corrected,126,116,3,196,129,312
216646,30110_20190831142715.jpg,イオン金沢八景,1010,横浜,584.0,は,2019/8/31 14:26,2-1_all_corrected,45,36,152,104,197,140
216679,30167_20190831143636.jpg,イオン東雲店,4503,足立,502.0,ち,2019/8/31 14:36,2-1_all_corrected,59,43,313,170,372,213
216473,30139_20190831134519.jpg,イオン板橋ショッピングセンター,6105,練馬,480.0,れ,2019/8/31 13:44,2-1_all_corrected,79,67,418,338,497,405
215666,30163_20190831094356.jpg,コープ葛飾白鳥店(地上),***8,足立,30.0,す,2019/8/31 9:43,2-1_all_corrected,68,52,327,149,395,201
217303,30078_20190831164451.jpg,イオンスタイル仙台卸町店,*555,宮城,581.0,を,2019/8/31 16:44,2-1_all_corrected,79,57,149,181,228,238
217555,30110_20190831174047.jpg,イオン金沢八景,1011,横浜,378.0,さ,2019/8/31 17:40,2-1_all_corrected,52,39,428,99,480,138
218380,30169_20190831215014.jpg,イオン相模原ショッピングセンター,*350,相模,337.0,は,2019/8/31 21:49,2-1_all_corrected,87,68,157,278,244,346
218146,30120_20190831200749.jpg,イオン長浦（第１・第２）,8888,袖ヶ浦,585.0,よ,2019/8/31 20:07,2-1_all_corrected,76,65,51,311,127,376
217100,30139_20190831155830.jpg,イオン板橋ショッピングセンター,*275,川口,480.0,り,2019/8/31 15:58,2-1_all_corrected,78,66,428,347,506,413
217564,30111_20190831174346.jpg,イオン稲毛,8888,袖ヶ浦,339.0,て,2019/8/31 17:42,2-1_all_corrected,53,43,217,167,270,210
217590,30169_20190831175050.jpg,イオン相模原ショッピングセンター,9009,相模,334.0,ら,2019/8/31 17:50,2-1_all_corrected,99,79,120,355,219,434
215802,30167_20190831102707.jpg,イオン東雲店,3706,足立,530.0,せ,2019/8/31 10:26,2-1_all_corrected,37,32,20,0,57,32
215668,30167_20190831094359.jpg,イオン東雲店,*106,足立,530.0,も,2019/8/31 9:43,2-1_all_corrected,42,35,292,221,334,256
217351,30144_20190831165420.jpg,イオン幕張,*510,千葉,549.0,は,2019/8/31 16:53,2-1_all_corrected,71,57,162,194,233,251
217993,30169_20190831192238.jpg,イオン相模原ショッピングセンター,1018,相模,340.0,と,2019/8/31 19:22,2-1_all_corrected,80,75,423,319,503,394
215859,30169_20190831104442.jpg,イオン相模原ショッピングセンター,*117,相模,348.0,み,2019/8/31 10:44,2-1_all_corrected,83,60,256,137,339,197
216042,30062_20190831113350.jpg,ミスミモール,1010,神戸,31.0,ゆ,2019/8/31 11:33,2-1_all_corrected,50,40,365,121,415,161
218125,30167_20190831200049.jpg,イオン東雲店,2890,川崎,405.0,ち,2019/8/31 20:00,2-1_all_corrected,37,28,422,71,459,99
216080,30169_20190831114257.jpg,イオン相模原ショッピングセンター,9484,多摩,302.0,ま,2019/8/31 11:42,2-1_all_corrected,89,68,270,132,359,200
218328,30139_20190831211722.jpg,イオン板橋ショッピングセンター,5062,足立,481.0,り,2019/8/31 21:16,2-1_all_corrected,69,61,185,312,254,373
216848,30110_20190831150951.jpg,イオン金沢八景,1188,横浜,589.0,と,2019/8/31 15:09,2-1_all_corrected,37,30,296,67,333,97
216410,30072_20190831132144.jpg,関西スーパー京阪大和田１F,**10,大阪,359.0,や,2019/8/31 13:21,2-1_all_corrected,38,28,202,5,240,33
216428,30169_20190831132709.jpg,イオン相模原ショッピングセンター,7658,湘南,583.0,い,2019/8/31 13:26,2-1_all_corrected,82,67,242,119,324,186
217703,30078_20190831181409.jpg,イオンスタイル仙台卸町店,***8,仙台,335.0,る,2019/8/31 18:13,2-1_all_corrected,72,53,320,193,392,246
216443,30110_20190831133203.jpg,イオン金沢八景,1018,横浜,544.0,と,2019/8/31 13:31,2-1_all_corrected,48,39,463,103,511,142
218182,30110_20190831201954.jpg,イオン金沢八景,1001,横浜,311.0,の,2019/8/31 20:19,2-1_all_corrected,69,54,375,102,444,156
218388,30063_20190831215338.jpg,コーナン相模原小山モール,2453,一宮,-1.0,て,2019/8/31 21:53,2-1_all_corrected,44,48,556,127,600,175
216212,30169_20190831121349.jpg,イオン相模原ショッピングセンター,9664,相模,580.0,か,2019/8/31 12:13,2-1_all_corrected,84,65,268,119,352,184
216472,30132_20190831134414.jpg,イオンスタイル東神奈川,*188,横浜,333.0,ぬ,2019/8/31 13:43,2-1_all_corrected,57,42,230,209,287,251
217933,30111_20190831190314.jpg,イオン稲毛,**78,千葉,344.0,そ,2019/8/31 19:02,2-1_all_corrected,54,41,340,137,394,178
218381,30169_20190831215018.jpg,イオン相模原ショッピングセンター,*350,相模,337.0,け,2019/8/31 21:49,2-1_all_corrected,87,68,157,278,244,346
216223,30144_20190831122123.jpg,イオン幕張,5310,千葉,531.0,つ,2019/8/31 12:20,2-1_all_corrected,60,41,203,171,263,212
216812,30063_20190831150555.jpg,コーナン相模原小山モール,1010,横浜,31.0,つ,2019/8/31 15:05,2-1_all_corrected,67,67,32,197,99,264
218372,30063_20190831214434.jpg,コーナン相模原小山モール,2667,土浦,-1.0,ら,2019/8/31 21:44,2-1_all_corrected,71,58,464,184,535,242
217248,30046_20190831163355.jpg,マミーマート船橋日大[地上],1148,習志野,301.0,と,2019/8/31 16:33,2-1_all_corrected,44,31,187,60,231,91
216994,30144_20190831153746.jpg,イオン幕張,3832,千葉,530.0,ほ,2019/8/31 15:37,2-1_all_corrected,54,38,232,119,286,157
217283,30144_20190831164045.jpg,イオン幕張,5712,千葉,331.0,は,2019/8/31 16:40,2-1_all_corrected,63,41,117,174,180,215
216164,30111_20190831115803.jpg,イオン稲毛,1166,千葉,330.0,と,2019/8/31 11:56,2-1_all_corrected,44,34,113,68,157,102
217426,30144_20190831170826.jpg,イオン幕張,*505,習志野,534.0,め,2019/8/31 17:08,2-1_all_corrected,69,52,120,190,189,242
217270,30060_20190831163846.jpg,関西スーパー小野原,7861,大阪,301.0,ゆ,2019/8/31 16:38,2-1_all_corrected,77,68,508,269,585,337
217848,30078_20190831184127.jpg,イオンスタイル仙台卸町店,9119,仙台,530.0,そ,2019/8/31 18:41,2-1_all_corrected,89,64,354,293,443,357
217410,30144_20190831170442.jpg,イオン幕張,1018,千葉,343.0,ぬ,2019/8/31 17:04,2-1_all_corrected,56,38,220,112,276,150
217428,30144_20190831170907.jpg,イオン幕張,5773,千葉,503.0,つ,2019/8/31 17:08,2-1_all_corrected,59,40,233,142,292,182
216969,30111_20190831153436.jpg,イオン稲毛,2241,千葉,581.0,か,2019/8/31 15:31,2-1_all_corrected,47,37,105,120,152,157
217671,30111_20190831180933.jpg,イオン稲毛,9367,野田,580.0,え,2019/8/31 18:08,2-1_all_corrected,72,55,315,169,387,224
216902,30169_20190831152243.jpg,イオン相模原ショッピングセンター,*966,相模,530.0,と,2019/8/31 15:22,2-1_all_corrected,78,63,279,91,357,154
216139,30167_20190831115426.jpg,イオン東雲店,2533,静岡,580.0,わ,2019/8/31 11:54,2-1_all_corrected,74,58,190,223,264,281
217224,30139_20190831162849.jpg,イオン板橋ショッピングセンター,5062,足立,481.0,り,2019/8/31 16:28,2-1_all_corrected,70,62,304,273,374,335
218061,30046_20190831194103.jpg,マミーマート船橋日大[地上],*210,野田,331.0,ゆ,2019/8/31 19:40,2-1_all_corrected,70,54,291,132,361,186
217029,30144_20190831154350.jpg,イオン幕張,4514,習志野,301.0,す,2019/8/31 15:43,2-1_all_corrected,61,44,271,169,332,213
216553,30139_20190831140839.jpg,イオン板橋ショッピングセンター,5062,足立,481.0,り,2019/8/31 14:08,2-1_all_corrected,76,65,342,340,418,405
215913,30169_20190831110232.jpg,イオン相模原ショッピングセンター,8225,相模,501.0,ま,2019/8/31 11:02,2-1_all_corrected,84,65,250,276,334,341
218254,30078_20190831204715.jpg,イオンスタイル仙台卸町店,***7,仙台,330.0,は,2019/8/31 20:46,2-1_all_corrected,51,30,253,0,304,30
218092,30111_20190831195023.jpg,イオン稲毛,6483,千葉,330.0,て,2019/8/31 19:49,2-1_all_corrected,45,35,424,75,469,110
218005,30072_20190831192521.jpg,関西スーパー京阪大和田１F,1028,大阪,483.0,と,2019/8/31 19:24,2-1_all_corrected,81,86,0,310,81,396
217086,30144_20190831155552.jpg,イオン幕張,*620,千葉,338.0,の,2019/8/31 15:55,2-1_all_corrected,52,34,129,79,181,113
216154,30072_20190831115704.jpg,関西スーパー京阪大和田１F,*503,大阪,336.0,り,2019/8/31 11:56,2-1_all_corrected,74,56,423,136,497,192
216702,30144_20190831144040.jpg,イオン幕張,4034,千葉,302.0,さ,2019/8/31 14:40,2-1_all_corrected,58,40,140,95,198,135
215983,30136_20190831112337.jpg,イオンスタイル新百合ヶ丘,5598,川崎,501.0,そ,2019/8/31 11:23,2-1_all_corrected,92,71,374,117,466,188
217411,30136_20190831170446.jpg,イオンスタイル新百合ヶ丘,*218,川崎,532.0,や,2019/8/31 16:53,2-1_all_corrected,85,63,121,195,206,258
218034,30110_20190831193341.jpg,イオン金沢八景,9548,湘南,301.0,も,2019/8/31 19:33,2-1_all_corrected,69,56,175,139,244,195
216191,30139_20190831120621.jpg,イオン板橋ショッピングセンター,*970,練馬,580.0,せ,2019/8/31 12:05,2-1_all_corrected,79,63,311,188,390,251
217043,30137_20190831154619.jpg,イオンスタイル品川シーサイド,9797,品川,331.0,つ,2019/8/31 15:45,2-1_all_corrected,69,57,282,162,351,219
217271,30110_20190831163850.jpg,イオン金沢八景,8057,横浜,304.0,み,2019/8/31 16:38,2-1_all_corrected,46,41,506,116,552,157
216357,30078_20190831130227.jpg,イオンスタイル仙台卸町店,1002,仙台,583.0,を,2019/8/31 13:02,2-1_all_corrected,71,58,156,133,227,191
216501,30139_20190831134938.jpg,イオン板橋ショッピングセンター,*275,川口,480.0,り,2019/8/31 13:49,2-1_all_corrected,73,61,376,306,449,367
217276,30144_20190831163928.jpg,イオン幕張,8476,千葉,302.0,そ,2019/8/31 16:38,2-1_all_corrected,72,50,143,156,215,206
215575,30167_20190831085933.jpg,イオン東雲店,*115,足立,302.0,な,2019/8/31 8:59,2-1_all_corrected,84,60,139,157,223,217
218093,30070_20190831195023.jpg,カナートモール住道第一,**55,大阪,31.0,に,2019/8/31 19:49,2-1_all_corrected,73,53,324,180,397,233
215740,30091_20190831100343.jpg,イトーヨーカドー木場 立体,1010,伊豆,336.0,に,2019/8/31 10:03,2-1_all_corrected,47,36,340,106,387,142
216555,30136_20190831140846.jpg,イオンスタイル新百合ヶ丘,**27,川崎,342.0,ろ,2019/8/31 14:08,2-1_all_corrected,106,77,191,184,297,261
217814,30063_20190831183337.jpg,コーナン相模原小山モール,5139,相模,580.0,ゆ,2019/8/31 18:33,2-1_all_corrected,69,61,506,155,575,216
217213,30167_20190831162621.jpg,イオン東雲店,7484,足立,500.0,に,2019/8/31 16:25,2-1_all_corrected,56,43,297,151,353,194
218264,30168_20190831204854.jpg,イオン東雲店（屋上）,1447,野田,530.0,え,2019/8/31 20:48,2-1_all_corrected,39,32,150,21,189,53
216904,30144_20190831152249.jpg,イオン幕張,3268,大阪,503.0,す,2019/8/31 15:22,2-1_all_corrected,71,51,213,167,284,218
216769,30144_20190831145709.jpg,イオン幕張,1012,千葉,348.0,な,2019/8/31 14:56,2-1_all_corrected,53,40,148,148,201,188
215588,30167_20190831090726.jpg,イオン東雲店,2619,足立,480.0,い,2019/8/31 9:06,2-1_all_corrected,36,35,30,56,66,91
218051,30110_20190831193747.jpg,イオン金沢八景,**66,横浜,541.0,の,2019/8/31 19:37,2-1_all_corrected,67,65,52,213,119,278
216712,30168_20190831144328.jpg,イオン東雲店（屋上）,2593,仙台,300.0,た,2019/8/31 14:43,2-1_all_corrected,79,61,357,167,436,228
217859,30110_20190831184453.jpg,イオン金沢八景,2525,横浜,31.0,そ,2019/8/31 18:44,2-1_all_corrected,54,43,339,86,393,129
216518,30110_20190831135607.jpg,イオン金沢八景,2508,横浜,504.0,せ,2019/8/31 13:55,2-1_all_corrected,50,46,42,274,92,320
216982,30144_20190831153623.jpg,イオン幕張,8888,千葉,370.0,ち,2019/8/31 15:35,2-1_all_corrected,49,32,155,104,204,136
218216,30074_20190831203217.jpg,マックスバリュ北1条東,8008,札幌,-1.0,ま,2019/8/31 20:31,2-1_all_corrected,42,47,379,181,421,228
217602,30090_20190831175350.jpg,イトーヨーカドー木場 西棟,8154,習志野,580.0,ぬ,2019/8/31 17:53,2-1_all_corrected,58,44,276,202,334,246
217266,30144_20190831163747.jpg,イオン幕張,4848,千葉,330.0,ち,2019/8/31 16:37,2-1_all_corrected,76,55,395,280,471,335
216724,30060_20190831144610.jpg,関西スーパー小野原,5689,大阪,480.0,の,2019/8/31 14:45,2-1_all_corrected,81,65,270,327,351,392
217259,30062_20190831163559.jpg,ミスミモール,8888,神戸,30.0,み,2019/8/31 16:35,2-1_all_corrected,87,80,36,268,123,348
217669,30136_20190831180906.jpg,イオンスタイル新百合ヶ丘,1017,川崎,336.0,せ,2019/8/31 18:08,2-1_all_corrected,90,64,75,386,165,450
218084,30063_20190831194822.jpg,コーナン相模原小山モール,7745,相模,301.0,そ,2019/8/31 19:47,2-1_all_corrected,52,46,514,128,566,174
215561,30137_20190831085054.jpg,イオンスタイル品川シーサイド,8730,品川,331.0,と,2019/8/31 8:50,2-1_all_corrected,58,44,267,139,325,183
217038,30102_20190831154519.jpg,ココス神戸垂水,1010,神戸,31.0,ふ,2019/8/31 15:44,2-1_all_corrected,69,55,430,224,499,279
218070,30006_20190831194331.jpg,スギ薬局南千里,2610,大阪,531.0,ふ,2019/8/31 19:43,2-1_all_corrected,120,81,177,111,297,192
216545,30110_20190831140657.jpg,イオン金沢八景,*527,横浜,543.0,ほ,2019/8/31 14:06,2-1_all_corrected,57,44,366,82,423,126
216313,30137_20190831125003.jpg,イオンスタイル品川シーサイド,2792,品川,580.0,う,2019/8/31 12:49,2-1_all_corrected,93,61,379,389,472,450
216128,30072_20190831115107.jpg,関西スーパー京阪大和田１F,1952,大阪,581.0,ね,2019/8/31 11:50,2-1_all_corrected,106,86,118,261,224,347
215759,30072_20190831100956.jpg,関西スーパー京阪大和田１F,9388,大阪,480.0,て,2019/8/31 10:09,2-1_all_corrected,77,64,0,313,77,377
218422,30079_20190831221407.jpg,ピットデザイン仙台卸町駅前駐車場,5910,仙台,330.0,て,2019/8/31 22:13,2-1_all_corrected,72,51,308,169,380,220
216573,30001_20190831141302.jpg,関西スーパー高石駅前,8787,堺,335.0,て,2019/8/31 14:12,2-1_all_corrected,55,44,529,21,584,65
218425,30078_20190831221600.jpg,イオンスタイル仙台卸町店,1062,仙台,300.0,ろ,2019/8/31 22:15,2-1_all_corrected,86,62,194,260,280,322
217835,30139_20190831183728.jpg,イオン板橋ショッピングセンター,5024,練馬,480.0,れ,2019/8/31 18:36,2-1_all_corrected,77,59,451,378,528,437
216173,30072_20190831115948.jpg,関西スーパー京阪大和田１F,1031,大阪,347.0,の,2019/8/31 11:59,2-1_all_corrected,77,59,17,188,94,247
216517,30110_20190831135601.jpg,イオン金沢八景,1104,横浜,536.0,さ,2019/8/31 13:55,2-1_all_corrected,36,31,243,127,279,158
217431,30169_20190831170951.jpg,イオン相模原ショッピングセンター,*722,相模,533.0,ほ,2019/8/31 17:08,2-1_all_corrected,48,41,159,91,207,132
216187,30091_20190831120501.jpg,イトーヨーカドー木場 立体,7000,会津,330.0,の,2019/8/31 12:04,2-1_all_corrected,72,59,283,81,355,140
217869,30169_20190831184717.jpg,イオン相模原ショッピングセンター,7562,沼津,300.0,る,2019/8/31 18:46,2-1_all_corrected,81,69,400,273,481,342
216970,30144_20190831153441.jpg,イオン幕張,8882,千葉,330.0,め,2019/8/31 15:34,2-1_all_corrected,57,36,114,111,171,147
215957,30169_20190831111847.jpg,イオン相模原ショッピングセンター,*913,広島,301.0,ふ,2019/8/31 11:18,2-1_all_corrected,78,57,323,71,401,128
216180,30110_20190831120200.jpg,イオン金沢八景,8228,横浜,532.0,ほ,2019/8/31 12:01,2-1_all_corrected,57,43,234,68,291,111
216722,30078_20190831144548.jpg,イオンスタイル仙台卸町店,**37,仙台,584.0,こ,2019/8/31 14:45,2-1_all_corrected,53,42,289,79,342,121
217851,30169_20190831184222.jpg,イオン相模原ショッピングセンター,**37,相模,333.0,ね,2019/8/31 18:41,2-1_all_corrected,83,75,153,253,236,328
217858,30144_20190831184440.jpg,イオン幕張,*111,品川,30.0,と,2019/8/31 18:44,2-1_all_corrected,57,42,203,148,260,190
218221,30110_20190831203433.jpg,イオン金沢八景,1017,横浜,355.0,も,2019/8/31 20:34,2-1_all_corrected,53,48,517,119,570,167
216145,30144_20190831115541.jpg,イオン幕張,*884,千葉,584.0,は,2019/8/31 11:55,2-1_all_corrected,50,35,191,122,241,157
217097,30086_20190831155812.jpg,テックランド大阪りんくう,8008,和泉,31.0,す,2019/8/31 15:57,2-1_all_corrected,53,42,202,160,255,202
218219,30039_20190831203346.jpg,イトーヨーカドー大井町,5830,品川,501.0,す,2019/8/31 20:33,2-1_all_corrected,71,58,213,221,284,279
215995,30138_20190831112637.jpg,イオンスタイル湘南茅ヶ崎,1173,湘南,374.0,さ,2019/8/31 11:26,2-1_all_corrected,56,42,300,113,356,155
215961,30073_20190831111921.jpg,関西スーパー京阪大和田２F,6283,大阪,581.0,つ,2019/8/31 11:18,2-1_all_corrected,41,35,22,79,63,114
215794,30167_20190831102342.jpg,イオン東雲店,9307,足立,301.0,の,2019/8/31 10:23,2-1_all_corrected,69,54,166,172,235,226
216323,30169_20190831125253.jpg,イオン相模原ショッピングセンター,6160,相模,502.0,た,2019/8/31 12:52,2-1_all_corrected,80,70,381,274,461,344
217037,30144_20190831154517.jpg,イオン幕張,6768,千葉,530.0,ぬ,2019/8/31 15:44,2-1_all_corrected,71,50,190,165,261,215
216586,30078_20190831141629.jpg,イオンスタイル仙台卸町店,9744,仙台,580.0,こ,2019/8/31 14:16,2-1_all_corrected,72,58,165,137,237,195
218078,30062_20190831194520.jpg,ミスミモール,***3,神戸,30.0,ふ,2019/8/31 19:44,2-1_all_corrected,69,51,263,165,332,216
216749,30090_20190831145152.jpg,イトーヨーカドー木場 西棟,1222,足立,301.0,も,2019/8/31 14:51,2-1_all_corrected,54,41,289,168,343,209
217234,30110_20190831163122.jpg,イオン金沢八景,**73,横浜,431.0,ろ,2019/8/31 16:30,2-1_all_corrected,53,47,336,130,389,177
216312,30144_20190831124951.jpg,イオン幕張,2013,千葉,585.0,む,2019/8/31 12:49,2-1_all_corrected,94,67,361,357,455,424
215590,30167_20190831090754.jpg,イオン東雲店,2619,足立,480.0,い,2019/8/31 9:07,2-1_all_corrected,73,56,259,228,332,284
217465,30045_20190831171746.jpg,マックスバリュー徳川明倫,8008,名古屋,31.0,は,2019/8/31 17:17,2-1_all_corrected,48,38,267,119,315,157
217173,30139_20190831161726.jpg,イオン板橋ショッピングセンター,*808,練馬,342.0,や,2019/8/31 16:16,2-1_all_corrected,69,51,223,228,292,279
216603,30136_20190831141859.jpg,イオンスタイル新百合ヶ丘,2711,多摩,531.0,ろ,2019/8/31 14:17,2-1_all_corrected,47,33,462,0,509,33
216431,30167_20190831132749.jpg,イオン東雲店,1002,足立,584.0,ぬ,2019/8/31 13:27,2-1_all_corrected,77,65,113,273,190,338
215871,30072_20190831104815.jpg,関西スーパー京阪大和田１F,1103,大阪,563.0,ぬ,2019/8/31 10:46,2-1_all_corrected,104,88,90,352,194,440
216052,30072_20190831113623.jpg,関西スーパー京阪大和田１F,3018,大阪,531.0,と,2019/8/31 11:35,2-1_all_corrected,42,29,416,0,458,29
216436,30136_20190831132940.jpg,イオンスタイル新百合ヶ丘,1127,川崎,536.0,せ,2019/8/31 13:28,2-1_all_corrected,74,55,305,181,379,236
217722,30139_20190831181840.jpg,イオン板橋ショッピングセンター,3822,練馬,301.0,つ,2019/8/31 18:18,2-1_all_corrected,76,55,253,254,329,309
216409,30132_20190831132055.jpg,イオンスタイル東神奈川,9788,横浜,503.0,ゆ,2019/8/31 13:20,2-1_all_corrected,80,65,206,228,286,293
216099,30111_20190831114712.jpg,イオン稲毛,*248,千葉,581.0,け,2019/8/31 11:45,2-1_all_corrected,56,44,189,161,245,205
218103,30060_20190831195345.jpg,関西スーパー小野原,7812,大阪,530.0,ひ,2019/8/31 19:53,2-1_all_corrected,65,54,333,215,398,269
217370,30144_20190831165712.jpg,イオン幕張,1114,習志野,580.0,ひ,2019/8/31 16:56,2-1_all_corrected,59,40,211,174,270,214
216090,30167_20190831114448.jpg,イオン東雲店,1122,品川,545.0,み,2019/8/31 11:44,2-1_all_corrected,88,75,67,374,155,449
215840,30070_20190831103939.jpg,カナートモール住道第一,1212,大阪,31.0,ち,2019/8/31 10:39,2-1_all_corrected,83,63,155,197,238,260
216097,30139_20190831114645.jpg,イオン板橋ショッピングセンター,5062,足立,481.0,り,2019/8/31 11:46,2-1_all_corrected,54,41,236,178,290,219
218132,30111_20190831200241.jpg,イオン稲毛,*224,千葉,534.0,る,2019/8/31 20:02,2-1_all_corrected,67,55,393,218,460,273
218166,30072_20190831201409.jpg,関西スーパー京阪大和田１F,9726,大阪,430.0,さ,2019/8/31 20:13,2-1_all_corrected,47,34,214,59,261,93
218354,30063_20190831213055.jpg,コーナン相模原小山モール,2525,富山,-1.0,え,2019/8/31 21:30,2-1_all_corrected,44,33,262,111,306,144
216008,30106_20190831112846.jpg,ジョーシン東大阪長田,1122,大阪,31.0,た,2019/8/31 11:28,2-1_all_corrected,73,54,200,209,273,263
218159,30144_20190831201032.jpg,イオン幕張,6787,習志野,560.0,つ,2019/8/31 20:10,2-1_all_corrected,40,36,294,85,334,121
218195,30079_20190831202522.jpg,ピットデザイン仙台卸町駅前駐車場,*215,仙台,590.0,る,2019/8/31 20:24,2-1_all_corrected,66,55,207,162,273,217
216234,30144_20190831122708.jpg,イオン幕張,4913,練馬,77.0,と,2019/8/31 12:26,2-1_all_corrected,57,40,227,160,284,200
216496,30078_20190831134849.jpg,イオンスタイル仙台卸町店,3100,仙台,330.0,の,2019/8/31 13:48,2-1_all_corrected,87,52,344,364,431,416
217120,30167_20190831160232.jpg,イオン東雲店,*126,千葉,337.0,る,2019/8/31 16:02,2-1_all_corrected,72,82,3,265,75,347
217312,30078_20190831164549.jpg,イオンスタイル仙台卸町店,1204,大宮,335.0,ゆ,2019/8/31 16:45,2-1_all_corrected,91,63,344,280,435,343
216668,30139_20190831143123.jpg,イオン板橋ショッピングセンター,***8,練馬,584.0,こ,2019/8/31 14:30,2-1_all_corrected,79,57,252,193,331,250
216250,30110_20190831123042.jpg,イオン金沢八景,**63,横浜,338.0,も,2019/8/31 12:30,2-1_all_corrected,56,43,163,144,219,187
217520,30144_20190831173113.jpg,イオン幕張,*212,習志野,340.0,そ,2019/8/31 17:30,2-1_all_corrected,89,66,349,349,438,415
215879,30072_20190831105108.jpg,関西スーパー京阪大和田１F,8000,大阪,524.0,ひ,2019/8/31 10:50,2-1_all_corrected,69,55,40,142,109,197
216091,30139_20190831114450.jpg,イオン板橋ショッピングセンター,7487,練馬,480.0,れ,2019/8/31 11:44,2-1_all_corrected,79,63,209,313,288,376
217385,30144_20190831170146.jpg,イオン幕張,1122,千葉,393.0,ゆ,2019/8/31 17:01,2-1_all_corrected,57,44,171,146,228,190
216892,30046_20190831151926.jpg,マミーマート船橋日大[地上],8730,習志野,483.0,う,2019/8/31 15:19,2-1_all_corrected,76,61,322,250,398,311
216268,30136_20190831123713.jpg,イオンスタイル新百合ヶ丘,*617,品川,502.0,た,2019/8/31 12:36,2-1_all_corrected,80,58,371,70,451,128
216430,30167_20190831132727.jpg,イオン東雲店,7788,足立,357.0,の,2019/8/31 13:26,2-1_all_corrected,92,78,19,356,111,434
217340,30139_20190831165116.jpg,イオン板橋ショッピングセンター,*116,八王子,334.0,た,2019/8/31 16:50,2-1_all_corrected,71,56,230,233,301,289
218151,30169_20190831200855.jpg,イオン相模原ショッピングセンター,9367,相模,301.0,も,2019/8/31 20:08,2-1_all_corrected,51,43,180,97,231,140
216464,30110_20190831134028.jpg,イオン金沢八景,*880,横浜,584.0,あ,2019/8/31 13:40,2-1_all_corrected,44,35,269,139,313,174
216000,30136_20190831112733.jpg,イオンスタイル新百合ヶ丘,2610,多摩,583.0,え,2019/8/31 11:27,2-1_all_corrected,100,68,255,132,355,200
216232,30044_20190831122626.jpg,ココス横浜港南台,1000,横浜,30.0,も,2019/8/31 12:25,2-1_all_corrected,102,61,421,260,523,321
217314,30144_20190831164623.jpg,イオン幕張,2344,千葉,502.0,む,2019/8/31 16:45,2-1_all_corrected,42,41,274,126,316,167
218156,30046_20190831200945.jpg,マミーマート船橋日大[地上],**28,千葉,537.0,も,2019/8/31 20:09,2-1_all_corrected,72,65,496,213,568,278
218364,30139_20190831214033.jpg,イオン板橋ショッピングセンター,1689,練馬,330.0,ひ,2019/8/31 21:40,2-1_all_corrected,82,57,226,274,308,331
217748,30110_20190831182341.jpg,イオン金沢八景,9981,横浜,333.0,や,2019/8/31 18:23,2-1_all_corrected,74,54,99,164,173,218
217117,30169_20190831160157.jpg,イオン相模原ショッピングセンター,5507,相模,330.0,は,2019/8/31 16:01,2-1_all_corrected,56,42,447,5,503,47
216667,30145_20190831143038.jpg,イオン高根木戸,*999,習志野,586.0,こ,2019/8/31 14:30,2-1_all_corrected,54,41,257,83,311,124
218399,30001_20190831215918.jpg,関西スーパー高石駅前,1228,和泉,584.0,こ,2019/8/31 21:59,2-1_all_corrected,96,71,185,240,281,311
216009,30136_20190831112855.jpg,イオンスタイル新百合ヶ丘,3281,川崎,501.0,せ,2019/8/31 11:28,2-1_all_corrected,93,66,16,243,109,309
217746,30139_20190831182334.jpg,イオン板橋ショッピングセンター,7487,練馬,480.0,れ,2019/8/31 18:23,2-1_all_corrected,77,59,236,298,313,357
217110,30169_20190831160055.jpg,イオン相模原ショッピングセンター,9041,野田,300.0,さ,2019/8/31 16:00,2-1_all_corrected,63,29,167,197,230,226
215808,30167_20190831102743.jpg,イオン東雲店,3706,足立,530.0,せ,2019/8/31 10:27,2-1_all_corrected,68,55,234,200,302,255
217909,30143_20190831185621.jpg,イオン久里浜,*777,横浜,328.0,ろ,2019/8/31 18:55,2-1_all_corrected,77,66,96,378,173,444
218370,30169_20190831214333.jpg,イオン相模原ショッピングセンター,8453,札幌,-1.0,と,2019/8/31 21:43,2-1_all_corrected,40,32,229,124,269,156
218384,30131_20190831215120.jpg,ベルク狭山入間川,3932,豊橋,-1.0,に,2019/8/31 21:50,2-1_all_corrected,51,39,155,221,206,260
216687,30144_20190831143749.jpg,イオン幕張,*211,金沢,331.0,は,2019/8/31 14:37,2-1_all_corrected,58,44,164,155,222,199
217560,30137_20190831174200.jpg,イオンスタイル品川シーサイド,***3,品川,30.0,た,2019/8/31 17:41,2-1_all_corrected,55,41,101,120,156,161
218315,30169_20190831211103.jpg,イオン相模原ショッピングセンター,9979,相模,50.0,ほ,2019/8/31 21:10,2-1_all_corrected,57,44,169,119,226,163
215852,30113_20190831104223.jpg,ハローデイ新宮店第四,1787,福岡,480.0,ち,2019/8/31 10:41,2-1_all_corrected,82,59,164,133,246,192
217396,30144_20190831170311.jpg,イオン幕張,4944,習志野,580.0,は,2019/8/31 17:02,2-1_all_corrected,55,40,176,161,231,201
218118,30167_20190831195825.jpg,イオン東雲店,*919,品川,344.0,ひ,2019/8/31 19:57,2-1_all_corrected,56,45,368,330,424,375
217150,30110_20190831161152.jpg,イオン金沢八景,2298,横浜,505.0,た,2019/8/31 16:11,2-1_all_corrected,55,42,303,82,358,124
216288,30169_20190831124011.jpg,イオン相模原ショッピングセンター,6272,八王子,301.0,つ,2019/8/31 12:39,2-1_all_corrected,98,78,322,119,420,197
216275,30039_20190831123823.jpg,イトーヨーカドー大井町,5777,品川,331.0,る,2019/8/31 12:37,2-1_all_corrected,73,65,155,166,228,231
216611,30110_20190831142042.jpg,イオン金沢八景,2138,横浜,505.0,て,2019/8/31 14:20,2-1_all_corrected,82,61,322,224,404,285
216629,30110_20190831142335.jpg,イオン金沢八景,2802,横浜,503.0,に,2019/8/31 14:23,2-1_all_corrected,67,55,192,227,259,282
218323,30139_20190831211610.jpg,イオン板橋ショッピングセンター,5024,練馬,480.0,れ,2019/8/31 21:15,2-1_all_corrected,68,55,255,280,323,335
217965,30144_20190831191332.jpg,イオン幕張,7240,千葉,300.0,も,2019/8/31 19:13,2-1_all_corrected,89,62,297,375,386,437
216681,30144_20190831143658.jpg,イオン幕張,***7,野田,586.0,を,2019/8/31 14:36,2-1_all_corrected,53,39,205,183,258,222
217798,30111_20190831183145.jpg,イオン稲毛,1230,千葉,340.0,り,2019/8/31 18:31,2-1_all_corrected,59,44,364,142,423,186
217330,30057_20190831164947.jpg,ライフ東府中,***5,多摩,30.0,せ,2019/8/31 16:49,2-1_all_corrected,72,58,386,239,458,297
218181,30117_20190831201936.jpg,ショッパーズプラザ横須賀,**35,横浜,557.0,ね,2019/8/31 20:19,2-1_all_corrected,70,52,377,355,447,407
218188,30052_20190831202115.jpg,西友市ヶ尾,***8,横浜,-1.0,ふ,2019/8/31 20:20,2-1_all_corrected,91,77,65,338,156,415
217762,30139_20190831182521.jpg,イオン板橋ショッピングセンター,5062,足立,481.0,り,2019/8/31 18:24,2-1_all_corrected,82,60,318,330,400,390
217306,30144_20190831164513.jpg,イオン幕張,2586,千葉,581.0,つ,2019/8/31 16:44,2-1_all_corrected,57,41,241,136,298,177
215664,30139_20190831094234.jpg,イオン板橋ショッピングセンター,***7,練馬,376.0,ね,2019/8/31 9:42,2-1_all_corrected,77,62,401,259,478,321
217301,30115_20190831164431.jpg,イオン南行徳（平面）,8915,足立,400.0,ほ,2019/8/31 16:43,2-1_all_corrected,75,75,525,243,600,318
216485,30085_20190831134728.jpg,業務スーパー南津守,1001,なにわ,31.0,ね,2019/8/31 13:47,2-1_all_corrected,36,43,99,248,135,291
217557,30167_20190831174129.jpg,イオン東雲店,4822,足立,301.0,め,2019/8/31 17:40,2-1_all_corrected,84,60,6,390,90,450
216829,30091_20190831150805.jpg,イトーヨーカドー木場 立体,***8,足立,30.0,す,2019/8/31 15:07,2-1_all_corrected,41,37,243,12,284,49
218376,30063_20190831214612.jpg,コーナン相模原小山モール,*560,相模,530.0,む,2019/8/31 21:45,2-1_all_corrected,65,57,486,165,551,222
217158,30144_20190831161336.jpg,イオン幕張,*178,千葉,543.0,は,2019/8/31 16:13,2-1_all_corrected,57,44,227,151,284,195
218110,30110_20190831195526.jpg,イオン金沢八景,*700,横浜,538.0,ひ,2019/8/31 19:55,2-1_all_corrected,66,56,394,123,460,179
218322,30139_20190831211607.jpg,イオン板橋ショッピングセンター,*275,川口,480.0,り,2019/8/31 21:15,2-1_all_corrected,55,44,223,240,278,284
217990,30167_20190831192220.jpg,イオン東雲店,8008,足立,383.0,つ,2019/8/31 19:21,2-1_all_corrected,80,75,15,299,95,374
216041,30079_20190831113321.jpg,ピットデザイン仙台卸町駅前駐車場,5220,宮城,501.0,む,2019/8/31 11:32,2-1_all_corrected,54,36,391,171,445,207
218325,30139_20190831211651.jpg,イオン板橋ショッピングセンター,7487,練馬,480.0,れ,2019/8/31 21:16,2-1_all_corrected,76,55,213,303,289,358
217709,30144_20190831181507.jpg,イオン幕張,2525,つくば,554.0,り,2019/8/31 18:14,2-1_all_corrected,89,64,327,287,416,351
217194,30139_20190831162204.jpg,イオン板橋ショッピングセンター,1394,練馬,502.0,さ,2019/8/31 16:21,2-1_all_corrected,73,55,253,229,326,284
216610,30136_20190831142018.jpg,イオンスタイル新百合ヶ丘,6259,川崎,501.0,た,2019/8/31 14:19,2-1_all_corrected,47,31,504,0,551,31
217736,30144_20190831182230.jpg,イオン幕張,***3,千葉,393.0,ま,2019/8/31 18:22,2-1_all_corrected,57,45,183,189,240,234
217504,30139_20190831172635.jpg,イオン板橋ショッピングセンター,***8,練馬,30.0,た,2019/8/31 17:26,2-1_all_corrected,90,63,275,338,365,401
218121,30167_20190831195915.jpg,イオン東雲店,***1,品川,30.0,ろ,2019/8/31 19:58,2-1_all_corrected,92,70,159,377,251,447
216414,30167_20190831132313.jpg,イオン東雲店,3619,習志野,480.0,れ,2019/8/31 13:22,2-1_all_corrected,78,67,86,340,164,407
216242,30111_20190831122908.jpg,イオン稲毛,7297,千葉,501.0,そ,2019/8/31 12:26,2-1_all_corrected,56,49,270,176,326,225
217156,30139_20190831161255.jpg,イオン板橋ショッピングセンター,5024,練馬,480.0,れ,2019/8/31 16:12,2-1_all_corrected,68,58,326,246,394,304
216874,30085_20190831151412.jpg,業務スーパー南津守,8888,なにわ,30.0,ほ,2019/8/31 15:13,2-1_all_corrected,78,54,464,333,542,387
217707,30046_20190831181436.jpg,マミーマート船橋日大[地上],3286,習志野,501.0,ゆ,2019/8/31 18:14,2-1_all_corrected,58,43,325,200,383,243
216413,30078_20190831132310.jpg,イオンスタイル仙台卸町店,*711,仙台,580.0,そ,2019/8/31 13:22,2-1_all_corrected,69,51,254,114,323,165
216561,30139_20190831141010.jpg,イオン板橋ショッピングセンター,7487,練馬,480.0,れ,2019/8/31 14:09,2-1_all_corrected,81,62,262,374,343,436
216939,30078_20190831152859.jpg,イオンスタイル仙台卸町店,9999,山形,335.0,ゆ,2019/8/31 15:28,2-1_all_corrected,81,64,403,248,484,312
215774,30046_20190831101542.jpg,マミーマート船橋日大[地上],8855,習志野,488.0,う,2019/8/31 10:15,2-1_all_corrected,82,67,449,295,531,362
216595,30169_20190831141810.jpg,イオン相模原ショッピングセンター,**11,相模,594.0,は,2019/8/31 14:17,2-1_all_corrected,89,65,174,90,263,155
217440,30103_20190831171209.jpg,八尾老原１丁目,**10,神戸,31.0,み,2019/8/31 17:11,2-1_all_corrected,74,57,251,209,325,266
215773,30110_20190831101538.jpg,イオン金沢八景,2822,横浜,332.0,そ,2019/8/31 10:15,2-1_all_corrected,65,56,514,141,579,197
216102,30139_20190831114726.jpg,イオン板橋ショッピングセンター,*275,川口,480.0,り,2019/8/31 11:46,2-1_all_corrected,80,65,427,385,507,450
216754,30110_20190831145225.jpg,イオン金沢八景,2361,横浜,304.0,め,2019/8/31 14:52,2-1_all_corrected,65,58,110,185,175,243
218295,30110_20190831210439.jpg,イオン金沢八景,**51,横浜,352.0,ね,2019/8/31 21:04,2-1_all_corrected,63,58,505,116,568,174
217012,30012_20190831153930.jpg,西友都賀第2駐車場,2012,千葉,533.0,ま,2019/8/31 15:38,2-1_all_corrected,99,84,501,231,600,315
218268,30167_20190831204943.jpg,イオン東雲店,1447,静岡,500.0,ろ,2019/8/31 20:49,2-1_all_corrected,55,46,227,177,282,223
217220,30110_20190831162732.jpg,イオン金沢八景,*623,横浜,542.0,そ,2019/8/31 16:27,2-1_all_corrected,49,38,138,46,187,84
217449,30111_20190831171515.jpg,イオン稲毛,*317,習志野,332.0,ほ,2019/8/31 17:13,2-1_all_corrected,52,49,229,153,281,202
217485,30167_20190831172054.jpg,イオン東雲店,6702,横浜,304.0,ま,2019/8/31 17:20,2-1_all_corrected,89,73,86,330,175,403
217227,30139_20190831162921.jpg,イオン板橋ショッピングセンター,7487,練馬,480.0,れ,2019/8/31 16:28,2-1_all_corrected,81,65,301,367,382,432
216568,30144_20190831141125.jpg,イオン幕張,6911,千葉,581.0,す,2019/8/31 14:11,2-1_all_corrected,56,36,178,146,234,182
215789,30001_20190831102242.jpg,関西スーパー高石駅前,1222,堺,583.0,は,2019/8/31 10:22,2-1_all_corrected,82,63,334,145,416,208
216990,30078_20190831153712.jpg,イオンスタイル仙台卸町店,*776,仙台,330.0,に,2019/8/31 15:36,2-1_all_corrected,75,57,363,171,438,228
217274,30139_20190831163920.jpg,イオン板橋ショッピングセンター,2525,練馬,559.0,み,2019/8/31 16:38,2-1_all_corrected,79,56,254,278,333,334
216736,30169_20190831144938.jpg,イオン相模原ショッピングセンター,*361,八王子,501.0,ひ,2019/8/31 14:49,2-1_all_corrected,53,43,194,108,247,151
215972,30169_20190831112212.jpg,イオン相模原ショッピングセンター,3003,多摩,400.0,に,2019/8/31 11:21,2-1_all_corrected,84,61,270,138,354,199
216169,30072_20190831115855.jpg,関西スーパー京阪大和田１F,1109,大阪,585.0,ぬ,2019/8/31 11:57,2-1_all_corrected,87,82,0,291,87,373
215981,30136_20190831112302.jpg,イオンスタイル新百合ヶ丘,5598,川崎,501.0,そ,2019/8/31 11:22,2-1_all_corrected,49,33,445,0,494,33
217048,30137_20190831154710.jpg,イオンスタイル品川シーサイド,1011,品川,362.0,の,2019/8/31 15:46,2-1_all_corrected,87,67,351,300,438,367
217874,30111_20190831184944.jpg,イオン稲毛,1112,千葉,348.0,ひ,2019/8/31 18:49,2-1_all_corrected,53,44,216,153,269,197
216707,30114_20190831144201.jpg,イオン南行徳（立体）,8233,習志野,300.0,ゆ,2019/8/31 14:41,2-1_all_corrected,82,60,159,235,241,295
216363,30078_20190831130434.jpg,イオンスタイル仙台卸町店,1122,仙台,347.0,む,2019/8/31 13:04,2-1_all_corrected,74,56,274,231,348,287
217077,30139_20190831155323.jpg,イオン板橋ショッピングセンター,6105,練馬,480.0,れ,2019/8/31 15:52,2-1_all_corrected,51,44,299,205,350,249
217621,30014_20190831175717.jpg,フォルテ蘇我ベルク棟,***5,千葉,30.0,て,2019/8/31 17:56,2-1_all_corrected,55,41,51,47,106,88
218438,30079_20190831223750.jpg,ピットデザイン仙台卸町駅前駐車場,5910,徳島,330.0,く,2019/8/31 22:37,2-1_all_corrected,41,33,443,130,484,163
217828,30063_20190831183543.jpg,コーナン相模原小山モール,1721,相模,331.0,な,2019/8/31 18:35,2-1_all_corrected,63,60,496,109,559,169
217484,30045_20190831172027.jpg,マックスバリュー徳川明倫,2525,名古屋,31.0,そ,2019/8/31 17:20,2-1_all_corrected,75,66,141,296,216,362
218269,30167_20190831204948.jpg,イオン東雲店,1447,野田,500.0,う,2019/8/31 20:49,2-1_all_corrected,83,70,29,347,112,417
215576,30167_20190831090001.jpg,イオン東雲店,*115,足立,302.0,な,2019/8/31 8:59,2-1_all_corrected,52,43,289,93,341,136
217477,30144_20190831171947.jpg,イオン幕張,5757,習志野,50.0,な,2019/8/31 17:19,2-1_all_corrected,61,44,228,181,289,225
217645,30139_20190831180433.jpg,イオン板橋ショッピングセンター,6105,練馬,480.0,れ,2019/8/31 18:04,2-1_all_corrected,83,67,237,319,320,386
215911,30052_20190831110149.jpg,西友市ヶ尾,*111,横浜,30.0,た,2019/8/31 11:01,2-1_all_corrected,49,35,445,165,494,200
216331,30072_20190831125430.jpg,関西スーパー京阪大和田１F,*701,神戸,830.0,か,2019/8/31 12:54,2-1_all_corrected,64,62,6,156,70,218
216567,30110_20190831141107.jpg,イオン金沢八景,1084,横浜,331.0,り,2019/8/31 14:10,2-1_all_corrected,71,60,109,193,180,253
217441,30137_20190831171407.jpg,イオンスタイル品川シーサイド,*218,品川,347.0,む,2019/8/31 17:13,2-1_all_corrected,79,61,205,114,284,175
218294,30070_20190831210437.jpg,カナートモール住道第一,***2,大阪,-1.0,も,2019/8/31 21:04,2-1_all_corrected,75,54,301,204,376,258
218258,30078_20190831204720.jpg,イオンスタイル仙台卸町店,***7,仙台,330.0,は,2019/8/31 20:46,2-1_all_corrected,51,39,255,1,306,40
216799,30169_20190831150344.jpg,イオン相模原ショッピングセンター,4078,相模,301.0,ほ,2019/8/31 15:03,2-1_all_corrected,96,77,166,225,262,302
218267,30167_20190831204938.jpg,イオン東雲店,1447,野田,500.0,ろ,2019/8/31 20:49,2-1_all_corrected,49,39,277,133,326,172
218055,30144_20190831193922.jpg,イオン幕張,*830,千葉,334.0,ほ,2019/8/31 19:39,2-1_all_corrected,84,54,205,340,289,394
215987,30136_20190831112500.jpg,イオンスタイル新百合ヶ丘,*632,新潟,301.0,そ,2019/8/31 11:24,2-1_all_corrected,72,55,227,133,299,188
217288,30072_20190831164202.jpg,関西スーパー京阪大和田１F,*311,大阪,584.0,せ,2019/8/31 16:41,2-1_all_corrected,75,57,22,129,97,186
216701,30167_20190831144039.jpg,イオン東雲店,***8,足立,30.0,ほ,2019/8/31 14:40,2-1_all_corrected,83,75,60,244,143,319
217415,30111_20190831170510.jpg,イオン稲毛,6548,千葉,581.0,く,2019/8/31 17:01,2-1_all_corrected,57,45,134,162,191,207
216962,30110_20190831153351.jpg,イオン金沢八景,2976,横浜,580.0,よ,2019/8/31 15:33,2-1_all_corrected,85,72,31,228,116,300
218030,30132_20190831193254.jpg,イオンスタイル東神奈川,***8,横浜,30.0,に,2019/8/31 19:32,2-1_all_corrected,51,40,206,104,257,144
217078,30072_20190831155340.jpg,関西スーパー京阪大和田１F,8815,なにわ,830.0,あ,2019/8/31 15:53,2-1_all_corrected,69,60,317,108,386,168
216737,30110_20190831144938.jpg,イオン金沢八景,8541,横浜,505.0,な,2019/8/31 14:49,2-1_all_corrected,52,43,344,151,396,194
217423,30144_20190831170618.jpg,イオン幕張,*605,習志野,501.0,ひ,2019/8/31 17:05,2-1_all_corrected,56,37,206,123,262,160
217286,30110_20190831164159.jpg,イオン金沢八景,3988,横浜,335.0,な,2019/8/31 16:41,2-1_all_corrected,39,28,359,105,398,133
216354,30072_20190831130149.jpg,関西スーパー京阪大和田１F,3103,大阪,537.0,る,2019/8/31 13:00,2-1_all_corrected,80,64,45,190,125,254
216730,30144_20190831144821.jpg,イオン幕張,1305,練馬,301.0,す,2019/8/31 14:47,2-1_all_corrected,76,50,416,323,492,373
196853,30046_20190824134531.jpg,マミーマート船橋日大[地上],6320,習志野,501,ね,2019/8/24 13:45,2-1_all_corrected,42,30,193,57,235,87
197344,30111_20190824155015.jpg,イオン稲毛,*625,千葉,341,む,2019/8/24 15:49,2-1_all_corrected,59,44,367,135,426,179
197718,30111_20190824175017.jpg,イオン稲毛,4433,千葉,330,は,2019/8/24 17:48,2-1_all_corrected,57,45,219,140,276,185
197171,30169_20190824150231.jpg,イオン相模原ショッピングセンター,2525,相模,369,な,2019/8/24 15:02,2-1_all_corrected,69,56,259,141,328,197
197185,30072_20190824150700.jpg,関西スーパー京阪大和田１F,7722,なにわ,830,あ,2019/8/24 15:06,2-1_all_corrected,72,61,58,122,130,183
196405,30062_20190824115340.jpg,ミスミモール,1010,神戸,31,ゆ,2019/8/24 11:53,2-1_all_corrected,74,62,177,204,251,266
197386,30110_20190824160332.jpg,イオン金沢八景,2464,横浜,304,た,2019/8/24 16:03,2-1_all_corrected,39,32,283,21,322,53
197140,30110_20190824145751.jpg,イオン金沢八景,2311,横浜,533,せ,2019/8/24 14:57,2-1_all_corrected,70,59,197,167,267,226
196092,30046_20190824101239.jpg,マミーマート船橋日大[地上],2371,習志野,33,も,2019/8/24 10:12,2-1_all_corrected,40,31,155,73,195,104
198108,30063_20190824193518.jpg,コーナン相模原小山モール,**30,相模,430,ゆ,2019/8/24 19:34,2-1_all_corrected,67,59,95,187,162,246
197789,30169_20190824181600.jpg,イオン相模原ショッピングセンター,***4,相模,344,は,2019/8/24 18:15,2-1_all_corrected,75,56,348,213,423,269
197917,30006_20190824184728.jpg,スギ薬局南千里,6535,大阪,503,す,2019/8/24 18:47,2-1_all_corrected,117,75,234,52,351,127
197319,30046_20190824154509.jpg,マミーマート船橋日大[地上],*106,習志野,534,ち,2019/8/24 15:44,2-1_all_corrected,45,33,211,74,256,107
197583,30045_20190824170549.jpg,マックスバリュー徳川明倫,*358,名古屋,32,と,2019/8/24 17:05,2-1_all_corrected,80,56,211,225,291,281
196207,30111_20190824104913.jpg,イオン稲毛,**67,千葉,500,と,2019/8/24 10:48,2-1_all_corrected,44,35,94,94,138,129
197541,30167_20190824165412.jpg,イオン東雲店,6222,品川,330,め,2019/8/24 16:53,2-1_all_corrected,83,62,0,388,83,450
197125,30144_20190824145326.jpg,イオン幕張,*613,千葉,534,ら,2019/8/24 14:53,2-1_all_corrected,71,48,187,219,258,267
198199,30110_20190824200427.jpg,イオン金沢八景,2399,横浜,330,に,2019/8/24 20:03,2-1_all_corrected,77,61,221,199,298,260
197774,30169_20190824181102.jpg,イオン相模原ショッピングセンター,1836,相模,400,と,2019/8/24 18:10,2-1_all_corrected,81,59,274,95,355,154
196699,30100_20190824130502.jpg,JBM長崎三芳町,5505,熊本,33,な,2019/8/24 13:04,2-1_all_corrected,52,37,363,220,415,257
197942,30157_20190824185450.jpg,関西スーパー中央,5968,神戸,480,き,2019/8/24 18:54,2-1_all_corrected,52,41,141,322,193,363
197717,30167_20190824174954.jpg,イオン東雲店,8299,大宮,580,い,2019/8/24 17:49,2-1_all_corrected,87,70,78,317,165,387
196093,30085_20190824101243.jpg,業務スーパー南津守,**55,なにわ,31,も,2019/8/24 10:12,2-1_all_corrected,57,42,298,206,355,248
196252,30046_20190824110524.jpg,マミーマート船橋日大[地上],7376,北九州,501,す,2019/8/24 11:05,2-1_all_corrected,54,42,260,101,314,143
197974,30072_20190824190022.jpg,関西スーパー京阪大和田１F,4401,大阪,501,て,2019/8/24 18:59,2-1_all_corrected,50,35,99,64,149,99
196852,30110_20190824134444.jpg,イオン金沢八景,4927,横浜,304,な,2019/8/24 13:44,2-1_all_corrected,48,37,469,52,517,89
196638,30009_20190824124338.jpg,西友新北習志野,**81,習志野,334,り,2019/8/24 12:43,2-1_all_corrected,162,97,238,0,400,97
197513,30144_20190824164138.jpg,イオン幕張,2703,千葉,330,に,2019/8/24 16:41,2-1_all_corrected,53,39,197,118,250,157
197547,30078_20190824165521.jpg,イオンスタイル仙台卸町店,8888,仙台,336,み,2019/8/24 16:54,2-1_all_corrected,62,43,219,64,281,107
197781,30086_20190824181342.jpg,テックランド大阪りんくう,***8,和泉,30,ま,2019/8/24 18:13,2-1_all_corrected,56,41,338,196,394,237
197578,30144_20190824170423.jpg,イオン幕張,1000,足立,371,そ,2019/8/24 17:03,2-1_all_corrected,89,66,285,333,374,399
197786,30157_20190824181507.jpg,関西スーパー中央,3700,神戸,583,つ,2019/8/24 18:14,2-1_all_corrected,50,39,99,254,149,293
196459,30144_20190824120831.jpg,イオン幕張,1126,千葉,347,な,2019/8/24 12:08,2-1_all_corrected,50,39,137,126,187,165
198153,30022_20190824194520.jpg,業務スーパー平野駅前,***1,なにわ,30,そ,2019/8/24 19:44,2-1_all_corrected,70,59,205,118,275,177
196696,30169_20190824130334.jpg,イオン相模原ショッピングセンター,8908,相模,301,な,2019/8/24 13:02,2-1_all_corrected,80,59,323,76,403,135
197916,30110_20190824184710.jpg,イオン金沢八景,*358,横浜,592,に,2019/8/24 18:46,2-1_all_corrected,53,46,220,222,273,268
197788,30072_20190824181548.jpg,関西スーパー京阪大和田１F,4523,奈良,530,ち,2019/8/24 18:15,2-1_all_corrected,99,82,99,278,198,360
198196,30111_20190824200240.jpg,イオン稲毛,7538,千葉,583,て,2019/8/24 20:02,2-1_all_corrected,55,45,183,166,238,211
196830,30110_20190824133916.jpg,イオン金沢八景,*921,横浜,533,ら,2019/8/24 13:38,2-1_all_corrected,70,54,370,158,440,212
196728,30144_20190824131620.jpg,イオン幕張,1975,柏,330,ぬ,2019/8/24 13:15,2-1_all_corrected,56,41,188,113,244,154
198222,30090_20190824201357.jpg,イトーヨーカドー木場 西棟,***9,習志野,376,む,2019/8/24 20:13,2-1_all_corrected,46,36,395,118,441,154
196717,30043_20190824131251.jpg,ファインシティ東松戸,8370,野田,580,そ,2019/8/24 13:12,2-1_all_corrected,53,43,212,242,265,285
197631,30072_20190824172036.jpg,関西スーパー京阪大和田１F,***2,京都,517,ま,2019/8/24 17:20,2-1_all_corrected,69,55,90,165,159,220
196179,30167_20190824103951.jpg,イオン東雲店,8782,足立,302,た,2019/8/24 10:39,2-1_all_corrected,78,56,210,182,288,238
197404,30144_20190824160825.jpg,イオン幕張,2020,千葉,538,そ,2019/8/24 16:08,2-1_all_corrected,60,42,222,140,282,182
198028,30167_20190824191415.jpg,イオン東雲店,8686,足立,339,て,2019/8/24 19:13,2-1_all_corrected,67,56,279,100,346,156
197094,30085_20190824144747.jpg,業務スーパー南津守,1000,なにわ,30,む,2019/8/24 14:47,2-1_all_corrected,52,42,225,241,277,283
196522,30110_20190824121818.jpg,イオン金沢八景,7716,横浜,536,ぬ,2019/8/24 12:17,2-1_all_corrected,51,39,360,111,411,150
197855,30046_20190824183245.jpg,マミーマート船橋日大[地上],8830,習志野,530,た,2019/8/24 18:31,2-1_all_corrected,75,62,444,209,519,271
196719,30039_20190824131309.jpg,イトーヨーカドー大井町,4413,横浜,330,ぬ,2019/8/24 13:12,2-1_all_corrected,67,59,194,183,261,242
197600,30110_20190824171137.jpg,イオン金沢八景,1555,福岡,332,は,2019/8/24 17:11,2-1_all_corrected,45,37,498,65,543,102
196177,30167_20190824103939.jpg,イオン東雲店,8639,水戸,330,ま,2019/8/24 10:39,2-1_all_corrected,88,63,261,247,349,310
197607,30111_20190824171347.jpg,イオン稲毛,3605,袖ヶ浦,100,さ,2019/8/24 17:12,2-1_all_corrected,67,57,306,179,373,236
196183,30169_20190824104023.jpg,イオン相模原ショッピングセンター,2882,多摩,483,い,2019/8/24 10:39,2-1_all_corrected,79,67,172,232,251,299
197051,30167_20190824143614.jpg,イオン東雲店,3480,足立,502,の,2019/8/24 14:35,2-1_all_corrected,76,58,194,232,270,290
197495,30110_20190824163638.jpg,イオン金沢八景,8262,横浜,580,と,2019/8/24 16:36,2-1_all_corrected,54,44,223,241,277,285
197461,30085_20190824162508.jpg,業務スーパー南津守,***8,なにわ,30,は,2019/8/24 16:24,2-1_all_corrected,58,45,413,277,471,322
197653,30072_20190824172838.jpg,関西スーパー京阪大和田１F,3678,大阪,480,く,2019/8/24 17:28,2-1_all_corrected,45,34,283,83,328,117
196329,30144_20190824113220.jpg,イオン幕張,*224,習志野,583,る,2019/8/24 11:31,2-1_all_corrected,56,39,195,137,251,176
196582,30110_20190824123126.jpg,イオン金沢八景,*175,横浜,331,は,2019/8/24 12:31,2-1_all_corrected,67,63,15,221,82,284
197450,30167_20190824162149.jpg,イオン東雲店,4704,足立,481,り,2019/8/24 16:21,2-1_all_corrected,78,64,64,386,142,450
196576,30110_20190824122945.jpg,イオン金沢八景,3547,横浜,303,て,2019/8/24 12:29,2-1_all_corrected,43,37,430,118,473,155
196571,30066_20190824122807.jpg,ジョーシン和泉中央,1000,和泉,30,と,2019/8/24 12:27,2-1_all_corrected,71,56,119,257,190,313
197691,30169_20190824174204.jpg,イオン相模原ショッピングセンター,*115,相模,538,に,2019/8/24 17:41,2-1_all_corrected,84,62,302,108,386,170
196318,30111_20190824112811.jpg,イオン稲毛,3428,横浜,302,の,2019/8/24 11:27,2-1_all_corrected,58,43,354,148,412,191
197606,30106_20190824171306.jpg,ジョーシン東大阪長田,***7,大阪,30,り,2019/8/24 17:12,2-1_all_corrected,68,51,215,188,283,239
196986,30132_20190824142012.jpg,イオンスタイル東神奈川,***8,横浜,30,に,2019/8/24 14:19,2-1_all_corrected,57,40,246,164,303,204
197433,30111_20190824161821.jpg,イオン稲毛,4500,千葉,332,む,2019/8/24 16:17,2-1_all_corrected,58,45,218,141,276,186
197608,30062_20190824171414.jpg,ミスミモール,***3,神戸,30,ほ,2019/8/24 17:13,2-1_all_corrected,81,63,176,155,257,218
197891,30072_20190824184251.jpg,関西スーパー京阪大和田１F,1121,大阪,583,そ,2019/8/24 18:42,2-1_all_corrected,47,36,263,60,310,96
197032,30072_20190824142940.jpg,関西スーパー京阪大和田１F,3640,神戸,302,め,2019/8/24 14:29,2-1_all_corrected,87,69,7,301,94,370
198248,30110_20190824202320.jpg,イオン金沢八景,*503,多摩,339,も,2019/8/24 20:22,2-1_all_corrected,63,60,187,155,250,215
197456,30001_20190824162326.jpg,関西スーパー高石駅前,5060,和泉,51,の,2019/8/24 16:23,2-1_all_corrected,83,60,399,139,482,199
196319,30001_20190824112914.jpg,関西スーパー高石駅前,7239,和泉,581,き,2019/8/24 11:28,2-1_all_corrected,98,70,286,278,384,348
196113,30111_20190824102157.jpg,イオン稲毛,4558,千葉,502,さ,2019/8/24 10:21,2-1_all_corrected,72,57,343,160,415,217
196745,30111_20190824132419.jpg,イオン稲毛,3128,千葉,531,す,2019/8/24 13:23,2-1_all_corrected,56,42,359,136,415,178
197231,30167_20190824151631.jpg,イオン東雲店,*726,足立,333,て,2019/8/24 15:16,2-1_all_corrected,76,57,256,214,332,271
197467,30110_20190824162701.jpg,イオン金沢八景,7077,横浜,581,い,2019/8/24 16:26,2-1_all_corrected,68,55,344,122,412,177
197655,30072_20190824172911.jpg,関西スーパー京阪大和田１F,8778,大阪,580,の,2019/8/24 17:28,2-1_all_corrected,78,62,1,279,79,341
198246,30046_20190824202242.jpg,マミーマート船橋日大[地上],1205,神戸,342,て,2019/8/24 20:22,2-1_all_corrected,69,53,346,144,415,197
197652,30144_20190824172801.jpg,イオン幕張,**15,千葉,546,せ,2019/8/24 17:27,2-1_all_corrected,75,53,383,280,458,333
197460,30110_20190824162446.jpg,イオン金沢八景,4199,横浜,505,す,2019/8/24 16:24,2-1_all_corrected,45,34,504,100,549,134
197236,30169_20190824151801.jpg,イオン相模原ショッピングセンター,8896,相模,501,も,2019/8/24 15:17,2-1_all_corrected,69,34,306,171,375,205
198087,30062_20190824192847.jpg,ミスミモール,8008,神戸,30,す,2019/8/24 19:28,2-1_all_corrected,76,54,305,186,381,240
197825,30039_20190824182356.jpg,イトーヨーカドー大井町,8478,品川,330,に,2019/8/24 18:23,2-1_all_corrected,70,64,156,143,226,207
196597,30144_20190824123527.jpg,イオン幕張,*530,千葉,345,す,2019/8/24 12:35,2-1_all_corrected,58,42,193,167,251,209
197445,30052_20190824162058.jpg,西友市ヶ尾,*111,横浜,30,た,2019/8/24 16:20,2-1_all_corrected,72,54,346,228,418,282
197017,30111_20190824142542.jpg,イオン稲毛,*211,千葉,586,は,2019/8/24 14:24,2-1_all_corrected,49,40,104,122,153,162
197646,30157_20190824172636.jpg,関西スーパー中央,*358,大阪,344,は,2019/8/24 17:26,2-1_all_corrected,56,46,136,358,192,404
196794,30078_20190824133205.jpg,イオンスタイル仙台卸町店,1921,仙台,530,た,2019/8/24 13:31,2-1_all_corrected,97,65,258,365,355,430
198058,30169_20190824192128.jpg,イオン相模原ショッピングセンター,9999,相模,585,ね,2019/8/24 19:21,2-1_all_corrected,52,45,143,123,195,168
197010,30070_20190824142444.jpg,カナートモール住道第一,**11,大阪,31,さ,2019/8/24 14:24,2-1_all_corrected,53,43,208,126,261,169
197276,30144_20190824153129.jpg,イオン幕張,8412,千葉,301,や,2019/8/24 15:31,2-1_all_corrected,53,37,156,115,209,152
196368,30110_20190824114521.jpg,イオン金沢八景,*614,横浜,346,す,2019/8/24 11:44,2-1_all_corrected,46,40,428,68,474,108
197418,30110_20190824161221.jpg,イオン金沢八景,*828,横浜,360,そ,2019/8/24 16:12,2-1_all_corrected,73,63,211,210,284,273
198206,30110_20190824200708.jpg,イオン金沢八景,**55,横浜,31,ち,2019/8/24 20:06,2-1_all_corrected,52,38,352,95,404,133
197247,30111_20190824152249.jpg,イオン稲毛,1717,千葉,500,た,2019/8/24 15:21,2-1_all_corrected,43,35,76,82,119,117
197416,30167_20190824161143.jpg,イオン東雲店,*590,足立,580,た,2019/8/24 16:11,2-1_all_corrected,69,54,215,211,284,265
197678,30066_20190824173722.jpg,ジョーシン和泉中央,***3,和泉,30,に,2019/8/24 17:36,2-1_all_corrected,55,43,286,173,341,216
197481,30168_20190824163129.jpg,イオン東雲店（屋上）,**26,大宮,338,み,2019/8/24 16:31,2-1_all_corrected,50,38,226,45,276,83
197649,30157_20190824172715.jpg,関西スーパー中央,8396,神戸,530,そ,2019/8/24 17:26,2-1_all_corrected,51,42,149,264,200,306
198050,30144_20190824191902.jpg,イオン幕張,*323,千葉,334,や,2019/8/24 19:18,2-1_all_corrected,59,43,256,167,315,210
197870,30078_20190824183603.jpg,イオンスタイル仙台卸町店,4289,山形,501,な,2019/8/24 18:35,2-1_all_corrected,70,52,279,55,349,107
197410,30110_20190824160934.jpg,イオン金沢八景,1890,横浜,301,な,2019/8/24 16:09,2-1_all_corrected,83,65,262,199,345,264
197074,30167_20190824144508.jpg,イオン東雲店,***6,練馬,373,さ,2019/8/24 14:44,2-1_all_corrected,38,31,0,6,38,37
196394,30110_20190824115152.jpg,イオン金沢八景,3712,横浜,502,ゆ,2019/8/24 11:51,2-1_all_corrected,78,82,3,368,81,450
197080,30110_20190824144542.jpg,イオン金沢八景,1211,横浜,364,さ,2019/8/24 14:45,2-1_all_corrected,48,41,163,110,211,151
197426,30167_20190824161613.jpg,イオン東雲店,5577,多摩,341,む,2019/8/24 16:15,2-1_all_corrected,53,44,287,146,340,190
197284,30100_20190824153309.jpg,JBM長崎三芳町,5505,熊本,33,な,2019/8/24 15:32,2-1_all_corrected,50,35,202,146,252,181
195978,30167_20190824093804.jpg,イオン東雲店,1202,足立,535,て,2019/8/24 9:37,2-1_all_corrected,68,59,436,320,504,379
197846,30157_20190824183134.jpg,関西スーパー中央,1117,神戸,558,や,2019/8/24 18:31,2-1_all_corrected,54,40,191,275,245,315
197598,30110_20190824171039.jpg,イオン金沢八景,1205,横浜,547,た,2019/8/24 17:10,2-1_all_corrected,74,63,319,172,393,235
196223,30090_20190824105645.jpg,イトーヨーカドー木場 西棟,6710,多摩,330,さ,2019/8/24 10:56,2-1_all_corrected,105,74,370,356,475,430
197106,30167_20190824144923.jpg,イオン東雲店,4984,品川,301,ぬ,2019/8/24 14:48,2-1_all_corrected,73,55,201,229,274,284
197334,30046_20190824154806.jpg,マミーマート船橋日大[地上],1208,習志野,584,ひ,2019/8/24 15:47,2-1_all_corrected,77,70,484,195,561,265
197750,30111_20190824180412.jpg,イオン稲毛,5555,千葉,310,ね,2019/8/24 18:02,2-1_all_corrected,56,47,252,172,308,219
197565,30144_20190824165934.jpg,イオン幕張,6976,千葉,330,て,2019/8/24 16:59,2-1_all_corrected,87,58,226,245,313,303
197101,30157_20190824144843.jpg,関西スーパー中央,3057,神戸,480,す,2019/8/24 14:48,2-1_all_corrected,56,42,116,408,172,450
198149,30111_20190824194505.jpg,イオン稲毛,6744,千葉,302,に,2019/8/24 19:44,2-1_all_corrected,71,58,407,191,478,249
197591,30110_20190824170830.jpg,イオン金沢八景,1107,横浜,380,ら,2019/8/24 17:08,2-1_all_corrected,47,35,140,30,187,65
197531,30144_20190824164856.jpg,イオン幕張,9236,千葉,301,ま,2019/8/24 16:48,2-1_all_corrected,59,43,160,143,219,186
197393,30110_20190824160653.jpg,イオン金沢八景,4950,横浜,304,て,2019/8/24 16:06,2-1_all_corrected,43,34,328,50,371,84
196417,30070_20190824115601.jpg,カナートモール住道第一,1212,大阪,31,ち,2019/8/24 11:55,2-1_all_corrected,74,55,232,114,306,169
197360,30144_20190824155323.jpg,イオン幕張,*321,袖ヶ浦,588,さ,2019/8/24 15:52,2-1_all_corrected,53,38,131,124,184,162
198125,30091_20190824193739.jpg,イトーヨーカドー木場 立体,*887,足立,330,や,2019/8/24 19:37,2-1_all_corrected,91,62,452,294,543,356
196284,30141_20190824111719.jpg,尼崎水堂町4丁目,5678,神戸,30,ろ,2019/8/24 11:16,2-1_all_corrected,53,41,143,222,196,263
197507,30110_20190824164002.jpg,イオン金沢八景,3377,横浜,540,と,2019/8/24 16:39,2-1_all_corrected,70,55,237,205,307,260
196421,30072_20190824115816.jpg,関西スーパー京阪大和田１F,***8,奈良,30,ひ,2019/8/24 11:57,2-1_all_corrected,67,51,96,155,163,206
197960,30167_20190824185732.jpg,イオン東雲店,4562,横浜,581,さ,2019/8/24 18:57,2-1_all_corrected,43,35,384,90,427,125
198177,30001_20190824195512.jpg,関西スーパー高石駅前,2438,神戸,335,も,2019/8/24 19:54,2-1_all_corrected,94,65,271,220,365,285
197590,30110_20190824170825.jpg,イオン金沢八景,3210,横浜,534,ひ,2019/8/24 17:07,2-1_all_corrected,44,34,496,82,540,116
198170,30091_20190824195127.jpg,イトーヨーカドー木場 立体,**18,品川,31,も,2019/8/24 19:51,2-1_all_corrected,51,39,300,133,351,172
196028,30169_20190824095140.jpg,イオン相模原ショッピングセンター,***4,相模,344,え,2019/8/24 9:51,2-1_all_corrected,60,43,334,162,394,205
198141,30168_20190824194328.jpg,イオン東雲店（屋上）,***2,富士山,347,ち,2019/8/24 19:43,2-1_all_corrected,55,43,304,118,359,161
197506,30144_20190824164001.jpg,イオン幕張,*274,千葉,502,め,2019/8/24 16:39,2-1_all_corrected,76,49,303,254,379,303
197539,30144_20190824165253.jpg,イオン幕張,7777,千葉,326,つ,2019/8/24 16:52,2-1_all_corrected,52,39,113,123,165,162
196285,30144_20190824111727.jpg,イオン幕張,3530,千葉,503,つ,2019/8/24 11:17,2-1_all_corrected,52,40,184,103,236,143
196427,30111_20190824115912.jpg,イオン稲毛,1501,千葉,502,む,2019/8/24 11:58,2-1_all_corrected,65,55,255,171,320,226
197966,30063_20190824185846.jpg,コーナン相模原小山モール,5139,相模,580,ゆ,2019/8/24 18:58,2-1_all_corrected,72,66,485,163,557,229
196418,30144_20190824115621.jpg,イオン幕張,1916,千葉,530,ゆ,2019/8/24 11:55,2-1_all_corrected,55,38,178,131,233,169
197992,30169_20190824190320.jpg,イオン相模原ショッピングセンター,6520,相模,301,や,2019/8/24 19:02,2-1_all_corrected,75,72,490,313,565,385
197537,30144_20190824165157.jpg,イオン幕張,*526,千葉,337,ろ,2019/8/24 16:51,2-1_all_corrected,53,33,221,71,274,104
197508,30111_20190824164011.jpg,イオン稲毛,5957,大阪,504,さ,2019/8/24 16:39,2-1_all_corrected,55,41,178,145,233,186
198124,30168_20190824193719.jpg,イオン東雲店（屋上）,8686,足立,339,て,2019/8/24 19:36,2-1_all_corrected,78,61,345,120,423,181
197110,30144_20190824145026.jpg,イオン幕張,9669,千葉,502,も,2019/8/24 14:50,2-1_all_corrected,56,38,173,110,229,148
197574,30046_20190824170246.jpg,マミーマート船橋日大[地上],*406,大阪,583,の,2019/8/24 17:02,2-1_all_corrected,44,34,168,47,212,81
196694,30111_20190824130212.jpg,イオン稲毛,4196,千葉,581,い,2019/8/24 13:00,2-1_all_corrected,60,45,153,152,213,197
197580,30157_20190824170518.jpg,関西スーパー中央,7707,神戸,333,な,2019/8/24 17:04,2-1_all_corrected,58,43,107,325,165,368
196203,30001_20190824104747.jpg,関西スーパー高石駅前,3808,堺,500,ね,2019/8/24 10:47,2-1_all_corrected,71,57,451,92,522,149
197587,30144_20190824170652.jpg,イオン幕張,*517,千葉,537,ら,2019/8/24 17:06,2-1_all_corrected,70,49,262,220,332,269
197573,30144_20190824170106.jpg,イオン幕張,5793,千葉,502,な,2019/8/24 17:00,2-1_all_corrected,48,31,170,81,218,112
196235,30070_20190824105915.jpg,カナートモール住道第一,1212,大阪,31,ち,2019/8/24 10:58,2-1_all_corrected,81,60,139,202,220,262
197545,30144_20190824165456.jpg,イオン幕張,1225,千葉,534,ら,2019/8/24 16:54,2-1_all_corrected,51,35,195,110,246,145
197748,30078_20190824180345.jpg,イオンスタイル仙台卸町店,***3,宮城,326,さ,2019/8/24 18:03,2-1_all_corrected,93,70,192,334,285,404
197589,30110_20190824170751.jpg,イオン金沢八景,1717,横浜,567,ひ,2019/8/24 17:07,2-1_all_corrected,53,44,210,89,263,133
197340,30106_20190824154936.jpg,ジョーシン東大阪長田,**55,なにわ,31,る,2019/8/24 15:49,2-1_all_corrected,76,54,210,340,286,394
197982,30078_20190824190147.jpg,イオンスタイル仙台卸町店,7145,仙台,501,つ,2019/8/24 19:01,2-1_all_corrected,69,59,342,200,411,259
197723,30072_20190824175453.jpg,関西スーパー京阪大和田１F,*126,大阪,502,せ,2019/8/24 17:53,2-1_all_corrected,99,82,99,339,198,421
197144,30110_20190824145816.jpg,イオン金沢八景,2311,横浜,533,せ,2019/8/24 14:57,2-1_all_corrected,69,60,198,167,267,227
197712,30157_20190824174853.jpg,関西スーパー中央,7445,神戸,502,ち,2019/8/24 17:48,2-1_all_corrected,54,43,141,368,195,411
197588,30110_20190824170655.jpg,イオン金沢八景,*176,横浜,583,い,2019/8/24 17:06,2-1_all_corrected,41,36,161,141,202,177
196802,30110_20190824133316.jpg,イオン金沢八景,*354,横浜,583,そ,2019/8/24 13:32,2-1_all_corrected,53,43,350,130,403,173
197776,30006_20190824181207.jpg,スギ薬局南千里,4410,大阪,502,わ,2019/8/24 18:12,2-1_all_corrected,104,66,237,20,341,86
196234,30169_20190824105823.jpg,イオン相模原ショッピングセンター,4812,多摩,503,ね,2019/8/24 10:57,2-1_all_corrected,81,67,295,219,376,286
198157,30110_20190824194608.jpg,イオン金沢八景,4183,横浜,583,え,2019/8/24 19:45,2-1_all_corrected,71,61,133,162,204,223
196454,30169_20190824120645.jpg,イオン相模原ショッピングセンター,7009,相模,502,ち,2019/8/24 12:06,2-1_all_corrected,81,65,267,95,348,160
197581,30144_20190824170519.jpg,イオン幕張,*723,千葉,347,ゆ,2019/8/24 17:05,2-1_all_corrected,54,39,206,110,260,149
196037,30139_20190824095547.jpg,イオン板橋ショッピングセンター,***1,練馬,30,ね,2019/8/24 9:55,2-1_all_corrected,73,54,235,252,308,306
197941,30167_20190824185448.jpg,イオン東雲店,*516,足立,338,ひ,2019/8/24 18:54,2-1_all_corrected,55,45,270,105,325,150
197714,30167_20190824174927.jpg,イオン東雲店,8299,大宮,580,い,2019/8/24 17:48,2-1_all_corrected,39,32,1,0,40,32
197526,30144_20190824164718.jpg,イオン幕張,8872,尾張小牧,51,さ,2019/8/24 16:46,2-1_all_corrected,87,61,353,365,440,426
197725,30060_20190824175531.jpg,関西スーパー小野原,4333,大阪,302,ゆ,2019/8/24 17:55,2-1_all_corrected,66,65,527,280,593,345
197657,30110_20190824172918.jpg,イオン金沢八景,7983,習志野,580,ひ,2019/8/24 17:28,2-1_all_corrected,52,42,363,62,415,104
197802,30157_20190824181749.jpg,関西スーパー中央,1211,神戸,364,ふ,2019/8/24 18:17,2-1_all_corrected,60,36,41,412,101,448
196924,30110_20190824135903.jpg,イオン金沢八景,9819,横浜,504,め,2019/8/24 13:58,2-1_all_corrected,76,58,184,212,260,270
197650,30072_20190824172729.jpg,関西スーパー京阪大和田１F,7750,大阪,330,る,2019/8/24 17:27,2-1_all_corrected,55,44,194,116,249,160
197462,30110_20190824162517.jpg,イオン金沢八景,*123,横浜,542,に,2019/8/24 16:24,2-1_all_corrected,42,34,212,51,254,85
197030,30144_20190824142924.jpg,イオン幕張,2552,習志野,530,め,2019/8/24 14:29,2-1_all_corrected,90,63,283,318,373,381
196747,30169_20190824132443.jpg,イオン相模原ショッピングセンター,8453,相模,502,と,2019/8/24 13:24,2-1_all_corrected,86,48,252,278,338,326
197498,30169_20190824163704.jpg,イオン相模原ショッピングセンター,**22,相模,588,ね,2019/8/24 16:36,2-1_all_corrected,84,68,132,272,216,340
197635,30144_20190824172155.jpg,イオン幕張,7179,千葉,302,た,2019/8/24 17:21,2-1_all_corrected,70,51,163,171,233,222
196383,30169_20190824115016.jpg,イオン相模原ショッピングセンター,1526,多摩,530,ふ,2019/8/24 11:49,2-1_all_corrected,54,42,145,101,199,143
196519,30167_20190824121719.jpg,イオン東雲店,9453,足立,302,の,2019/8/24 12:16,2-1_all_corrected,54,44,366,305,420,349
197064,30144_20190824144004.jpg,イオン幕張,*728,千葉,536,る,2019/8/24 14:39,2-1_all_corrected,58,46,145,143,203,189
196174,30168_20190824103915.jpg,イオン東雲店（屋上）,8782,足立,302,た,2019/8/24 10:38,2-1_all_corrected,81,67,501,160,582,227
198228,30169_20190824201720.jpg,イオン相模原ショッピングセンター,*418,多摩,531,す,2019/8/24 20:16,2-1_all_corrected,83,73,360,260,443,333
196180,30090_20190824103951.jpg,イトーヨーカドー木場 西棟,1731,足立,330,す,2019/8/24 10:39,2-1_all_corrected,85,64,410,328,495,392
196984,30001_20190824141958.jpg,関西スーパー高石駅前,7788,和泉,556,む,2019/8/24 14:19,2-1_all_corrected,71,54,305,70,376,124
197055,30144_20190824143843.jpg,イオン幕張,9639,千葉,502,た,2019/8/24 14:38,2-1_all_corrected,89,59,236,385,325,444
197431,30110_20190824161747.jpg,イオン金沢八景,5311,横浜,581,い,2019/8/24 16:17,2-1_all_corrected,41,31,526,100,567,131
197204,30110_20190824151140.jpg,イオン金沢八景,1014,横浜,502,ひ,2019/8/24 15:11,2-1_all_corrected,72,54,283,170,355,224
197497,30111_20190824163657.jpg,イオン稲毛,*548,千葉,502,ぬ,2019/8/24 16:36,2-1_all_corrected,57,41,358,149,415,190
197656,30157_20190824172918.jpg,関西スーパー中央,3100,神戸,582,う,2019/8/24 17:28,2-1_all_corrected,54,46,94,316,148,362
198077,30052_20190824192451.jpg,西友市ヶ尾,***8,横浜,30,ふ,2019/8/24 19:24,2-1_all_corrected,92,71,189,308,281,379
197868,30144_20190824183535.jpg,イオン幕張,2568,横浜,331,な,2019/8/24 18:35,2-1_all_corrected,54,39,184,119,238,158
197430,30078_20190824161717.jpg,イオンスタイル仙台卸町店,*520,仙台,332,ふ,2019/8/24 16:16,2-1_all_corrected,69,56,355,134,424,190
197408,30137_20190824160900.jpg,イオンスタイル品川シーサイド,3711,品川,300,ろ,2019/8/24 16:08,2-1_all_corrected,58,43,316,117,374,160
197437,30167_20190824161903.jpg,イオン東雲店,3640,品川,502,た,2019/8/24 16:18,2-1_all_corrected,82,59,2,391,84,450
197261,30078_20190824152821.jpg,イオンスタイル仙台卸町店,4699,仙台,580,つ,2019/8/24 15:27,2-1_all_corrected,70,54,346,112,416,166
196175,30167_20190824103924.jpg,イオン東雲店,8782,足立,302,た,2019/8/24 10:38,2-1_all_corrected,81,67,501,160,582,227
195929,30167_20190824090834.jpg,イオン東雲店,1230,足立,342,た,2019/8/24 9:08,2-1_all_corrected,89,59,38,391,127,450
197268,30144_20190824152931.jpg,イオン幕張,*686,千葉,502,の,2019/8/24 15:29,2-1_all_corrected,84,63,343,345,427,408
197439,30110_20190824161921.jpg,イオン金沢八景,*331,横浜,356,ゆ,2019/8/24 16:18,2-1_all_corrected,48,44,98,124,146,168
197062,30039_20190824143955.jpg,イトーヨーカドー大井町,5777,品川,331,る,2019/8/24 14:39,2-1_all_corrected,75,67,166,170,241,237
196192,30072_20190824104349.jpg,関西スーパー京阪大和田１F,***8,奈良,30,ひ,2019/8/24 10:43,2-1_all_corrected,72,58,166,307,238,365
197272,30144_20190824153053.jpg,イオン幕張,9633,千葉,301,ら,2019/8/24 15:30,2-1_all_corrected,53,37,236,140,289,177
196195,30169_20190824104525.jpg,イオン相模原ショッピングセンター,2882,多摩,483,い,2019/8/24 10:44,2-1_all_corrected,96,78,452,372,548,450
197078,30167_20190824144530.jpg,イオン東雲店,***6,練馬,373,さ,2019/8/24 14:45,2-1_all_corrected,76,57,186,248,262,305
197071,30144_20190824144420.jpg,イオン幕張,4574,千葉,480,す,2019/8/24 14:43,2-1_all_corrected,56,43,119,166,175,209
197415,30167_20190824161115.jpg,イオン東雲店,*590,足立,580,た,2019/8/24 16:10,2-1_all_corrected,43,36,3,61,46,97
197618,30157_20190824171606.jpg,関西スーパー中央,8309,神戸,303,の,2019/8/24 17:15,2-1_all_corrected,54,42,117,294,171,336
196168,30085_20190824103816.jpg,業務スーパー南津守,1001,なにわ,31,む,2019/8/24 10:37,2-1_all_corrected,68,61,100,336,168,397
197886,30062_20190824184136.jpg,ミスミモール,**18,神戸,31,ち,2019/8/24 18:41,2-1_all_corrected,67,68,72,219,139,287
196362,30110_20190824114123.jpg,イオン金沢八景,3158,横浜,331,つ,2019/8/24 11:40,2-1_all_corrected,55,41,259,88,314,129
197412,30110_20190824161017.jpg,イオン金沢八景,*800,横浜,354,や,2019/8/24 16:09,2-1_all_corrected,79,62,218,166,297,228
196396,30144_20190824115212.jpg,イオン幕張,1626,千葉,333,さ,2019/8/24 11:51,2-1_all_corrected,51,34,195,99,246,133
196953,30167_20190824141012.jpg,イオン東雲店,6798,習志野,580,は,2019/8/24 14:09,2-1_all_corrected,74,61,225,229,299,290
197049,30167_20190824143539.jpg,イオン東雲店,3480,足立,502,の,2019/8/24 14:35,2-1_all_corrected,35,35,0,4,35,39
197821,30157_20190824182235.jpg,関西スーパー中央,7073,神戸,501,む,2019/8/24 18:22,2-1_all_corrected,60,44,116,392,176,436
197680,30043_20190824173729.jpg,ファインシティ東松戸,2238,野田,530,と,2019/8/24 17:37,2-1_all_corrected,74,52,20,398,94,450
197687,30072_20190824174012.jpg,関西スーパー京阪大和田１F,6177,大阪,501,ち,2019/8/24 17:39,2-1_all_corrected,107,74,112,376,219,450
197477,30078_20190824163014.jpg,イオンスタイル仙台卸町店,**39,仙台,584,も,2019/8/24 16:29,2-1_all_corrected,81,49,300,193,381,242
197484,30110_20190824163410.jpg,イオン金沢八景,*168,横浜,350,つ,2019/8/24 16:33,2-1_all_corrected,81,64,298,225,379,289
196363,30144_20190824114126.jpg,イオン幕張,7124,千葉,501,そ,2019/8/24 11:40,2-1_all_corrected,82,59,287,285,369,344
197083,30144_20190824144553.jpg,イオン幕張,*711,千葉,352,て,2019/8/24 14:45,2-1_all_corrected,52,38,171,129,223,167
197048,30144_20190824143526.jpg,イオン幕張,6720,千葉,530,と,2019/8/24 14:35,2-1_all_corrected,46,30,192,57,238,87
197880,30070_20190824183934.jpg,カナートモール住道第一,***3,大阪,30,に,2019/8/24 18:39,2-1_all_corrected,58,41,348,151,406,192
197873,30098_20190824183702.jpg,BRANCH仙台（東棟）,9800,仙台,330,た,2019/8/24 18:36,2-1_all_corrected,85,69,470,361,555,430
197816,30045_20190824182041.jpg,マックスバリュー徳川明倫,*358,名古屋,32,つ,2019/8/24 18:20,2-1_all_corrected,74,54,212,200,286,254
198065,30001_20190824192234.jpg,関西スーパー高石駅前,*283,なにわ,501,そ,2019/8/24 19:22,2-1_all_corrected,102,65,283,385,385,450
196330,30079_20190824113234.jpg,ピットデザイン仙台卸町駅前駐車場,*528,仙台,580,に,2019/8/24 11:32,2-1_all_corrected,49,37,444,173,493,210
196753,30110_20190824132651.jpg,イオン金沢八景,6805,横浜,503,と,2019/8/24 13:26,2-1_all_corrected,43,34,299,100,342,134
197707,30072_20190824174719.jpg,関西スーパー京阪大和田１F,7010,大阪,534,ち,2019/8/24 17:46,2-1_all_corrected,94,76,171,283,265,359
197532,30144_20190824165034.jpg,イオン幕張,1221,千葉,350,そ,2019/8/24 16:50,2-1_all_corrected,85,58,273,343,358,401
196626,30110_20190824124139.jpg,イオン金沢八景,*250,横浜,531,み,2019/8/24 12:41,2-1_all_corrected,69,56,179,188,248,244
197955,30014_20190824185619.jpg,フォルテ蘇我ベルク棟,**11,千葉,31,せ,2019/8/24 18:55,2-1_all_corrected,47,44,83,25,130,69
198121,30079_20190824193717.jpg,ピットデザイン仙台卸町駅前駐車場,8000,宮城,319,ゆ,2019/8/24 19:36,2-1_all_corrected,72,58,419,226,491,284
196280,30090_20190824111609.jpg,イトーヨーカドー木場 西棟,**77,足立,327,せ,2019/8/24 11:15,2-1_all_corrected,58,42,274,186,332,228
197997,30046_20190824190514.jpg,マミーマート船橋日大[地上],3212,習志野,530,み,2019/8/24 19:04,2-1_all_corrected,78,64,502,249,580,313
196425,30110_20190824115859.jpg,イオン金沢八景,1010,横浜,584,は,2019/8/24 11:58,2-1_all_corrected,93,68,269,381,362,449
198144,30167_20190824194407.jpg,イオン東雲店,8888,足立,383,な,2019/8/24 19:43,2-1_all_corrected,52,42,341,107,393,149
197134,30144_20190824145500.jpg,イオン幕張,6348,習志野,501,て,2019/8/24 14:54,2-1_all_corrected,88,65,319,335,407,400
196644,30090_20190824124435.jpg,イトーヨーカドー木場 西棟,2323,名古屋,351,す,2019/8/24 12:44,2-1_all_corrected,90,65,272,334,362,399
197330,30110_20190824154640.jpg,イオン金沢八景,8782,横浜,530,は,2019/8/24 15:46,2-1_all_corrected,65,54,139,157,204,211
196216,30144_20190824105329.jpg,イオン幕張,9332,千葉,581,か,2019/8/24 10:52,2-1_all_corrected,56,41,212,192,268,233
196672,30111_20190824125125.jpg,イオン稲毛,**62,千葉,332,ろ,2019/8/24 12:50,2-1_all_corrected,57,43,252,127,309,170
197592,30110_20190824170846.jpg,イオン金沢八景,3939,横浜,346,み,2019/8/24 17:08,2-1_all_corrected,71,51,415,169,486,220
197730,30110_20190824175641.jpg,イオン金沢八景,5369,横浜,581,く,2019/8/24 17:56,2-1_all_corrected,52,40,164,53,216,93
196286,30072_20190824111851.jpg,関西スーパー京阪大和田１F,5083,大阪,580,も,2019/8/24 11:17,2-1_all_corrected,90,71,20,233,110,304
196888,30091_20190824134935.jpg,イトーヨーカドー木場 立体,**10,高崎,335,ら,2019/8/24 13:49,2-1_all_corrected,90,69,312,204,402,273
196424,30111_20190824115842.jpg,イオン稲毛,2005,千葉,541,む,2019/8/24 11:57,2-1_all_corrected,52,41,176,127,228,168
197195,30111_20190824150859.jpg,イオン稲毛,*315,千葉,342,せ,2019/8/24 15:07,2-1_all_corrected,72,52,277,179,349,231
197708,30072_20190824174730.jpg,関西スーパー京阪大和田１F,7010,大阪,534,ち,2019/8/24 17:46,2-1_all_corrected,82,63,22,231,104,294
196085,30072_20190824100920.jpg,関西スーパー京阪大和田１F,*563,京都,800,せ,2019/8/24 10:08,2-1_all_corrected,84,70,29,286,113,356
198118,30169_20190824193659.jpg,イオン相模原ショッピングセンター,7000,横浜,383,ほ,2019/8/24 19:36,2-1_all_corrected,80,70,430,295,510,365
197953,30157_20190824185558.jpg,関西スーパー中央,*603,神戸,583,せ,2019/8/24 18:55,2-1_all_corrected,54,46,124,312,178,358
198173,30009_20190824195231.jpg,西友新北習志野,**11,習志野,393,や,2019/8/24 19:52,2-1_all_corrected,153,134,133,12,286,146
197799,30167_20190824181658.jpg,イオン東雲店,*911,足立,352,ね,2019/8/24 18:16,2-1_all_corrected,88,78,62,361,150,439
197560,30144_20190824165803.jpg,イオン幕張,2853,習志野,583,え,2019/8/24 16:57,2-1_all_corrected,87,63,304,329,391,392
197594,30110_20190824170916.jpg,イオン金沢八景,7814,横浜,581,け,2019/8/24 17:08,2-1_all_corrected,56,42,171,38,227,80
197558,30110_20190824165753.jpg,イオン金沢八景,6734,横浜,530,て,2019/8/24 16:57,2-1_all_corrected,70,58,296,167,366,225
197103,30167_20190824144849.jpg,イオン東雲店,4984,品川,301,ぬ,2019/8/24 14:48,2-1_all_corrected,38,35,33,13,71,48
196689,30110_20190824125640.jpg,イオン金沢八景,4857,横浜,505,す,2019/8/24 12:56,2-1_all_corrected,56,41,188,142,244,183
194535,30110_20190823173930.jpg,イオン金沢八景,5152,横浜,303,ゆ,2019/8/23 17:39,2-1_all_corrected,70,56,270,170,340,226
195070,30062_20190823185312.jpg,ミスミモール,***3,神戸,30,ほ,2019/8/23 18:52,2-1_all_corrected,72,58,222,143,294,201
193387,30144_20190823110349.jpg,イオン幕張,2956,成田,330,さ,2019/8/23 11:03,2-1_all_corrected,57,40,187,157,244,197
194364,30110_20190823170022.jpg,イオン金沢八景,1813,横浜,332,な,2019/8/23 16:42,2-1_all_corrected,73,59,120,189,193,248
194399,30110_20190823171049.jpg,イオン金沢八景,6851,横浜,302,み,2019/8/23 16:52,2-1_all_corrected,74,62,474,223,548,285
193183,30144_20190823101614.jpg,イオン幕張,3199,千葉,580,み,2019/8/23 10:15,2-1_all_corrected,52,37,189,138,241,175
194736,30110_20190823180231.jpg,イオン金沢八景,6500,横浜,580,よ,2019/8/23 18:02,2-1_all_corrected,88,69,170,343,258,412
194990,30169_20190823183454.jpg,イオン相模原ショッピングセンター,*516,多摩,339,ち,2019/8/23 18:34,2-1_all_corrected,82,69,486,377,568,446
194503,30110_20190823173118.jpg,イオン金沢八景,1234,横浜,335,せ,2019/8/23 17:30,2-1_all_corrected,72,60,146,173,218,233
194355,30110_20190823165726.jpg,イオン金沢八景,8574,横浜,304,め,2019/8/23 16:39,2-1_all_corrected,81,68,131,257,212,325
194908,30046_20190823182231.jpg,マミーマート船橋日大[地上],*907,習志野,332,や,2019/8/23 18:22,2-1_all_corrected,45,36,187,30,232,66
194306,30078_20190823164949.jpg,イオンスタイル仙台卸町店,***3,仙台,586,を,2019/8/23 16:49,2-1_all_corrected,74,54,227,132,301,186
194339,30110_20190823165515.jpg,イオン金沢八景,4738,横浜,480,け,2019/8/23 16:36,2-1_all_corrected,59,43,348,177,407,220
193585,30045_20190823121315.jpg,マックスバリュー徳川明倫,**17,名古屋,31,り,2019/8/23 12:12,2-1_all_corrected,68,59,115,182,183,241
194592,30110_20190823175136.jpg,イオン金沢八景,5577,横浜,539,な,2019/8/23 17:51,2-1_all_corrected,64,57,188,182,252,239
194330,30110_20190823165431.jpg,イオン金沢八景,8001,横浜,334,む,2019/8/23 16:36,2-1_all_corrected,78,69,478,210,556,279
193115,30143_20190823095327.jpg,イオン久里浜,3793,横浜,50,も,2019/8/23 9:52,2-1_all_corrected,55,39,287,168,342,207
195681,30147_20190823225849.jpg,三井のリパーク 厚木文化会館,*309,大宮,580,る,2019/8/23 22:58,2-1_all_corrected,80,63,231,243,311,306
195211,30169_20190823192710.jpg,イオン相模原ショッピングセンター,*178,多摩,340,ほ,2019/8/23 19:26,2-1_all_corrected,85,79,432,316,517,395
195023,30110_20190823184352.jpg,イオン金沢八景,8485,横浜,503,な,2019/8/23 18:43,2-1_all_corrected,59,44,336,119,395,163
194308,30110_20190823165041.jpg,イオン金沢八景,7711,横浜,339,す,2019/8/23 16:32,2-1_all_corrected,57,44,372,95,429,139
194991,30110_20190823183514.jpg,イオン金沢八景,6720,湘南,530,つ,2019/8/23 18:34,2-1_all_corrected,68,59,209,192,277,251
195040,30110_20190823184757.jpg,イオン金沢八景,1109,横浜,352,は,2019/8/23 18:47,2-1_all_corrected,68,59,176,134,244,193
194354,30110_20190823165722.jpg,イオン金沢八景,8230,広島,301,せ,2019/8/23 16:39,2-1_all_corrected,71,60,181,168,252,228
193975,30167_20190823150835.jpg,イオン東雲店,6669,柏,330,す,2019/8/23 15:08,2-1_all_corrected,54,42,327,156,381,198
194398,30110_20190823171037.jpg,イオン金沢八景,4391,横浜,303,も,2019/8/23 16:52,2-1_all_corrected,59,45,354,222,413,267
195078,30144_20190823185448.jpg,イオン幕張,*182,習志野,330,ひ,2019/8/23 18:54,2-1_all_corrected,88,61,263,341,351,402
194353,30110_20190823165714.jpg,イオン金沢八景,**96,横浜,333,ま,2019/8/23 16:38,2-1_all_corrected,93,84,89,360,182,444
193720,30155_20190823131050.jpg,JBMパーキング上荒田,1899,鹿児島,880,あ,2019/8/23 13:10,2-1_all_corrected,87,62,289,214,376,276
194505,30111_20190823173127.jpg,イオン稲毛,7755,千葉,533,ま,2019/8/23 17:29,2-1_all_corrected,49,41,239,125,288,166
195047,30006_20190823184843.jpg,スギ薬局南千里,7352,大阪,581,ほ,2019/8/23 18:48,2-1_all_corrected,89,56,273,67,362,123
194533,30110_20190823173851.jpg,イオン金沢八景,1001,横浜,567,の,2019/8/23 17:38,2-1_all_corrected,73,74,14,251,87,325
194365,30110_20190823170031.jpg,イオン金沢八景,1036,横浜,504,せ,2019/8/23 16:42,2-1_all_corrected,71,59,176,170,247,229
194391,30111_20190823170755.jpg,イオン稲毛,3605,袖ヶ浦,100,さ,2019/8/23 17:06,2-1_all_corrected,53,44,237,147,290,191
194534,30110_20190823173918.jpg,イオン金沢八景,8477,横浜,303,ぬ,2019/8/23 17:38,2-1_all_corrected,75,61,246,196,321,257
195446,30169_20190823205331.jpg,イオン相模原ショッピングセンター,9999,多摩,367,に,2019/8/23 20:52,2-1_all_corrected,73,63,329,235,402,298
194336,30110_20190823165458.jpg,イオン金沢八景,3716,横浜,503,な,2019/8/23 16:36,2-1_all_corrected,54,45,432,74,486,119
194755,30110_20190823180407.jpg,イオン金沢八景,3528,横浜,504,ゆ,2019/8/23 18:03,2-1_all_corrected,56,44,326,135,382,179
195228,30006_20190823193133.jpg,スギ薬局南千里,5815,大阪,330,ゆ,2019/8/23 19:31,2-1_all_corrected,122,81,26,129,148,210
194551,30110_20190823174254.jpg,イオン金沢八景,1832,横浜,503,め,2019/8/23 17:42,2-1_all_corrected,64,62,162,219,226,281
194763,30052_20190823180434.jpg,西友市ヶ尾,1010,横浜,31,ほ,2019/8/23 18:04,2-1_all_corrected,77,59,271,260,348,319
195013,30111_20190823184148.jpg,イオン稲毛,3646,千葉,330,ろ,2019/8/23 18:41,2-1_all_corrected,55,42,378,124,433,166
194338,30110_20190823165511.jpg,イオン金沢八景,***8,横浜,543,は,2019/8/23 16:36,2-1_all_corrected,75,62,178,254,253,316
193854,30072_20190823140515.jpg,関西スーパー京阪大和田１F,7327,奈良,480,こ,2019/8/23 14:04,2-1_all_corrected,74,62,440,234,514,296
194286,30110_20190823164527.jpg,イオン金沢八景,1201,横浜,362,み,2019/8/23 16:25,2-1_all_corrected,89,70,120,380,209,450
195398,30078_20190823203710.jpg,イオンスタイル仙台卸町店,3559,仙台,500,ま,2019/8/23 20:36,2-1_all_corrected,75,50,251,142,326,192
193898,30091_20190823142608.jpg,イトーヨーカドー木場 立体,3968,足立,57,ろ,2019/8/23 14:25,2-1_all_corrected,53,44,229,181,282,225
194281,30110_20190823164504.jpg,イオン金沢八景,4422,横浜,580,め,2019/8/23 16:24,2-1_all_corrected,50,39,408,54,458,93
194423,30110_20190823171453.jpg,イオン金沢八景,*168,横浜,333,や,2019/8/23 16:56,2-1_all_corrected,68,56,410,107,478,163
194886,30111_20190823181919.jpg,イオン稲毛,7734,千葉,530,た,2019/8/23 18:17,2-1_all_corrected,57,42,370,122,427,164
194288,30110_20190823164536.jpg,イオン金沢八景,2325,横浜,304,る,2019/8/23 16:26,2-1_all_corrected,73,61,430,123,503,184
194875,30110_20190823181748.jpg,イオン金沢八景,*680,横浜,330,の,2019/8/23 18:17,2-1_all_corrected,68,64,169,195,237,259
193253,30006_20190823102726.jpg,スギ薬局南千里,3550,大阪,501,も,2019/8/23 10:27,2-1_all_corrected,85,51,461,27,546,78
194076,30078_20190823154246.jpg,イオンスタイル仙台卸町店,1127,仙台,583,ね,2019/8/23 15:42,2-1_all_corrected,74,55,232,148,306,203
195150,30110_20190823191148.jpg,イオン金沢八景,2761,横浜,504,ぬ,2019/8/23 19:11,2-1_all_corrected,73,60,313,182,386,242
194446,30144_20190823171917.jpg,イオン幕張,*815,千葉,533,ろ,2019/8/23 17:18,2-1_all_corrected,56,40,211,148,267,188
195594,30081_20190823220809.jpg,サニー福重,1263,福岡,302,つ,2019/8/23 22:07,2-1_all_corrected,53,83,2,196,55,279
194680,30169_20190823175745.jpg,イオン相模原ショッピングセンター,1108,相模,340,ぬ,2019/8/23 17:57,2-1_all_corrected,80,64,208,233,288,297
194479,30078_20190823172610.jpg,イオンスタイル仙台卸町店,1206,仙台,583,を,2019/8/23 17:25,2-1_all_corrected,71,58,164,92,235,150
194217,30060_20190823161642.jpg,関西スーパー小野原,6506,大阪,502,さ,2019/8/23 16:16,2-1_all_corrected,50,37,155,185,205,222
194483,30110_20190823172736.jpg,イオン金沢八景,4062,横浜,503,の,2019/8/23 17:27,2-1_all_corrected,82,74,85,267,167,341
194645,30046_20190823175628.jpg,マミーマート船橋日大[地上],9252,習志野,580,き,2019/8/23 17:56,2-1_all_corrected,84,76,460,328,544,404
193004,30167_20190823085533.jpg,イオン東雲店,7411,足立,230,さ,2019/8/23 8:55,2-1_all_corrected,58,43,320,332,378,375
194448,30111_20190823171942.jpg,イオン稲毛,*291,千葉,530,め,2019/8/23 17:18,2-1_all_corrected,54,45,216,151,270,196
194828,30110_20190823180844.jpg,イオン金沢八景,5903,山口,501,ほ,2019/8/23 18:08,2-1_all_corrected,49,37,304,113,353,150
195569,30078_20190823214925.jpg,イオンスタイル仙台卸町店,*741,仙台,580,ね,2019/8/23 21:48,2-1_all_corrected,92,67,150,299,242,366
194413,30110_20190823171251.jpg,イオン金沢八景,2421,横浜,304,め,2019/8/23 16:54,2-1_all_corrected,54,47,506,87,560,134
194289,30110_20190823164538.jpg,イオン金沢八景,4637,横浜,503,め,2019/8/23 16:26,2-1_all_corrected,69,52,156,261,225,313
194887,30111_20190823181925.jpg,イオン稲毛,1025,千葉,584,き,2019/8/23 18:18,2-1_all_corrected,66,56,276,163,342,219
194845,30078_20190823181155.jpg,イオンスタイル仙台卸町店,9653,岩手,580,む,2019/8/23 18:11,2-1_all_corrected,73,57,265,110,338,167
193435,30068_20190823112221.jpg,ケーヨーデイツー唐木田,***5,多摩,30,も,2019/8/23 11:21,2-1_all_corrected,48,36,340,148,388,184
194610,30072_20190823175236.jpg,関西スーパー京阪大和田１F,4627,大阪,530,さ,2019/8/23 17:51,2-1_all_corrected,67,53,164,164,231,217
193051,30022_20190823092256.jpg,業務スーパー平野駅前,*859,大阪,101,い,2019/8/23 9:22,2-1_all_corrected,101,58,326,192,427,250
194280,30110_20190823164458.jpg,イオン金沢八景,*312,高知,530,ね,2019/8/23 16:24,2-1_all_corrected,69,59,463,239,532,298
195352,30079_20190823201639.jpg,ピットデザイン仙台卸町駅前駐車場,*127,宮城,333,ぬ,2019/8/23 20:16,2-1_all_corrected,78,58,230,188,308,246
195503,30110_20190823211233.jpg,イオン金沢八景,**62,横浜,334,ふ,2019/8/23 21:12,2-1_all_corrected,63,59,526,138,589,197
194287,30110_20190823164531.jpg,イオン金沢八景,1234,横浜,326,ひ,2019/8/23 16:26,2-1_all_corrected,68,57,421,134,489,191
194889,30111_20190823181955.jpg,イオン稲毛,*703,千葉,549,せ,2019/8/23 18:18,2-1_all_corrected,54,42,214,139,268,181
193056,30085_20190823092850.jpg,業務スーパー南津守,**55,なにわ,31,と,2019/8/23 9:28,2-1_all_corrected,55,44,436,223,491,267
194425,30110_20190823171513.jpg,イオン金沢八景,1806,横浜,331,は,2019/8/23 16:56,2-1_all_corrected,65,56,79,139,144,195
195134,30110_20190823190805.jpg,イオン金沢八景,8418,横浜,580,ま,2019/8/23 19:07,2-1_all_corrected,56,43,332,194,388,237
194449,30111_20190823171953.jpg,イオン稲毛,*714,千葉,535,や,2019/8/23 17:19,2-1_all_corrected,54,44,218,135,272,179
195566,30169_20190823214527.jpg,イオン相模原ショッピングセンター,5707,相模,301,ふ,2019/8/23 21:44,2-1_all_corrected,57,43,431,32,488,75
194447,30110_20190823171925.jpg,イオン金沢八景,*580,横浜,531,さ,2019/8/23 17:01,2-1_all_corrected,64,56,420,88,484,144
194023,30167_20190823153204.jpg,イオン東雲店,4230,足立,500,に,2019/8/23 15:31,2-1_all_corrected,51,41,283,148,334,189
193034,30163_20190823090740.jpg,コープ葛飾白鳥店(地上),***8,足立,30,す,2019/8/23 9:07,2-1_all_corrected,59,41,338,150,397,191
194478,30110_20190823172558.jpg,イオン金沢八景,*111,横浜,30,に,2019/8/23 17:25,2-1_all_corrected,51,43,548,150,599,193
195543,30169_20190823213312.jpg,イオン相模原ショッピングセンター,3150,横浜,330,い,2019/8/23 21:32,2-1_all_corrected,75,68,428,295,503,363
194491,30110_20190823172844.jpg,イオン金沢八景,6811,横浜,303,と,2019/8/23 17:28,2-1_all_corrected,70,54,331,161,401,215
195315,30110_20190823195901.jpg,イオン金沢八景,*627,横浜,584,ほ,2019/8/23 19:58,2-1_all_corrected,69,56,316,271,385,327
193640,30111_20190823124151.jpg,イオン稲毛,1896,千葉,502,も,2019/8/23 12:40,2-1_all_corrected,68,54,201,162,269,216
193678,30111_20190823125705.jpg,イオン稲毛,3578,千葉,336,さ,2019/8/23 12:56,2-1_all_corrected,71,54,335,164,406,218
194462,30110_20190823172211.jpg,イオン金沢八景,8622,横浜,304,に,2019/8/23 17:03,2-1_all_corrected,52,42,465,95,517,137
194006,30110_20190823152410.jpg,イオン金沢八景,5586,横浜,302,つ,2019/8/23 15:23,2-1_all_corrected,64,58,414,88,478,146
194496,30110_20190823173009.jpg,イオン金沢八景,1964,横浜,336,も,2019/8/23 17:29,2-1_all_corrected,54,44,415,92,469,136
193671,30072_20190823125317.jpg,関西スーパー京阪大和田１F,1584,大阪,480,た,2019/8/23 12:52,2-1_all_corrected,78,60,153,236,231,296
194834,30110_20190823180900.jpg,イオン金沢八景,*306,横浜,341,つ,2019/8/23 18:08,2-1_all_corrected,57,45,209,137,266,182
194407,30110_20190823171156.jpg,イオン金沢八景,4718,横浜,504,は,2019/8/23 16:53,2-1_all_corrected,86,82,28,290,114,372
194251,30111_20190823162939.jpg,イオン稲毛,2429,千葉,330,て,2019/8/23 16:28,2-1_all_corrected,59,42,341,140,400,182
194860,30062_20190823181444.jpg,ミスミモール,***3,神戸,30,ふ,2019/8/23 18:14,2-1_all_corrected,71,50,307,168,378,218
194438,30110_20190823171744.jpg,イオン金沢八景,1123,横浜,572,そ,2019/8/23 16:59,2-1_all_corrected,71,60,447,179,518,239
194400,30110_20190823171057.jpg,イオン金沢八景,*558,横浜,583,た,2019/8/23 16:52,2-1_all_corrected,88,69,165,337,253,406
193417,30144_20190823111734.jpg,イオン幕張,*123,千葉,357,ち,2019/8/23 11:17,2-1_all_corrected,58,42,181,170,239,212
194867,30110_20190823181555.jpg,イオン金沢八景,*605,横浜,583,ゆ,2019/8/23 18:15,2-1_all_corrected,73,60,367,159,440,219
194436,30110_20190823171726.jpg,イオン金沢八景,*326,湘南,531,む,2019/8/23 16:59,2-1_all_corrected,71,55,421,236,492,291
194294,30078_20190823164651.jpg,イオンスタイル仙台卸町店,***1,宮城,527,の,2019/8/23 16:46,2-1_all_corrected,82,59,262,278,344,337
195510,30078_20190823211352.jpg,イオンスタイル仙台卸町店,8877,いわき,330,ふ,2019/8/23 21:13,2-1_all_corrected,86,63,205,267,291,330
194409,30110_20190823171208.jpg,イオン金沢八景,*713,横浜,344,ぬ,2019/8/23 16:53,2-1_all_corrected,85,70,152,321,237,391
194293,30078_20190823164647.jpg,イオンスタイル仙台卸町店,***1,宮城,527,の,2019/8/23 16:46,2-1_all_corrected,74,57,255,200,329,257
194869,30046_20190823181628.jpg,マミーマート船橋日大[地上],***3,習志野,527,む,2019/8/23 18:16,2-1_all_corrected,41,34,227,25,268,59
194431,30110_20190823171613.jpg,イオン金沢八景,7255,横浜,331,も,2019/8/23 16:57,2-1_all_corrected,57,46,383,70,440,116
195528,30110_20190823212445.jpg,イオン金沢八景,*328,横浜,348,ろ,2019/8/23 21:24,2-1_all_corrected,58,44,336,90,394,134
194452,30110_20190823172004.jpg,イオン金沢八景,1176,横浜,338,ら,2019/8/23 17:01,2-1_all_corrected,46,45,537,106,583,151
195325,30167_20190823200243.jpg,イオン東雲店,*673,春日部,880,り,2019/8/23 20:02,2-1_all_corrected,76,65,131,301,207,366
194455,30110_20190823172052.jpg,イオン金沢八景,5576,横浜,50,み,2019/8/23 17:02,2-1_all_corrected,56,44,299,178,355,222
194497,30072_20190823173031.jpg,関西スーパー京阪大和田１F,***1,大阪,569,ゆ,2019/8/23 17:30,2-1_all_corrected,68,58,84,184,152,242
194463,30110_20190823172222.jpg,イオン金沢八景,*562,横浜,332,ほ,2019/8/23 17:04,2-1_all_corrected,52,43,441,142,493,185
195119,30144_20190823190522.jpg,イオン幕張,4535,習志野,330,つ,2019/8/23 19:05,2-1_all_corrected,82,57,286,292,368,349
194464,30110_20190823172231.jpg,イオン金沢八景,1696,横浜,330,ぬ,2019/8/23 17:04,2-1_all_corrected,78,69,4,253,82,322
193641,30167_20190823124257.jpg,イオン東雲店,7411,足立,230,さ,2019/8/23 12:42,2-1_all_corrected,57,41,348,326,405,367
194868,30110_20190823181605.jpg,イオン金沢八景,*907,横浜,335,ほ,2019/8/23 18:15,2-1_all_corrected,74,60,176,158,250,218
193840,30167_20190823135949.jpg,イオン東雲店,***9,練馬,395,な,2019/8/23 13:59,2-1_all_corrected,37,28,392,81,429,109
194295,30110_20190823164653.jpg,イオン金沢八景,*743,横浜,505,そ,2019/8/23 16:28,2-1_all_corrected,47,40,459,65,506,105
194850,30144_20190823181321.jpg,イオン幕張,*555,千葉,511,た,2019/8/23 18:12,2-1_all_corrected,81,56,277,326,358,382
194065,30167_20190823154134.jpg,イオン東雲店,*151,足立,502,と,2019/8/23 15:41,2-1_all_corrected,47,38,303,270,350,308
194401,30110_20190823171128.jpg,イオン金沢八景,1223,横浜,538,ふ,2019/8/23 16:53,2-1_all_corrected,82,71,499,316,581,387
194406,30110_20190823171151.jpg,イオン金沢八景,4335,横浜,504,み,2019/8/23 16:53,2-1_all_corrected,66,54,455,96,521,150
195382,30156_20190823202924.jpg,万代 西神中央店,3369,神戸,331,に,2019/8/23 20:28,2-1_all_corrected,53,40,280,241,333,281
195144,30110_20190823191113.jpg,イオン金沢八景,*525,横浜,363,て,2019/8/23 19:10,2-1_all_corrected,49,46,254,183,303,229
192950,30157_20190823082406.jpg,関西スーパー中央,8927,大阪,600,せ,2019/8/23 8:23,2-1_all_corrected,52,43,428,263,480,306
195009,30111_20190823184124.jpg,イオン稲毛,8515,千葉,503,つ,2019/8/23 18:40,2-1_all_corrected,70,50,305,170,375,220
194580,30144_20190823174945.jpg,イオン幕張,*971,千葉,501,ひ,2019/8/23 17:49,2-1_all_corrected,62,39,216,195,278,234
195452,30078_20190823205406.jpg,イオンスタイル仙台卸町店,8672,仙台,530,ち,2019/8/23 20:53,2-1_all_corrected,87,66,172,277,259,343
195031,30072_20190823184600.jpg,関西スーパー京阪大和田１F,1118,大阪,387,や,2019/8/23 18:45,2-1_all_corrected,68,59,346,109,414,168
193590,30044_20190823121653.jpg,ココス横浜港南台,***3,横浜,30,ら,2019/8/23 12:16,2-1_all_corrected,101,65,499,372,600,437
194777,30111_20190823180534.jpg,イオン稲毛,3776,千葉,537,せ,2019/8/23 18:04,2-1_all_corrected,55,42,369,103,424,145
193555,30144_20190823115938.jpg,イオン幕張,1754,千葉,301,る,2019/8/23 11:59,2-1_all_corrected,73,50,246,251,319,301
195430,30006_20190823204932.jpg,スギ薬局南千里,2018,大阪,332,め,2019/8/23 20:49,2-1_all_corrected,95,53,443,6,538,59
194516,30110_20190823173400.jpg,イオン金沢八景,3103,宮城,531,ぬ,2019/8/23 17:33,2-1_all_corrected,69,54,228,212,297,266
193992,30062_20190823151508.jpg,ミスミモール,**10,神戸,31,む,2019/8/23 15:14,2-1_all_corrected,78,62,266,187,344,249
194985,30066_20190823183355.jpg,ジョーシン和泉中央,***5,和泉,30,も,2019/8/23 18:33,2-1_all_corrected,77,59,179,261,256,320
194529,30110_20190823173730.jpg,イオン金沢八景,7072,横浜,330,ま,2019/8/23 17:37,2-1_all_corrected,68,55,245,126,313,181
194347,30110_20190823165627.jpg,イオン金沢八景,*708,横浜,585,き,2019/8/23 16:38,2-1_all_corrected,52,43,392,58,444,101
194175,30062_20190823160143.jpg,ミスミモール,8888,神戸,30,み,2019/8/23 16:01,2-1_all_corrected,66,55,371,131,437,186
194511,30111_20190823173303.jpg,イオン稲毛,4516,千葉,580,け,2019/8/23 17:31,2-1_all_corrected,79,60,222,212,301,272
194385,30110_20190823170700.jpg,イオン金沢八景,3012,横浜,480,ち,2019/8/23 16:48,2-1_all_corrected,68,55,154,230,222,285
193392,30078_20190823110753.jpg,イオンスタイル仙台卸町店,7583,仙台,530,た,2019/8/23 11:07,2-1_all_corrected,70,56,314,158,384,214
194518,30110_20190823173427.jpg,イオン金沢八景,7903,横浜,303,や,2019/8/23 17:34,2-1_all_corrected,64,58,64,183,128,241
194382,30110_20190823170546.jpg,イオン金沢八景,1013,横浜,304,な,2019/8/23 16:47,2-1_all_corrected,56,46,486,70,542,116
194520,30111_20190823173507.jpg,イオン稲毛,3700,千葉,583,き,2019/8/23 17:32,2-1_all_corrected,70,55,177,169,247,224
194349,30110_20190823165643.jpg,イオン金沢八景,5574,横浜,330,つ,2019/8/23 16:38,2-1_all_corrected,72,63,500,156,572,219
194947,30169_20190823182548.jpg,イオン相模原ショッピングセンター,2017,相模,331,ゆ,2019/8/23 18:25,2-1_all_corrected,57,45,102,118,159,163
194315,30110_20190823165214.jpg,イオン金沢八景,8823,横浜,351,ゆ,2019/8/23 16:33,2-1_all_corrected,76,65,476,197,552,262
194785,30060_20190823180557.jpg,関西スーパー小野原,3406,大阪,480,な,2019/8/23 18:05,2-1_all_corrected,74,59,409,366,483,425
195039,30110_20190823184744.jpg,イオン金沢八景,8829,横浜,580,の,2019/8/23 18:47,2-1_all_corrected,53,43,252,184,305,227
194749,30110_20190823180320.jpg,イオン金沢八景,*930,横浜,304,ふ,2019/8/23 18:02,2-1_all_corrected,71,65,46,179,117,244
194312,30110_20190823165134.jpg,イオン金沢八景,*910,横浜,584,く,2019/8/23 16:33,2-1_all_corrected,51,38,443,139,494,177
194544,30110_20190823174031.jpg,イオン金沢八景,7022,横浜,580,そ,2019/8/23 17:40,2-1_all_corrected,72,59,188,270,260,329
195202,30110_20190823192559.jpg,イオン金沢八景,1203,横浜,342,ま,2019/8/23 19:25,2-1_all_corrected,85,70,177,231,262,301
193565,30078_20190823120226.jpg,イオンスタイル仙台卸町店,9119,仙台,530,そ,2019/8/23 12:02,2-1_all_corrected,72,57,354,192,426,249
194324,30110_20190823165346.jpg,イオン金沢八景,1130,横浜,504,さ,2019/8/23 16:35,2-1_all_corrected,76,60,289,198,365,258
194323,30110_20190823165328.jpg,イオン金沢八景,*801,横浜,350,る,2019/8/23 16:35,2-1_all_corrected,88,76,501,374,589,450
194581,30110_20190823174949.jpg,イオン金沢八景,7900,横浜,304,つ,2019/8/23 17:49,2-1_all_corrected,72,54,215,188,287,242
195453,30078_20190823205411.jpg,イオンスタイル仙台卸町店,8672,仙台,530,ち,2019/8/23 20:53,2-1_all_corrected,86,62,172,260,258,322
195037,30110_20190823184706.jpg,イオン金沢八景,*500,横浜,351,み,2019/8/23 18:46,2-1_all_corrected,78,60,266,203,344,263
194377,30110_20190823170355.jpg,イオン金沢八景,*190,湘南,332,ぬ,2019/8/23 16:45,2-1_all_corrected,54,42,398,105,452,147
195097,30110_20190823190029.jpg,イオン金沢八景,*154,横浜,580,ね,2019/8/23 19:00,2-1_all_corrected,51,43,258,179,309,222
194145,30143_20190823155323.jpg,イオン久里浜,3706,横浜,500,う,2019/8/23 15:52,2-1_all_corrected,80,58,362,320,442,378
193536,30091_20190823115337.jpg,イトーヨーカドー木場 立体,4099,足立,481,り,2019/8/23 11:53,2-1_all_corrected,67,62,394,202,461,264
195251,30078_20190823193923.jpg,イオンスタイル仙台卸町店,*707,仙台,583,む,2019/8/23 19:38,2-1_all_corrected,57,39,264,103,321,142
194348,30110_20190823165632.jpg,イオン金沢八景,*569,横浜,504,せ,2019/8/23 16:38,2-1_all_corrected,54,44,460,138,514,182
195256,30110_20190823194131.jpg,イオン金沢八景,1217,横浜,547,り,2019/8/23 19:41,2-1_all_corrected,54,40,302,71,356,111
194384,30110_20190823170655.jpg,イオン金沢八景,3012,横浜,480,ち,2019/8/23 16:48,2-1_all_corrected,73,57,370,215,443,272
194526,30110_20190823173719.jpg,イオン金沢八景,5695,横浜,504,も,2019/8/23 17:36,2-1_all_corrected,70,62,177,196,247,258
195090,30110_20190823185858.jpg,イオン金沢八景,1143,横浜,304,に,2019/8/23 18:58,2-1_all_corrected,50,39,238,37,288,76
194370,30110_20190823170230.jpg,イオン金沢八景,*122,横浜,540,ふ,2019/8/23 16:44,2-1_all_corrected,77,64,452,202,529,266
195269,30006_20190823194322.jpg,スギ薬局南千里,*212,大阪,301,も,2019/8/23 19:43,2-1_all_corrected,91,55,314,42,405,97
194948,30167_20190823182605.jpg,イオン東雲店,4704,足立,481,り,2019/8/23 18:25,2-1_all_corrected,70,62,170,272,240,334
194346,30066_20190823165619.jpg,ジョーシン和泉中央,***3,和泉,30,も,2019/8/23 16:55,2-1_all_corrected,54,42,324,139,378,181
195294,30110_20190823195202.jpg,イオン金沢八景,1346,横浜,304,ね,2019/8/23 19:51,2-1_all_corrected,53,40,323,65,376,105
193735,30144_20190823132124.jpg,イオン幕張,2102,千葉,330,る,2019/8/23 13:21,2-1_all_corrected,62,41,205,152,267,193
194517,30110_20190823173405.jpg,イオン金沢八景,3592,横浜,580,や,2019/8/23 17:33,2-1_all_corrected,67,54,417,97,484,151
194341,30110_20190823165527.jpg,イオン金沢八景,3895,横浜,505,そ,2019/8/23 16:37,2-1_all_corrected,53,47,463,95,516,142
195055,30006_20190823184955.jpg,スギ薬局南千里,*281,名古屋,506,め,2019/8/23 18:49,2-1_all_corrected,98,58,305,55,403,113
195603,30079_20190823221041.jpg,ピットデザイン仙台卸町駅前駐車場,*127,宮城,333,め,2019/8/23 22:10,2-1_all_corrected,60,43,426,141,486,184
193782,30167_20190823133439.jpg,イオン東雲店,*123,多摩,355,む,2019/8/23 13:34,2-1_all_corrected,54,44,420,320,474,364
194554,30169_20190823174400.jpg,イオン相模原ショッピングセンター,*166,多摩,530,む,2019/8/23 17:43,2-1_all_corrected,48,40,125,79,173,119
195016,30072_20190823184210.jpg,関西スーパー京阪大和田１F,5060,大阪,581,と,2019/8/23 18:41,2-1_all_corrected,70,54,121,223,191,277
192936,30072_20190823081351.jpg,関西スーパー京阪大和田１F,3022,奈良,830,あ,2019/8/23 8:13,2-1_all_corrected,64,62,288,134,352,196
193581,30045_20190823121137.jpg,マックスバリュー徳川明倫,8008,名古屋,31,は,2019/8/23 12:11,2-1_all_corrected,54,44,228,155,282,199
195027,30110_20190823184455.jpg,イオン金沢八景,2346,横浜,303,め,2019/8/23 18:44,2-1_all_corrected,53,42,256,113,309,155
194565,30110_20190823174523.jpg,イオン金沢八景,3821,横浜,304,ち,2019/8/23 17:44,2-1_all_corrected,66,57,180,144,246,201
194333,30169_20190823165448.jpg,イオン相模原ショッピングセンター,**37,相模,333,ね,2019/8/23 16:54,2-1_all_corrected,92,72,220,312,312,384
195018,30110_20190823184252.jpg,イオン金沢八景,8441,横浜,505,つ,2019/8/23 18:42,2-1_all_corrected,53,42,444,117,497,159
195073,30110_20190823185350.jpg,イオン金沢八景,3016,横浜,331,せ,2019/8/23 18:53,2-1_all_corrected,77,98,0,343,77,441
194393,30037_20190823170835.jpg,西友鳴海,*358,名古屋,32,た,2019/8/23 17:08,2-1_all_corrected,52,41,422,145,474,186
195417,30098_20190823204625.jpg,BRANCH仙台（東棟）,*211,仙台,333,ぬ,2019/8/23 20:45,2-1_all_corrected,103,77,227,291,330,368
194531,30110_20190823173818.jpg,イオン金沢八景,7884,横浜,504,せ,2019/8/23 17:37,2-1_all_corrected,68,53,348,132,416,185
195087,30110_20190823185819.jpg,イオン金沢八景,2736,横浜,530,み,2019/8/23 18:57,2-1_all_corrected,71,55,292,148,363,203
194367,30110_20190823170144.jpg,イオン金沢八景,3278,横浜,504,ぬ,2019/8/23 16:43,2-1_all_corrected,57,45,393,174,450,219
194509,30110_20190823173217.jpg,イオン金沢八景,2056,多摩,581,い,2019/8/23 17:31,2-1_all_corrected,55,45,255,229,310,274
194951,30169_20190823182658.jpg,イオン相模原ショッピングセンター,5115,多摩,580,に,2019/8/23 18:26,2-1_all_corrected,98,75,378,375,476,450
194360,30110_20190823165815.jpg,イオン金沢八景,3180,横浜,531,む,2019/8/23 16:39,2-1_all_corrected,54,44,428,102,482,146
194536,30169_20190823173937.jpg,イオン相模原ショッピングセンター,1108,相模,334,つ,2019/8/23 17:39,2-1_all_corrected,79,66,318,218,397,284
194394,30110_20190823170837.jpg,イオン金沢八景,*817,品川,337,に,2019/8/23 16:50,2-1_all_corrected,63,58,5,156,68,214
194369,30110_20190823170203.jpg,イオン金沢八景,5188,横浜,304,と,2019/8/23 16:43,2-1_all_corrected,77,56,348,136,425,192
194993,30144_20190823183519.jpg,イオン幕張,*373,千葉,480,せ,2019/8/23 18:34,2-1_all_corrected,77,55,241,280,318,335
194500,30111_20190823173052.jpg,イオン稲毛,3811,千葉,583,て,2019/8/23 17:29,2-1_all_corrected,55,40,328,142,383,182
195284,30110_20190823194942.jpg,イオン金沢八景,*312,横浜,500,み,2019/8/23 19:49,2-1_all_corrected,66,54,193,173,259,227
194958,30110_20190823182801.jpg,イオン金沢八景,8589,横浜,330,ぬ,2019/8/23 18:27,2-1_all_corrected,69,50,308,123,377,173
194538,30110_20190823173959.jpg,イオン金沢八景,**75,横浜,532,も,2019/8/23 17:39,2-1_all_corrected,70,53,283,163,353,216
194960,30144_20190823182848.jpg,イオン幕張,*215,千葉,337,ひ,2019/8/23 18:28,2-1_all_corrected,81,60,366,293,447,353
194351,30110_20190823165657.jpg,イオン金沢八景,8118,横浜,585,ほ,2019/8/23 16:38,2-1_all_corrected,68,60,460,213,528,273
193573,30090_20190823120620.jpg,イトーヨーカドー木場 西棟,2010,足立,336,る,2019/8/23 12:05,2-1_all_corrected,99,59,172,391,271,450
194332,30110_20190823165442.jpg,イオン金沢八景,2573,横浜,303,な,2019/8/23 16:36,2-1_all_corrected,79,59,265,202,344,261
194590,30110_20190823175106.jpg,イオン金沢八景,1124,横浜,549,そ,2019/8/23 17:50,2-1_all_corrected,73,63,260,198,333,261
193914,30062_20190823143417.jpg,ミスミモール,8888,神戸,30,み,2019/8/23 14:33,2-1_all_corrected,81,63,362,184,443,247
194555,30110_20190823174408.jpg,イオン金沢八景,2551,横浜,503,せ,2019/8/23 17:43,2-1_all_corrected,78,60,285,284,363,344
194767,30144_20190823180439.jpg,イオン幕張,6588,千葉,580,た,2019/8/23 18:04,2-1_all_corrected,48,33,157,107,205,140
194303,30110_20190823164836.jpg,イオン金沢八景,7533,横浜,304,ね,2019/8/23 16:30,2-1_all_corrected,67,57,78,162,145,219
194136,30167_20190823155028.jpg,イオン東雲店,4505,足立,481,り,2019/8/23 15:50,2-1_all_corrected,74,64,104,315,178,379
194552,30110_20190823174346.jpg,イオン金沢八景,2710,横浜,333,そ,2019/8/23 17:43,2-1_all_corrected,52,42,398,102,450,144
194539,30045_20190823174000.jpg,マックスバリュー徳川明倫,1010,名古屋,31,ゆ,2019/8/23 17:39,2-1_all_corrected,54,43,251,126,305,169
193982,30167_20190823151008.jpg,イオン東雲店,4006,土浦,580,ほ,2019/8/23 15:09,2-1_all_corrected,72,61,107,258,179,319
193723,30138_20190823131325.jpg,イオンスタイル湘南茅ヶ崎,2402,湘南,502,と,2019/8/23 13:12,2-1_all_corrected,58,44,269,113,327,157
194506,30110_20190823173140.jpg,イオン金沢八景,1206,横浜,351,な,2019/8/23 17:31,2-1_all_corrected,71,55,259,157,330,212
195276,30110_20190823194556.jpg,イオン金沢八景,7145,横浜,580,あ,2019/8/23 19:45,2-1_all_corrected,75,63,162,204,237,267
195271,30063_20190823194350.jpg,コーナン相模原小山モール,7745,相模,301,そ,2019/8/23 19:43,2-1_all_corrected,64,60,455,123,519,183
193516,30111_20190823114849.jpg,イオン稲毛,1369,千葉,583,こ,2019/8/23 11:47,2-1_all_corrected,55,45,213,152,268,197
195285,30169_20190823194942.jpg,イオン相模原ショッピングセンター,4613,相模,301,と,2019/8/23 19:49,2-1_all_corrected,86,75,443,317,529,392
194357,30110_20190823165733.jpg,イオン金沢八景,7123,横浜,531,さ,2019/8/23 16:39,2-1_all_corrected,56,45,360,166,416,211
194395,30110_20190823170844.jpg,イオン金沢八景,*812,横浜,584,も,2019/8/23 16:50,2-1_all_corrected,53,46,153,119,206,165
194361,30110_20190823165845.jpg,イオン金沢八景,1177,横浜,369,ま,2019/8/23 16:40,2-1_all_corrected,55,43,461,71,516,114
194537,30110_20190823173937.jpg,イオン金沢八景,*907,横浜,339,そ,2019/8/23 17:39,2-1_all_corrected,74,63,95,175,169,238
194359,30110_20190823165753.jpg,イオン金沢八景,***2,横浜,518,と,2019/8/23 16:39,2-1_all_corrected,53,41,307,164,360,205
194366,30110_20190823170129.jpg,イオン金沢八景,1033,横浜,505,な,2019/8/23 16:43,2-1_all_corrected,51,42,427,151,478,193
194392,30110_20190823170821.jpg,イオン金沢八景,8103,横浜,303,は,2019/8/23 16:50,2-1_all_corrected,55,45,496,140,551,185
195072,30110_20190823185340.jpg,イオン金沢八景,7806,横浜,501,ぬ,2019/8/23 18:53,2-1_all_corrected,66,55,299,155,365,210
194442,30110_20190823171803.jpg,イオン金沢八景,1971,横浜,334,る,2019/8/23 16:59,2-1_all_corrected,52,48,87,182,139,230
193667,30167_20190823125150.jpg,イオン東雲店,6767,足立,530,う,2019/8/23 12:51,2-1_all_corrected,84,65,79,312,163,377
194489,30066_20190823172824.jpg,ジョーシン和泉中央,***3,和泉,30,ね,2019/8/23 17:27,2-1_all_corrected,56,47,252,200,308,247
194825,30110_20190823180829.jpg,イオン金沢八景,1752,横浜,530,み,2019/8/23 18:08,2-1_all_corrected,54,45,277,120,331,165
193452,30046_20190823112839.jpg,マミーマート船橋日大[地上],*806,習志野,530,ふ,2019/8/23 11:28,2-1_all_corrected,40,28,149,33,189,61
194445,30111_20190823171910.jpg,イオン稲毛,7201,千葉,302,て,2019/8/23 17:18,2-1_all_corrected,56,44,201,112,257,156
193835,30106_20190823135739.jpg,ジョーシン東大阪長田,1122,大阪,31,た,2019/8/23 13:57,2-1_all_corrected,58,42,406,102,464,144
194473,30110_20190823172527.jpg,イオン金沢八景,4657,横浜,300,ふ,2019/8/23 17:24,2-1_all_corrected,60,45,388,204,448,249
194487,30167_20190823172809.jpg,イオン東雲店,**21,大宮,431,て,2019/8/23 17:27,2-1_all_corrected,55,43,279,202,334,245
194480,30110_20190823172611.jpg,イオン金沢八景,6733,横浜,480,ち,2019/8/23 17:25,2-1_all_corrected,75,61,390,236,465,297
194474,30144_20190823172535.jpg,イオン幕張,3189,千葉,581,あ,2019/8/23 17:25,2-1_all_corrected,76,59,311,262,387,321
193235,30046_20190823102533.jpg,マミーマート船橋日大[地上],3306,習志野,330,ま,2019/8/23 10:25,2-1_all_corrected,53,42,242,110,295,152
193804,30111_20190823134247.jpg,イオン稲毛,8822,千葉,530,ゆ,2019/8/23 13:42,2-1_all_corrected,70,51,329,167,399,218
194282,30110_20190823164509.jpg,イオン金沢八景,3046,横浜,504,ま,2019/8/23 16:25,2-1_all_corrected,70,63,146,190,216,253
194420,30110_20190823171438.jpg,イオン金沢八景,5678,横浜,321,ま,2019/8/23 16:56,2-1_all_corrected,56,42,385,148,441,190
193605,30167_20190823122015.jpg,イオン東雲店,*123,多摩,355,む,2019/8/23 12:19,2-1_all_corrected,56,45,390,319,446,364
194878,30110_20190823181806.jpg,イオン金沢八景,3874,横浜,503,め,2019/8/23 18:17,2-1_all_corrected,54,42,266,102,320,144
194427,30110_20190823171532.jpg,イオン金沢八景,4189,横浜,35,つ,2019/8/23 16:57,2-1_all_corrected,67,61,111,189,178,250
194285,30110_20190823164522.jpg,イオン金沢八景,1212,横浜,313,ね,2019/8/23 16:25,2-1_all_corrected,81,73,90,236,171,309
194278,30111_20190823164443.jpg,イオン稲毛,3887,千葉,502,さ,2019/8/23 16:43,2-1_all_corrected,57,42,351,130,408,172
193634,30157_20190823123737.jpg,関西スーパー中央,1188,神戸,590,て,2019/8/23 12:37,2-1_all_corrected,57,39,160,411,217,450
194411,30110_20190823171233.jpg,イオン金沢八景,*435,横浜,504,ま,2019/8/23 16:54,2-1_all_corrected,73,64,462,236,535,300
194623,30167_20190823175352.jpg,イオン東雲店,4965,足立,480,う,2019/8/23 17:53,2-1_all_corrected,80,63,268,247,348,310
194247,30046_20190823162402.jpg,マミーマート船橋日大[地上],8665,春日部,501,な,2019/8/23 16:23,2-1_all_corrected,52,37,179,120,231,157
195359,30169_20190823201843.jpg,イオン相模原ショッピングセンター,2757,多摩,500,ろ,2019/8/23 20:18,2-1_all_corrected,80,60,253,127,333,187
194429,30110_20190823171547.jpg,イオン金沢八景,*932,横浜,330,り,2019/8/23 16:57,2-1_all_corrected,75,60,297,261,372,321
194240,30144_20190823162126.jpg,イオン幕張,2525,袖ヶ浦,547,て,2019/8/23 16:20,2-1_all_corrected,93,66,278,372,371,438
193650,30139_20190823124632.jpg,イオン板橋ショッピングセンター,***1,練馬,30,ね,2019/8/23 12:46,2-1_all_corrected,45,34,383,122,428,156
194011,30167_20190823152630.jpg,イオン東雲店,3132,横浜,304,め,2019/8/23 15:26,2-1_all_corrected,55,45,370,296,425,341
194481,30111_20190823172628.jpg,イオン稲毛,8733,千葉,530,せ,2019/8/23 17:25,2-1_all_corrected,52,41,208,139,260,180
194678,30111_20190823175742.jpg,イオン稲毛,1219,千葉,537,も,2019/8/23 17:57,2-1_all_corrected,59,39,350,123,409,162
194444,30110_20190823171905.jpg,イオン金沢八景,*601,横浜,338,と,2019/8/23 17:00,2-1_all_corrected,89,79,112,303,201,382
194020,30167_20190823153132.jpg,イオン東雲店,4230,足立,500,に,2019/8/23 15:31,2-1_all_corrected,36,34,1,40,37,74
194443,30110_20190823171820.jpg,イオン金沢八景,*113,横浜,357,は,2019/8/23 17:00,2-1_all_corrected,79,65,494,194,573,259
193692,30001_20190823130248.jpg,関西スーパー高石駅前,4123,和泉,500,め,2019/8/23 13:02,2-1_all_corrected,97,69,323,204,420,273
194488,30110_20190823172818.jpg,イオン金沢八景,*512,横浜,356,む,2019/8/23 17:27,2-1_all_corrected,54,43,385,59,439,102
194428,30110_20190823171541.jpg,イオン金沢八景,8033,横浜,303,る,2019/8/23 16:57,2-1_all_corrected,77,61,173,185,250,246
195358,30169_20190823201838.jpg,イオン相模原ショッピングセンター,3113,多摩,334,ろ,2019/8/23 20:18,2-1_all_corrected,47,44,123,259,170,303
194241,30144_20190823162135.jpg,イオン幕張,3661,習志野,330,つ,2019/8/23 16:21,2-1_all_corrected,57,42,206,151,263,193
194417,30110_20190823171352.jpg,イオン金沢八景,1278,横浜,333,さ,2019/8/23 16:55,2-1_all_corrected,81,75,18,282,99,357
195199,30169_20190823192531.jpg,イオン相模原ショッピングセンター,***5,相模,375,に,2019/8/23 19:24,2-1_all_corrected,53,41,178,102,231,143
193251,30006_20190823102720.jpg,スギ薬局南千里,3550,大阪,501,も,2019/8/23 10:27,2-1_all_corrected,84,51,462,28,546,79
194848,30110_20190823181227.jpg,イオン金沢八景,3759,横浜,302,や,2019/8/23 18:12,2-1_all_corrected,67,62,199,179,266,241
194419,30110_20190823171419.jpg,イオン金沢八景,8913,横浜,580,ゆ,2019/8/23 16:55,2-1_all_corrected,72,55,238,229,310,284
194284,30110_20190823164518.jpg,イオン金沢八景,8257,横浜,504,み,2019/8/23 16:25,2-1_all_corrected,74,55,289,194,363,249
194614,30110_20190823175312.jpg,イオン金沢八景,1003,横浜,303,せ,2019/8/23 17:52,2-1_all_corrected,71,62,227,224,298,286
194426,30110_20190823171525.jpg,イオン金沢八景,*784,名古屋,583,え,2019/8/23 16:57,2-1_all_corrected,53,47,187,147,240,194
195538,30111_20190823213040.jpg,イオン稲毛,1005,千葉,346,み,2019/8/23 21:30,2-1_all_corrected,54,45,190,132,244,177
195351,30167_20190823201621.jpg,イオン東雲店,4704,足立,481,り,2019/8/23 20:15,2-1_all_corrected,70,69,155,346,225,415
194283,30110_20190823164513.jpg,イオン金沢八景,8257,横浜,504,み,2019/8/23 16:25,2-1_all_corrected,51,42,511,144,562,186
195163,30078_20190823191503.jpg,イオンスタイル仙台卸町店,***6,仙台,336,つ,2019/8/23 19:14,2-1_all_corrected,84,58,217,225,301,283
193242,30110_20190823102553.jpg,イオン金沢八景,5589,横浜,359,ふ,2019/8/23 10:25,2-1_all_corrected,102,79,44,371,146,450
194058,30072_20190823154036.jpg,関西スーパー京阪大和田１F,4128,大阪,580,ぬ,2019/8/23 15:40,2-1_all_corrected,44,33,326,15,370,48
192955,30072_20190823082739.jpg,関西スーパー京阪大和田１F,*762,京都,800,せ,2019/8/23 8:26,2-1_all_corrected,81,62,78,299,159,361
194890,30144_20190823182008.jpg,イオン幕張,6251,習志野,330,つ,2019/8/23 18:19,2-1_all_corrected,79,57,218,284,297,341
194404,30110_20190823171139.jpg,イオン金沢八景,1729,横浜,532,ち,2019/8/23 16:53,2-1_all_corrected,51,45,513,108,564,153
194299,30110_20190823164745.jpg,イオン金沢八景,2585,横浜,504,た,2019/8/23 16:29,2-1_all_corrected,66,57,178,178,244,235
193041,30006_20190823091218.jpg,スギ薬局南千里,*990,大阪,330,ほ,2019/8/23 9:12,2-1_all_corrected,79,44,429,0,508,44
194432,30110_20190823171629.jpg,イオン金沢八景,**62,横浜,502,わ,2019/8/23 16:58,2-1_all_corrected,55,45,392,93,447,138
194435,30110_20190823171717.jpg,イオン金沢八景,*510,横浜,556,さ,2019/8/23 16:58,2-1_all_corrected,75,70,117,272,192,342
195183,30015_20190823192045.jpg,フォルテ蘇我テナント棟,7455,千葉,-1,か,2019/8/23 19:20,2-1_all_corrected,54,67,260,338,314,405
194051,30111_20190823154009.jpg,イオン稲毛,*214,千葉,587,う,2019/8/23 15:38,2-1_all_corrected,56,42,357,116,413,158
195177,30111_20190823191836.jpg,イオン稲毛,*514,千葉,336,ほ,2019/8/23 19:17,2-1_all_corrected,49,41,161,111,210,152
195345,30169_20190823201429.jpg,イオン相模原ショッピングセンター,8822,多摩,800,せ,2019/8/23 20:14,2-1_all_corrected,93,79,395,337,488,416
195148,30072_20190823191130.jpg,関西スーパー京阪大和田１F,1328,大阪,580,ね,2019/8/23 19:10,2-1_all_corrected,72,61,220,303,292,364
194461,30110_20190823172155.jpg,イオン金沢八景,5178,横浜,303,ら,2019/8/23 17:03,2-1_all_corrected,70,74,0,276,70,350
194839,30110_20190823181041.jpg,イオン金沢八景,*915,横浜,348,り,2019/8/23 18:10,2-1_all_corrected,69,54,215,142,284,196
194495,30110_20190823173004.jpg,イオン金沢八景,1957,湘南,580,わ,2019/8/23 17:29,2-1_all_corrected,51,40,400,160,451,200
194492,30111_20190823172916.jpg,イオン稲毛,*613,千葉,335,り,2019/8/23 17:28,2-1_all_corrected,68,56,259,181,327,237
194239,30060_20190823162119.jpg,関西スーパー小野原,8832,大阪,503,ほ,2019/8/23 16:20,2-1_all_corrected,70,60,443,261,513,321
194837,30110_20190823181000.jpg,イオン金沢八景,5725,横浜,504,ち,2019/8/23 18:09,2-1_all_corrected,54,48,163,233,217,281
193681,30167_20190823125815.jpg,イオン東雲店,*124,世田谷,510,あ,2019/8/23 12:57,2-1_all_corrected,53,40,340,150,393,190
194450,30111_20190823171954.jpg,イオン稲毛,*106,千葉,537,さ,2019/8/23 17:19,2-1_all_corrected,58,45,332,157,390,202
194201,30111_20190823161417.jpg,イオン稲毛,7299,千葉,502,と,2019/8/23 16:13,2-1_all_corrected,54,46,221,168,275,214
194457,30110_20190823172128.jpg,イオン金沢八景,6101,横浜,502,め,2019/8/23 17:03,2-1_all_corrected,82,89,2,330,84,419
194434,30110_20190823171640.jpg,イオン金沢八景,4824,横浜,504,ね,2019/8/23 16:58,2-1_all_corrected,78,60,242,204,320,264
194606,30167_20190823175228.jpg,イオン東雲店,7411,足立,230,さ,2019/8/23 17:51,2-1_all_corrected,61,42,335,327,396,369
194265,30045_20190823163608.jpg,マックスバリュー徳川明倫,*358,名古屋,32,と,2019/8/23 16:35,2-1_all_corrected,78,58,202,204,280,262
194433,30110_20190823171635.jpg,イオン金沢八景,9472,横浜,504,に,2019/8/23 16:58,2-1_all_corrected,73,55,344,259,417,314
195515,30072_20190823211524.jpg,関西スーパー京阪大和田１F,*313,大阪,342,め,2019/8/23 21:14,2-1_all_corrected,68,53,133,96,201,149
194291,30078_20190823164623.jpg,イオンスタイル仙台卸町店,3518,仙台,583,あ,2019/8/23 16:46,2-1_all_corrected,72,54,293,177,365,231
193629,30057_20190823123417.jpg,ライフ東府中,***5,多摩,30,せ,2019/8/23 12:33,2-1_all_corrected,81,63,494,341,575,404
194854,30033_20190823181345.jpg,マックスバリュ南15条,***5,札幌,30,す,2019/8/23 18:13,2-1_all_corrected,107,88,350,317,457,405
194405,30110_20190823171141.jpg,イオン金沢八景,6755,横浜,304,に,2019/8/23 16:53,2-1_all_corrected,63,60,70,203,133,263
193076,30110_20190823094212.jpg,イオン金沢八景,1103,横浜,587,た,2019/8/23 9:41,2-1_all_corrected,60,45,310,125,370,170
194608,30111_20190823175234.jpg,イオン稲毛,7315,千葉,531,の,2019/8/23 17:51,2-1_all_corrected,77,57,317,194,394,251
194298,30110_20190823164706.jpg,イオン金沢八景,3789,横浜,580,く,2019/8/23 16:28,2-1_all_corrected,70,57,370,229,440,286
194402,30110_20190823171132.jpg,イオン金沢八景,*822,横浜,338,た,2019/8/23 16:53,2-1_all_corrected,106,87,74,359,180,446
194469,30110_20190823172405.jpg,イオン金沢八景,5561,横浜,330,や,2019/8/23 17:05,2-1_all_corrected,72,61,141,210,213,271
193687,30072_20190823130036.jpg,関西スーパー京阪大和田１F,3841,大阪,581,に,2019/8/23 13:00,2-1_all_corrected,46,35,389,39,435,74
193441,30060_20190823112354.jpg,関西スーパー小野原,8000,大阪,486,て,2019/8/23 11:23,2-1_all_corrected,71,62,427,340,498,402
193479,30111_20190823113500.jpg,イオン稲毛,9900,千葉,332,と,2019/8/23 11:34,2-1_all_corrected,56,44,391,146,447,190
194451,30110_20190823171955.jpg,イオン金沢八景,8258,横浜,330,め,2019/8/23 17:01,2-1_all_corrected,84,88,57,357,141,445
194663,30110_20190823175703.jpg,イオン金沢八景,2408,横浜,583,ち,2019/8/23 17:56,2-1_all_corrected,54,43,363,116,417,159
194035,30111_20190823153913.jpg,イオン稲毛,3776,千葉,585,の,2019/8/23 15:37,2-1_all_corrected,55,43,311,149,366,192
194467,30110_20190823172309.jpg,イオン金沢八景,8721,横浜,530,ま,2019/8/23 17:04,2-1_all_corrected,54,43,393,92,447,135
194493,30072_20190823172957.jpg,関西スーパー京阪大和田１F,2551,大阪,503,の,2019/8/23 17:28,2-1_all_corrected,89,72,206,297,295,369
195541,30091_20190823213219.jpg,イトーヨーカドー木場 立体,1010,伊豆,336,に,2019/8/23 21:31,2-1_all_corrected,69,59,152,216,221,275
195122,30110_20190823190557.jpg,イオン金沢八景,3154,横浜,530,は,2019/8/23 19:05,2-1_all_corrected,54,42,310,145,364,187
194460,30110_20190823172144.jpg,イオン金沢八景,7256,横浜,504,ふ,2019/8/23 17:03,2-1_all_corrected,67,58,469,146,536,204
194512,30110_20190823173309.jpg,イオン金沢八景,1118,横浜,394,つ,2019/8/23 17:32,2-1_all_corrected,72,59,178,164,250,223
195434,30169_20190823205008.jpg,イオン相模原ショッピングセンター,1014,横浜,346,の,2019/8/23 20:49,2-1_all_corrected,72,69,446,268,518,337
194975,30110_20190823183056.jpg,イオン金沢八景,3999,川崎,580,け,2019/8/23 18:30,2-1_all_corrected,56,45,316,204,372,249
194515,30110_20190823173355.jpg,イオン金沢八景,8826,横浜,504,て,2019/8/23 17:33,2-1_all_corrected,73,61,200,225,273,286
194343,30110_20190823165535.jpg,イオン金沢八景,1129,横浜,586,め,2019/8/23 16:37,2-1_all_corrected,80,65,417,163,497,228
193354,30167_20190823105150.jpg,イオン東雲店,6718,品川,500,ぬ,2019/8/23 10:51,2-1_all_corrected,53,42,283,168,336,210
195068,30144_20190823185237.jpg,イオン幕張,**10,千葉,343,つ,2019/8/23 18:52,2-1_all_corrected,70,53,253,211,323,264
194986,30070_20190823183430.jpg,カナートモール住道第一,***2,大阪,30,ら,2019/8/23 18:34,2-1_all_corrected,81,65,69,219,150,284
194388,30110_20190823170720.jpg,イオン金沢八景,3290,横浜,580,ま,2019/8/23 16:48,2-1_all_corrected,73,57,291,252,364,309
194718,30110_20190823180102.jpg,イオン金沢八景,2009,横浜,336,み,2019/8/23 18:00,2-1_all_corrected,68,55,305,100,373,155
194381,30110_20190823170540.jpg,イオン金沢八景,8000,横浜,395,は,2019/8/23 16:47,2-1_all_corrected,53,43,444,104,497,147
194375,30110_20190823170339.jpg,イオン金沢八景,2147,横浜,580,え,2019/8/23 16:45,2-1_all_corrected,76,62,230,277,306,339
194372,30110_20190823170248.jpg,イオン金沢八景,3210,横浜,534,ひ,2019/8/23 16:44,2-1_all_corrected,76,74,79,267,155,341
193391,30144_20190823110625.jpg,イオン幕張,4896,袖ヶ浦,580,と,2019/8/23 11:05,2-1_all_corrected,56,39,220,126,276,165
194319,30110_20190823165230.jpg,イオン金沢八景,5272,横浜,504,と,2019/8/23 16:34,2-1_all_corrected,67,59,110,227,177,286
194570,30110_20190823174600.jpg,イオン金沢八景,6070,横浜,303,ね,2019/8/23 17:45,2-1_all_corrected,71,56,191,211,262,267
194326,30110_20190823165351.jpg,イオン金沢八景,2208,横浜,580,み,2019/8/23 16:35,2-1_all_corrected,72,57,336,257,408,314
195032,30110_20190823184632.jpg,イオン金沢八景,*310,横浜,371,み,2019/8/23 18:46,2-1_all_corrected,71,59,189,182,260,241
194548,30111_20190823174206.jpg,イオン稲毛,**81,千葉,339,と,2019/8/23 17:41,2-1_all_corrected,54,43,381,121,435,164
195207,30169_20190823192618.jpg,イオン相模原ショッピングセンター,2706,相模,480,く,2019/8/23 19:25,2-1_all_corrected,47,38,55,52,102,90
194321,30110_20190823165244.jpg,イオン金沢八景,1231,横浜,541,ぬ,2019/8/23 16:34,2-1_all_corrected,56,46,424,118,480,164
194745,30110_20190823180258.jpg,イオン金沢八景,*134,とちぎ,331,ふ,2019/8/23 18:02,2-1_all_corrected,74,62,176,205,250,267
193752,30144_20190823132635.jpg,イオン幕張,*214,千葉,341,す,2019/8/23 13:26,2-1_all_corrected,55,38,209,109,264,147
194328,30144_20190823165404.jpg,イオン幕張,4419,習志野,501,な,2019/8/23 16:53,2-1_all_corrected,93,65,246,361,339,426
194787,30110_20190823180608.jpg,イオン金沢八景,7027,横浜,504,す,2019/8/23 18:05,2-1_all_corrected,51,42,249,186,300,228
194541,30110_20190823174010.jpg,イオン金沢八景,1822,横浜,304,の,2019/8/23 17:39,2-1_all_corrected,75,60,209,159,284,219
194317,30110_20190823165225.jpg,イオン金沢八景,8899,横浜,303,て,2019/8/23 16:33,2-1_all_corrected,65,58,410,100,475,158
194579,30110_20190823174936.jpg,イオン金沢八景,*824,横浜,538,む,2019/8/23 17:49,2-1_all_corrected,56,42,361,105,417,147
194310,30110_20190823165103.jpg,イオン金沢八景,6080,横浜,505,そ,2019/8/23 16:32,2-1_all_corrected,73,56,280,182,353,238
193909,30111_20190823143105.jpg,イオン稲毛,2388,愛媛,300,み,2019/8/23 14:30,2-1_all_corrected,55,43,208,138,263,181
195460,30169_20190823205724.jpg,イオン相模原ショッピングセンター,9009,相模,531,と,2019/8/23 20:56,2-1_all_corrected,69,70,517,301,586,371
194780,30110_20190823180543.jpg,イオン金沢八景,9247,川崎,300,み,2019/8/23 18:05,2-1_all_corrected,78,67,56,259,134,326
193955,30085_20190823150051.jpg,業務スーパー南津守,8888,なにわ,30,ち,2019/8/23 15:00,2-1_all_corrected,52,39,247,204,299,243
194374,30169_20190823170304.jpg,イオン相模原ショッピングセンター,7747,相模,580,の,2019/8/23 17:02,2-1_all_corrected,69,56,148,143,217,199
193535,30144_20190823115255.jpg,イオン幕張,*881,千葉,530,ま,2019/8/23 11:52,2-1_all_corrected,58,37,223,187,281,224
194522,30110_20190823173528.jpg,イオン金沢八景,9077,横浜,504,な,2019/8/23 17:35,2-1_all_corrected,69,53,237,162,306,215
194380,30110_20190823170418.jpg,イオン金沢八景,*839,横浜,304,む,2019/8/23 16:45,2-1_all_corrected,70,63,198,237,268,300
193952,30111_20190823145845.jpg,イオン稲毛,1028,千葉,586,て,2019/8/23 14:58,2-1_all_corrected,55,43,311,149,366,192
194945,30167_20190823182531.jpg,イオン東雲店,4704,足立,481,り,2019/8/23 18:25,2-1_all_corrected,36,29,70,42,106,71
194514,30110_20190823173328.jpg,イオン金沢八景,6802,横浜,504,ま,2019/8/23 17:33,2-1_all_corrected,67,54,304,162,371,216
194342,30110_20190823165529.jpg,イオン金沢八景,2813,横浜,504,も,2019/8/23 16:37,2-1_all_corrected,74,60,404,161,478,221
195600,30111_20190823220949.jpg,イオン稲毛,9776,千葉,580,む,2019/8/23 22:09,2-1_all_corrected,54,43,159,151,213,194
194389,30110_20190823170730.jpg,イオン金沢八景,5556,横浜,331,ふ,2019/8/23 16:49,2-1_all_corrected,67,54,386,112,453,166
194987,30111_20190823183442.jpg,イオン稲毛,1030,千葉,344,さ,2019/8/23 18:33,2-1_all_corrected,49,36,378,75,427,111
195051,30110_20190823184927.jpg,イオン金沢八景,6473,横浜,505,と,2019/8/23 18:49,2-1_all_corrected,68,53,215,160,283,213
194183,30060_20190823160554.jpg,関西スーパー小野原,*562,大分,-1,み,2019/8/23 16:05,2-1_all_corrected,43,45,375,334,418,379
195297,30169_20190823195338.jpg,イオン相模原ショッピングセンター,*456,多摩,530,る,2019/8/23 19:53,2-1_all_corrected,68,54,263,168,331,222
194345,30110_20190823165618.jpg,イオン金沢八景,1512,横浜,504,に,2019/8/23 16:38,2-1_all_corrected,72,60,320,151,392,211
193352,30167_20190823105120.jpg,イオン東雲店,6718,品川,500,ぬ,2019/8/23 10:50,2-1_all_corrected,41,40,23,0,64,40
193399,30046_20190823111006.jpg,マミーマート船橋日大[地上],*258,千葉,400,と,2019/8/23 11:09,2-1_all_corrected,42,29,203,75,245,104
194148,30167_20190823155402.jpg,イオン東雲店,7411,足立,230,さ,2019/8/23 15:53,2-1_all_corrected,54,43,351,320,405,363
193963,30169_20190823150216.jpg,イオン相模原ショッピングセンター,2677,相模,501,み,2019/8/23 15:01,2-1_all_corrected,67,58,211,166,278,224
194578,30110_20190823174931.jpg,イオン金沢八景,6775,袖ヶ浦,300,や,2019/8/23 17:49,2-1_all_corrected,55,45,384,192,439,237
194311,30110_20190823165109.jpg,イオン金沢八景,*426,横浜,581,う,2019/8/23 16:32,2-1_all_corrected,46,36,451,58,497,94
193134,30111_20190823100114.jpg,イオン稲毛,3113,千葉,50,ゆ,2019/8/23 10:00,2-1_all_corrected,70,60,233,169,303,229
194549,30110_20190823174242.jpg,イオン金沢八景,3841,横浜,330,も,2019/8/23 17:42,2-1_all_corrected,56,48,232,145,288,193
194911,30110_20190823182237.jpg,イオン金沢八景,1416,沖縄,581,さ,2019/8/23 18:22,2-1_all_corrected,55,45,233,200,288,245
193798,30169_20190823133834.jpg,イオン相模原ショッピングセンター,8424,相模,301,て,2019/8/23 13:38,2-1_all_corrected,71,51,208,141,279,192
195033,30110_20190823184640.jpg,イオン金沢八景,*500,横浜,361,ら,2019/8/23 18:46,2-1_all_corrected,55,42,367,78,422,120
194327,30110_20190823165352.jpg,イオン金沢八景,6364,横浜,505,さ,2019/8/23 16:35,2-1_all_corrected,79,68,82,286,161,354
191844,30144_20190822175016.jpg,イオン幕張,3355,千葉,534,ほ,2019/8/22 17:49,2-1_all_corrected,59,42,153,170,212,212
191611,30091_20190822155845.jpg,イトーヨーカドー木場 立体,1103,足立,355,の,2019/8/22 15:58,2-1_all_corrected,71,59,316,93,387,152
192403,30046_20190822204533.jpg,マミーマート船橋日大[地上],3441,習志野,301,な,2019/8/22 20:45,2-1_all_corrected,73,54,372,166,445,220
191875,30043_20190822175911.jpg,ファインシティ東松戸,***5,野田,335,は,2019/8/22 17:58,2-1_all_corrected,43,32,360,167,403,199
191217,30157_20190822144828.jpg,関西スーパー中央,**10,神戸,31,な,2019/8/22 14:47,2-1_all_corrected,57,43,136,162,193,205
191826,30060_20190822174330.jpg,関西スーパー小野原,*136,大阪,584,も,2019/8/22 17:43,2-1_all_corrected,56,77,74,136,130,213
190560,30169_20190822100257.jpg,イオン相模原ショッピングセンター,5423,横浜,581,え,2019/8/22 10:02,2-1_all_corrected,94,80,447,357,541,437
191821,30078_20190822174052.jpg,イオンスタイル仙台卸町店,8139,仙台,580,ち,2019/8/22 17:40,2-1_all_corrected,72,55,243,114,315,169
190556,30078_20190822095631.jpg,イオンスタイル仙台卸町店,1355,仙台,330,つ,2019/8/22 9:56,2-1_all_corrected,93,77,140,335,233,412
192206,30169_20190822193450.jpg,イオン相模原ショッピングセンター,**14,相模,584,て,2019/8/22 19:34,2-1_all_corrected,89,65,156,198,245,263
191873,30111_20190822175849.jpg,イオン稲毛,*312,千葉,542,さ,2019/8/22 17:57,2-1_all_corrected,57,41,357,140,414,181
192050,30144_20190822184903.jpg,イオン幕張,5077,千葉,503,て,2019/8/22 18:48,2-1_all_corrected,90,64,344,370,434,434
191842,30111_20190822174916.jpg,イオン稲毛,8016,千葉,330,ぬ,2019/8/22 17:48,2-1_all_corrected,57,43,366,151,423,194
190796,30157_20190822113957.jpg,関西スーパー中央,1010,神戸,31,の,2019/8/22 11:39,2-1_all_corrected,64,57,166,349,230,406
190937,30144_20190822124806.jpg,イオン幕張,4363,千葉,581,う,2019/8/22 12:47,2-1_all_corrected,50,33,215,89,265,122
191643,30144_20190822161332.jpg,イオン幕張,6421,千葉,302,そ,2019/8/22 16:13,2-1_all_corrected,52,38,229,109,281,147
191816,30078_20190822174016.jpg,イオンスタイル仙台卸町店,2677,徳島,504,た,2019/8/22 17:39,2-1_all_corrected,66,60,166,98,232,158
191675,30167_20190822162955.jpg,イオン東雲店,7409,横浜,400,ま,2019/8/22 16:29,2-1_all_corrected,98,69,123,366,221,435
191700,30110_20190822164600.jpg,イオン金沢八景,*787,横浜,536,む,2019/8/22 16:45,2-1_all_corrected,46,37,340,104,386,141
192343,30111_20190822202243.jpg,イオン稲毛,8997,成田,530,さ,2019/8/22 20:22,2-1_all_corrected,71,59,294,227,365,286
192182,30111_20190822193037.jpg,イオン稲毛,8694,千葉,330,す,2019/8/22 19:30,2-1_all_corrected,49,40,173,125,222,165
191990,30169_20190822183338.jpg,イオン相模原ショッピングセンター,*518,相模,580,た,2019/8/22 18:33,2-1_all_corrected,94,76,325,352,419,428
192140,30046_20190822191708.jpg,マミーマート船橋日大[地上],*812,習志野,531,ひ,2019/8/22 19:16,2-1_all_corrected,82,68,464,365,546,433
190425,30072_20190822081136.jpg,関西スーパー京阪大和田１F,1568,大阪,130,あ,2019/8/22 8:11,2-1_all_corrected,64,62,225,143,289,205
191963,30078_20190822182614.jpg,イオンスタイル仙台卸町店,8081,仙台,580,ひ,2019/8/22 18:25,2-1_all_corrected,71,59,199,115,270,174
191937,30111_20190822182016.jpg,イオン稲毛,*808,千葉,343,ら,2019/8/22 18:19,2-1_all_corrected,54,42,375,98,429,140
191791,30144_20190822173234.jpg,イオン幕張,6950,千葉,530,た,2019/8/22 17:32,2-1_all_corrected,88,57,390,389,478,446
191906,30072_20190822181139.jpg,関西スーパー京阪大和田１F,2217,大阪,581,は,2019/8/22 18:11,2-1_all_corrected,44,31,282,80,326,111
191566,30078_20190822154011.jpg,イオンスタイル仙台卸町店,2100,宮城,580,ね,2019/8/22 15:39,2-1_all_corrected,78,58,254,197,332,255
192146,30103_20190822191950.jpg,八尾老原１丁目,**33,和泉,31,む,2019/8/22 19:19,2-1_all_corrected,89,63,303,270,392,333
192342,30098_20190822202216.jpg,BRANCH仙台（東棟）,*211,仙台,333,ぬ,2019/8/22 20:21,2-1_all_corrected,103,73,213,322,316,395
192184,30072_20190822193104.jpg,関西スーパー京阪大和田１F,2140,大阪,581,す,2019/8/22 19:30,2-1_all_corrected,74,53,254,143,328,196
191755,30111_20190822171707.jpg,イオン稲毛,1033,千葉,332,つ,2019/8/22 17:16,2-1_all_corrected,55,42,201,148,256,190
190826,30167_20190822115404.jpg,イオン東雲店,4704,足立,481,り,2019/8/22 11:53,2-1_all_corrected,68,63,184,249,252,312
192123,30111_20190822191117.jpg,イオン稲毛,1107,千葉,548,む,2019/8/22 19:10,2-1_all_corrected,55,41,382,114,437,155
192311,30167_20190822201212.jpg,イオン東雲店,*224,長崎,331,ぬ,2019/8/22 20:11,2-1_all_corrected,69,55,389,356,458,411
191132,30144_20190822140546.jpg,イオン幕張,1188,千葉,569,と,2019/8/22 14:05,2-1_all_corrected,56,42,118,149,174,191
190828,30001_20190822115435.jpg,関西スーパー高石駅前,7268,広島,580,も,2019/8/22 11:54,2-1_all_corrected,99,82,200,308,299,390
191763,30090_20190822171931.jpg,イトーヨーカドー木場 西棟,5028,足立,583,あ,2019/8/22 17:19,2-1_all_corrected,52,36,249,180,301,216
191574,30072_20190822154252.jpg,関西スーパー京阪大和田１F,2239,大阪,583,こ,2019/8/22 15:41,2-1_all_corrected,86,67,58,172,144,239
192137,30169_20190822191657.jpg,イオン相模原ショッピングセンター,8118,多摩,346,な,2019/8/22 19:16,2-1_all_corrected,82,76,425,329,507,405
191748,30111_20190822171405.jpg,イオン稲毛,3605,袖ヶ浦,100,さ,2019/8/22 17:13,2-1_all_corrected,67,56,271,160,338,216
191347,30045_20190822150350.jpg,マックスバリュー徳川明倫,**77,名古屋,31,ほ,2019/8/22 15:03,2-1_all_corrected,68,60,182,173,250,233
191143,30167_20190822141001.jpg,イオン東雲店,7268,品川,800,せ,2019/8/22 14:09,2-1_all_corrected,88,66,158,340,246,406
191782,30111_20190822172730.jpg,イオン稲毛,1018,千葉,546,そ,2019/8/22 17:26,2-1_all_corrected,54,45,219,146,273,191
192107,30111_20190822190405.jpg,イオン稲毛,8686,千葉,334,わ,2019/8/22 19:03,2-1_all_corrected,54,42,174,128,228,170
191924,30078_20190822181712.jpg,イオンスタイル仙台卸町店,*621,豊田,930,も,2019/8/22 18:16,2-1_all_corrected,54,47,349,107,403,154
191771,30167_20190822172102.jpg,イオン東雲店,**21,大宮,431,て,2019/8/22 17:20,2-1_all_corrected,70,54,246,209,316,263
191778,30144_20190822172515.jpg,イオン幕張,*777,千葉,342,ぬ,2019/8/22 17:24,2-1_all_corrected,68,49,274,208,342,257
191740,30111_20190822171127.jpg,イオン稲毛,9350,多摩,302,ら,2019/8/22 17:10,2-1_all_corrected,69,53,211,165,280,218
190632,30072_20190822103748.jpg,関西スーパー京阪大和田１F,*563,京都,800,せ,2019/8/22 10:37,2-1_all_corrected,60,58,0,214,60,272
192162,30111_20190822192435.jpg,イオン稲毛,1016,千葉,540,と,2019/8/22 19:23,2-1_all_corrected,49,35,396,85,445,120
191187,30110_20190822143808.jpg,イオン金沢八景,4558,横浜,503,む,2019/8/22 14:37,2-1_all_corrected,43,30,380,70,423,100
190603,30167_20190822102859.jpg,イオン東雲店,8747,足立,502,つ,2019/8/22 10:28,2-1_all_corrected,52,40,298,132,350,172
192392,30147_20190822204151.jpg,三井のリパーク 厚木文化会館,2388,相模,-1,め,2019/8/22 20:41,2-1_all_corrected,41,67,116,267,157,334
191802,30168_20190822173509.jpg,イオン東雲店（屋上）,3295,足立,480,え,2019/8/22 17:34,2-1_all_corrected,46,34,192,105,238,139
191465,30136_20190822152333.jpg,イオンスタイル新百合ヶ丘,1103,川崎,340,ぬ,2019/8/22 15:22,2-1_all_corrected,94,56,102,393,196,449
191834,30078_20190822174649.jpg,イオンスタイル仙台卸町店,1921,仙台,530,た,2019/8/22 17:46,2-1_all_corrected,73,57,288,170,361,227
191856,30144_20190822175237.jpg,イオン幕張,4126,千葉,332,ぬ,2019/8/22 17:52,2-1_all_corrected,78,50,161,229,239,279
191851,30169_20190822175133.jpg,イオン相模原ショッピングセンター,4361,多摩,77,ま,2019/8/22 17:50,2-1_all_corrected,57,41,182,140,239,181
191693,30144_20190822164138.jpg,イオン幕張,6917,習志野,502,す,2019/8/22 16:41,2-1_all_corrected,65,43,162,165,227,208
191651,30060_20190822161758.jpg,関西スーパー小野原,3406,大阪,480,な,2019/8/22 16:17,2-1_all_corrected,76,62,404,325,480,387
190783,30111_20190822113137.jpg,イオン稲毛,3929,千葉,500,さ,2019/8/22 11:31,2-1_all_corrected,41,34,65,82,106,116
191007,30060_20190822131215.jpg,関西スーパー小野原,7223,大阪,480,に,2019/8/22 13:11,2-1_all_corrected,77,64,335,320,412,384
190949,30157_20190822125423.jpg,関西スーパー中央,1010,神戸,31,ね,2019/8/22 12:54,2-1_all_corrected,51,41,164,219,215,260
190516,30139_20190822092440.jpg,イオン板橋ショッピングセンター,2254,品川,35,す,2019/8/22 9:24,2-1_all_corrected,50,38,213,158,263,196
192073,30110_20190822185558.jpg,イオン金沢八景,*612,つくば,333,け,2019/8/22 18:55,2-1_all_corrected,71,55,351,190,422,245
192087,30169_20190822185849.jpg,イオン相模原ショッピングセンター,*318,横浜,358,み,2019/8/22 18:58,2-1_all_corrected,83,62,317,233,400,295
190978,30144_20190822130142.jpg,イオン幕張,*310,千葉,552,に,2019/8/22 13:01,2-1_all_corrected,44,33,280,99,324,132
191062,30091_20190822133945.jpg,イトーヨーカドー木場 立体,***5,多摩,30,む,2019/8/22 13:39,2-1_all_corrected,40,34,264,31,304,65
191861,30090_20190822175401.jpg,イトーヨーカドー木場 西棟,**17,足立,345,け,2019/8/22 17:53,2-1_all_corrected,71,53,142,228,213,281
191065,30078_20190822134126.jpg,イオンスタイル仙台卸町店,1036,仙台,580,も,2019/8/22 13:41,2-1_all_corrected,55,48,346,106,401,154
191670,30144_20190822162633.jpg,イオン幕張,2741,千葉,302,ぬ,2019/8/22 16:26,2-1_all_corrected,49,36,228,95,277,131
192001,30144_20190822183805.jpg,イオン幕張,1987,千葉,530,に,2019/8/22 18:37,2-1_all_corrected,55,44,289,179,344,223
190769,30168_20190822112746.jpg,イオン東雲店（屋上）,2163,八王子,100,わ,2019/8/22 11:27,2-1_all_corrected,87,70,427,273,514,343
191646,30168_20190822161607.jpg,イオン東雲店（屋上）,9432,足立,502,せ,2019/8/22 16:15,2-1_all_corrected,86,67,380,204,466,271
191679,30090_20190822163152.jpg,イトーヨーカドー木場 西棟,***9,練馬,537,は,2019/8/22 16:31,2-1_all_corrected,56,40,301,164,357,204
190935,30090_20190822124728.jpg,イトーヨーカドー木場 西棟,1729,足立,500,え,2019/8/22 12:47,2-1_all_corrected,77,59,151,323,228,382
190767,30045_20190822112640.jpg,マックスバリュー徳川明倫,*358,名古屋,32,と,2019/8/22 11:26,2-1_all_corrected,56,42,308,186,364,228
190501,30006_20190822091120.jpg,スギ薬局南千里,1188,大阪,565,と,2019/8/22 9:11,2-1_all_corrected,131,113,44,87,175,200
190961,30169_20190822125816.jpg,イオン相模原ショッピングセンター,1010,多摩,355,て,2019/8/22 12:57,2-1_all_corrected,43,35,294,116,337,151
192407,30169_20190822204709.jpg,イオン相模原ショッピングセンター,3311,相模,331,は,2019/8/22 20:46,2-1_all_corrected,100,81,130,249,230,330
190506,30111_20190822091517.jpg,イオン稲毛,1020,千葉,588,え,2019/8/22 9:14,2-1_all_corrected,70,58,273,166,343,224
191871,30111_20190822175740.jpg,イオン稲毛,1099,千葉,530,な,2019/8/22 17:56,2-1_all_corrected,73,53,358,165,431,218
192267,30072_20190822195827.jpg,関西スーパー京阪大和田１F,8877,大阪,333,ゆ,2019/8/22 19:58,2-1_all_corrected,91,77,121,244,212,321
191086,30039_20190822135044.jpg,イトーヨーカドー大井町,2437,品川,450,き,2019/8/22 13:50,2-1_all_corrected,61,41,262,221,323,262
190968,30167_20190822130011.jpg,イオン東雲店,7411,足立,230,さ,2019/8/22 12:59,2-1_all_corrected,71,55,391,388,462,443
192455,30167_20190822211141.jpg,イオン東雲店,*211,なにわ,533,ち,2019/8/22 21:11,2-1_all_corrected,90,59,7,391,97,450
191029,30167_20190822132250.jpg,イオン東雲店,**27,品川,374,や,2019/8/22 13:22,2-1_all_corrected,75,68,92,285,167,353
191815,30078_20190822174011.jpg,イオンスタイル仙台卸町店,2677,福島,501,た,2019/8/22 17:39,2-1_all_corrected,64,59,168,74,232,133
190933,30143_20190822124701.jpg,イオン久里浜,*916,横浜,343,ろ,2019/8/22 12:46,2-1_all_corrected,54,38,409,199,463,237
190795,30062_20190822113926.jpg,ミスミモール,**33,神戸,31,ぬ,2019/8/22 11:38,2-1_all_corrected,65,62,92,232,157,294
190598,30060_20190822102759.jpg,関西スーパー小野原,7372,なにわ,580,け,2019/8/22 10:27,2-1_all_corrected,85,79,476,267,561,346
190757,30169_20190822112318.jpg,イオン相模原ショッピングセンター,6401,相模,580,め,2019/8/22 11:22,2-1_all_corrected,86,72,149,99,235,171
191018,30157_20190822131704.jpg,関西スーパー中央,4635,神戸,504,つ,2019/8/22 13:16,2-1_all_corrected,52,41,88,362,140,403
190750,30078_20190822112227.jpg,イオンスタイル仙台卸町店,*707,仙台,532,め,2019/8/22 11:22,2-1_all_corrected,84,64,175,210,259,274
191649,30144_20190822161632.jpg,イオン幕張,1628,習志野,330,み,2019/8/22 16:16,2-1_all_corrected,45,33,145,57,190,90
191848,30167_20190822175122.jpg,イオン東雲店,7411,足立,230,さ,2019/8/22 17:50,2-1_all_corrected,77,55,334,369,411,424
191074,30078_20190822134345.jpg,イオンスタイル仙台卸町店,1002,仙台,583,を,2019/8/22 13:43,2-1_all_corrected,77,55,189,161,266,216
192261,30111_20190822195545.jpg,イオン稲毛,2980,千葉,330,ろ,2019/8/22 19:54,2-1_all_corrected,54,45,184,131,238,176
191625,30091_20190822160309.jpg,イトーヨーカドー木場 立体,***2,品川,30,ち,2019/8/22 16:02,2-1_all_corrected,73,52,211,216,284,268
192257,30167_20190822195418.jpg,イオン東雲店,4482,習志野,480,れ,2019/8/22 19:53,2-1_all_corrected,53,44,290,189,343,233
191761,30072_20190822171811.jpg,関西スーパー京阪大和田１F,5171,大阪,400,ほ,2019/8/22 17:17,2-1_all_corrected,73,59,2,160,75,219
192313,30167_20190822201232.jpg,イオン東雲店,*673,春日部,880,り,2019/8/22 20:12,2-1_all_corrected,47,44,107,205,154,249
191360,30157_20190822150751.jpg,関西スーパー中央,**10,神戸,31,な,2019/8/22 15:07,2-1_all_corrected,53,38,248,376,301,414
191152,30167_20190822141441.jpg,イオン東雲店,7411,足立,230,さ,2019/8/22 14:14,2-1_all_corrected,53,39,281,290,334,329
191956,30111_20190822182504.jpg,イオン稲毛,*363,千葉,530,ゆ,2019/8/22 18:24,2-1_all_corrected,69,53,291,148,360,201
191969,30046_20190822182915.jpg,マミーマート船橋日大[地上],5944,習志野,502,す,2019/8/22 18:28,2-1_all_corrected,36,30,138,43,174,73
192516,30169_20190822214318.jpg,イオン相模原ショッピングセンター,8668,多摩,331,て,2019/8/22 21:42,2-1_all_corrected,83,67,324,262,407,329
191393,30045_20190822151421.jpg,マックスバリュー徳川明倫,*358,名古屋,32,と,2019/8/22 15:13,2-1_all_corrected,74,55,208,194,282,249
190846,30167_20190822120505.jpg,イオン東雲店,1500,品川,300,こ,2019/8/22 12:04,2-1_all_corrected,84,55,22,394,106,449
192144,30110_20190822191918.jpg,イオン金沢八景,5252,横浜,331,ら,2019/8/22 19:18,2-1_all_corrected,56,45,465,137,521,182
190879,30085_20190822122212.jpg,業務スーパー南津守,1001,なにわ,31,み,2019/8/22 12:21,2-1_all_corrected,50,40,335,209,385,249
192188,30046_20190822193155.jpg,マミーマート船橋日大[地上],1101,習志野,554,に,2019/8/22 19:31,2-1_all_corrected,40,29,178,82,218,111
191732,30072_20190822170654.jpg,関西スーパー京阪大和田１F,**97,大阪,581,み,2019/8/22 17:06,2-1_all_corrected,48,39,144,72,192,111
191597,30090_20190822155159.jpg,イトーヨーカドー木場 西棟,6376,足立,302,な,2019/8/22 15:51,2-1_all_corrected,84,63,174,302,258,365
192118,30111_20190822190844.jpg,イオン稲毛,1000,千葉,384,れ,2019/8/22 19:08,2-1_all_corrected,35,29,451,35,486,64
190825,30167_20190822115311.jpg,イオン東雲店,4704,足立,481,り,2019/8/22 11:52,2-1_all_corrected,35,32,43,55,78,87
190480,30072_20190822085601.jpg,関西スーパー京阪大和田１F,2404,神戸,100,す,2019/8/22 8:55,2-1_all_corrected,55,44,61,208,116,252
191131,30144_20190822140540.jpg,イオン幕張,6374,千葉,581,て,2019/8/22 14:05,2-1_all_corrected,58,39,141,173,199,212
191758,30111_20190822171722.jpg,イオン稲毛,9650,千葉,502,み,2019/8/22 17:16,2-1_all_corrected,51,38,204,142,255,180
191191,30110_20190822144002.jpg,イオン金沢八景,2348,横浜,505,た,2019/8/22 14:39,2-1_all_corrected,49,40,394,91,443,131
190871,30072_20190822121718.jpg,関西スーパー京阪大和田１F,4444,大阪,373,す,2019/8/22 12:16,2-1_all_corrected,83,65,7,160,90,225
191957,30144_20190822182509.jpg,イオン幕張,*303,千葉,540,ひ,2019/8/22 18:24,2-1_all_corrected,89,64,295,312,384,376
191950,30144_20190822182325.jpg,イオン幕張,1326,習志野,330,や,2019/8/22 18:23,2-1_all_corrected,86,61,253,317,339,378
191705,30167_20190822164824.jpg,イオン東雲店,7411,足立,230,さ,2019/8/22 16:48,2-1_all_corrected,59,43,323,336,382,379
192169,30046_20190822192707.jpg,マミーマート船橋日大[地上],1236,習志野,531,の,2019/8/22 19:26,2-1_all_corrected,36,27,173,47,209,74
192151,30110_20190822192041.jpg,イオン金沢八景,*894,横浜,77,と,2019/8/22 19:20,2-1_all_corrected,67,52,323,149,390,201
191975,30110_20190822183106.jpg,イオン金沢八景,2268,横浜,930,ほ,2019/8/22 18:30,2-1_all_corrected,56,42,337,58,393,100
191729,30168_20190822170458.jpg,イオン東雲店（屋上）,***2,足立,1,き,2019/8/22 17:04,2-1_all_corrected,35,25,127,26,162,51
192134,30138_20190822191602.jpg,イオンスタイル湘南茅ヶ崎,2402,湘南,502,と,2019/8/22 19:15,2-1_all_corrected,56,45,234,109,290,154
191789,30144_20190822172953.jpg,イオン幕張,*220,足立,341,ほ,2019/8/22 17:29,2-1_all_corrected,80,57,345,297,425,354
190699,30169_20190822105839.jpg,イオン相模原ショッピングセンター,*457,湘南,800,は,2019/8/22 10:58,2-1_all_corrected,78,86,475,187,553,273
191921,30144_20190822181633.jpg,イオン幕張,*110,千葉,350,さ,2019/8/22 18:16,2-1_all_corrected,71,49,193,191,264,240
191774,30110_20190822172356.jpg,イオン金沢八景,6083,横浜,581,い,2019/8/22 17:23,2-1_all_corrected,72,53,273,250,345,303
191328,30144_20190822145955.jpg,イオン幕張,*921,千葉,336,な,2019/8/22 14:59,2-1_all_corrected,54,40,137,102,191,142
191125,30167_20190822140445.jpg,イオン東雲店,8009,足立,480,れ,2019/8/22 14:04,2-1_all_corrected,77,63,56,350,133,413
191945,30144_20190822182255.jpg,イオン幕張,8823,習志野,501,て,2019/8/22 18:22,2-1_all_corrected,43,38,253,142,296,180
191942,30110_20190822182220.jpg,イオン金沢八景,***1,横浜,307,せ,2019/8/22 18:21,2-1_all_corrected,38,32,451,56,489,88
190801,30106_20190822114311.jpg,ジョーシン東大阪長田,8008,京都,31,に,2019/8/22 11:42,2-1_all_corrected,62,44,163,174,225,218
192558,30169_20190822223203.jpg,イオン相模原ショッピングセンター,**77,相模,131,た,2019/8/22 22:31,2-1_all_corrected,102,75,279,357,381,432
191123,30167_20190822140424.jpg,イオン東雲店,4482,習志野,480,れ,2019/8/22 14:03,2-1_all_corrected,91,73,193,313,284,386
191775,30169_20190822172424.jpg,イオン相模原ショッピングセンター,9599,多摩,580,て,2019/8/22 17:23,2-1_all_corrected,72,57,131,134,203,191
191929,30111_20190822181814.jpg,イオン稲毛,*111,千葉,339,の,2019/8/22 18:17,2-1_all_corrected,56,48,347,130,403,178
192556,30078_20190822223019.jpg,イオンスタイル仙台卸町店,1113,宮城,336,ち,2019/8/22 22:29,2-1_all_corrected,85,64,201,208,286,272
191582,30060_20190822154448.jpg,関西スーパー小野原,8888,大阪,396,さ,2019/8/22 15:44,2-1_all_corrected,37,36,467,7,504,43
192135,30078_20190822191614.jpg,イオンスタイル仙台卸町店,***1,宮城,524,ひ,2019/8/22 19:15,2-1_all_corrected,95,59,329,383,424,442
191864,30078_20190822175516.jpg,イオンスタイル仙台卸町店,8681,仙台,580,も,2019/8/22 17:54,2-1_all_corrected,75,51,241,116,316,167
191056,30062_20190822133544.jpg,ミスミモール,***3,神戸,30,ふ,2019/8/22 13:35,2-1_all_corrected,77,58,221,215,298,273
191801,30144_20190822173502.jpg,イオン幕張,7606,習志野,501,も,2019/8/22 17:34,2-1_all_corrected,76,52,302,219,378,271
191002,30111_20190822131129.jpg,イオン稲毛,***5,千葉,30,そ,2019/8/22 13:10,2-1_all_corrected,55,41,310,185,365,226
190540,30167_20190822094335.jpg,イオン東雲店,1207,川口,310,ふ,2019/8/22 9:43,2-1_all_corrected,90,60,63,390,153,450
191698,30144_20190822164350.jpg,イオン幕張,8822,習志野,530,て,2019/8/22 16:43,2-1_all_corrected,81,58,315,301,396,359
191468,30144_20190822152340.jpg,イオン幕張,2213,千葉,531,ゆ,2019/8/22 15:23,2-1_all_corrected,59,42,217,141,276,183
190571,30062_20190822100756.jpg,ミスミモール,8888,神戸,30,さ,2019/8/22 10:07,2-1_all_corrected,73,58,235,186,308,244
191033,30144_20190822132525.jpg,イオン幕張,*560,千葉,331,も,2019/8/22 13:25,2-1_all_corrected,71,53,268,231,339,284
191837,30078_20190822174742.jpg,イオンスタイル仙台卸町店,8385,仙台,500,は,2019/8/22 17:47,2-1_all_corrected,81,65,138,217,219,282
191206,30110_20190822144313.jpg,イオン金沢八景,1737,横浜,502,ひ,2019/8/22 14:42,2-1_all_corrected,54,42,278,79,332,121
192013,30144_20190822184027.jpg,イオン幕張,6648,千葉,300,ら,2019/8/22 18:39,2-1_all_corrected,91,68,335,348,426,416
190981,30111_20190822130238.jpg,イオン稲毛,5369,千葉,302,ぬ,2019/8/22 13:01,2-1_all_corrected,81,59,277,231,358,290
190975,30106_20190822130112.jpg,ジョーシン東大阪長田,8008,京都,31,に,2019/8/22 13:00,2-1_all_corrected,71,55,304,256,375,311
190413,30072_20190822080116.jpg,関西スーパー京阪大和田１F,8686,和泉,400,た,2019/8/22 8:00,2-1_all_corrected,91,73,143,248,234,321
192079,30052_20190822185736.jpg,西友市ヶ尾,***3,横浜,30,む,2019/8/22 18:57,2-1_all_corrected,93,78,84,355,177,433
190583,30144_20190822101851.jpg,イオン幕張,3199,千葉,580,み,2019/8/22 10:18,2-1_all_corrected,50,34,191,102,241,136
191690,30072_20190822164005.jpg,関西スーパー京阪大和田１F,1518,大阪,336,さ,2019/8/22 16:39,2-1_all_corrected,89,65,62,385,151,450
190579,30167_20190822101705.jpg,イオン東雲店,5074,品川,580,き,2019/8/22 10:16,2-1_all_corrected,92,58,89,392,181,450
199443,30120_20190825134351.jpg,イオン長浦（第１・第２）,**69,袖ヶ浦,532,り,2019/8/25 13:43,2-1_all_corrected,52,46,203,268,255,314
199685,30110_20190825150640.jpg,イオン金沢八景,**10,横浜,319,の,2019/8/25 15:06,2-1_all_corrected,48,43,29,147,77,190
200275,30063_20190825173746.jpg,コーナン相模原小山モール,***8,練馬,30,ゆ,2019/8/25 17:37,2-1_all_corrected,50,38,270,110,320,148
200040,30169_20190825164418.jpg,イオン相模原ショッピングセンター,**55,湘南,383,る,2019/8/25 16:43,2-1_all_corrected,85,67,277,133,362,200
200082,30167_20190825165510.jpg,イオン東雲店,1114,品川,338,と,2019/8/25 16:54,2-1_all_corrected,77,62,172,224,249,286
199475,30138_20190825135543.jpg,イオンスタイル湘南茅ヶ崎,***6,湘南,540,ね,2019/8/25 13:55,2-1_all_corrected,55,40,310,197,365,237
200085,30039_20190825165543.jpg,イトーヨーカドー大井町,4814,足立,301,は,2019/8/25 16:55,2-1_all_corrected,75,65,143,201,218,266
200025,30144_20190825164008.jpg,イオン幕張,*313,習志野,341,は,2019/8/25 16:39,2-1_all_corrected,74,50,167,183,241,233
200446,30167_20190825182911.jpg,イオン東雲店,8999,足立,502,な,2019/8/25 18:28,2-1_all_corrected,42,35,391,59,433,94
200484,30168_20190825183903.jpg,イオン東雲店（屋上）,1625,足立,331,も,2019/8/25 18:38,2-1_all_corrected,76,60,318,222,394,282
200226,30052_20190825172553.jpg,西友市ヶ尾,4709,川崎,500,ひ,2019/8/25 17:25,2-1_all_corrected,72,50,342,252,414,302
200470,30167_20190825183602.jpg,イオン東雲店,1314,品川,331,ひ,2019/8/25 18:35,2-1_all_corrected,96,57,123,393,219,450
199870,30110_20190825160541.jpg,イオン金沢八景,2226,横浜,504,な,2019/8/25 16:05,2-1_all_corrected,58,43,203,176,261,219
198956,30111_20190825102826.jpg,イオン稲毛,**23,千葉,353,ふ,2019/8/25 10:27,2-1_all_corrected,55,42,357,131,412,173
200483,30144_20190825183854.jpg,イオン幕張,*217,千葉,554,も,2019/8/25 18:38,2-1_all_corrected,40,31,221,49,261,80
199087,30163_20190825111344.jpg,コープ葛飾白鳥店(地上),***8,足立,30,す,2019/8/25 11:13,2-1_all_corrected,68,56,129,165,197,221
200413,30078_20190825182224.jpg,イオンスタイル仙台卸町店,5811,仙台,580,ぬ,2019/8/25 18:21,2-1_all_corrected,69,53,284,127,353,180
200245,30144_20190825172921.jpg,イオン幕張,**88,尾張小牧,546,せ,2019/8/25 17:28,2-1_all_corrected,78,56,195,249,273,305
199028,30144_20190825105800.jpg,イオン幕張,7331,千葉,302,す,2019/8/25 10:57,2-1_all_corrected,60,42,182,132,242,174
200083,30110_20190825165511.jpg,イオン金沢八景,1212,横浜,573,た,2019/8/25 16:54,2-1_all_corrected,42,32,409,94,451,126
199445,30078_20190825134432.jpg,イオンスタイル仙台卸町店,**13,仙台,501,す,2019/8/25 13:44,2-1_all_corrected,76,54,343,264,419,318
199021,30144_20190825105644.jpg,イオン幕張,1107,習志野,480,れ,2019/8/25 10:56,2-1_all_corrected,84,65,219,345,303,410
200041,30169_20190825164424.jpg,イオン相模原ショッピングセンター,2774,相模,580,ち,2019/8/25 16:43,2-1_all_corrected,107,80,196,151,303,231
200287,30110_20190825174302.jpg,イオン金沢八景,6300,横浜,502,も,2019/8/25 17:42,2-1_all_corrected,83,71,140,253,223,324
200079,30144_20190825165458.jpg,イオン幕張,7389,千葉,503,て,2019/8/25 16:54,2-1_all_corrected,78,53,248,277,326,330
199442,30022_20190825134307.jpg,業務スーパー平野駅前,***8,大阪,30,も,2019/8/25 13:42,2-1_all_corrected,52,38,28,133,80,171
199489,30078_20190825140120.jpg,イオンスタイル仙台卸町店,1212,宮城,589,な,2019/8/25 14:00,2-1_all_corrected,56,40,262,59,318,99
199086,30163_20190825111342.jpg,コープ葛飾白鳥店(地上),***8,足立,30,す,2019/8/25 11:13,2-1_all_corrected,68,56,129,165,197,221
199072,30078_20190825110951.jpg,イオンスタイル仙台卸町店,2002,宮城,503,つ,2019/8/25 11:09,2-1_all_corrected,72,51,283,127,355,178
200015,30110_20190825163820.jpg,イオン金沢八景,6503,横浜,502,ゆ,2019/8/25 16:37,2-1_all_corrected,40,35,179,84,219,119
200820,30167_20190825193813.jpg,イオン東雲店,8648,品川,301,つ,2019/8/25 19:37,2-1_all_corrected,62,45,383,322,445,367
199615,30078_20190825144027.jpg,イオンスタイル仙台卸町店,2621,宮城,503,つ,2019/8/25 14:40,2-1_all_corrected,58,42,323,105,381,147
199285,30022_20190825122813.jpg,業務スーパー平野駅前,***5,姫路,30,や,2019/8/25 12:27,2-1_all_corrected,54,43,346,112,400,155
199878,30168_20190825160805.jpg,イオン東雲店（屋上）,6744,品川,302,つ,2019/8/25 16:07,2-1_all_corrected,74,56,372,177,446,233
199136,30167_20190825113518.jpg,イオン東雲店,*673,春日部,880,り,2019/8/25 11:34,2-1_all_corrected,43,35,264,147,307,182
199599,30110_20190825143557.jpg,イオン金沢八景,9243,横浜,503,み,2019/8/25 14:35,2-1_all_corrected,62,60,19,176,81,236
201048,30110_20190825202710.jpg,イオン金沢八景,8114,横浜,500,い,2019/8/25 20:26,2-1_all_corrected,66,58,315,179,381,237
201077,30110_20190825203551.jpg,イオン金沢八景,**29,横浜,345,み,2019/8/25 20:35,2-1_all_corrected,55,42,335,50,390,92
201245,30167_20190825224437.jpg,イオン東雲店,1418,品川,332,そ,2019/8/25 22:44,2-1_all_corrected,56,45,374,308,430,353
200160,30144_20190825171039.jpg,イオン幕張,*819,千葉,337,そ,2019/8/25 17:10,2-1_all_corrected,51,37,183,104,234,141
199957,30144_20190825162615.jpg,イオン幕張,3335,千葉,583,ち,2019/8/25 16:25,2-1_all_corrected,51,37,183,120,234,157
199366,30167_20190825130552.jpg,イオン東雲店,3837,足立,302,な,2019/8/25 13:05,2-1_all_corrected,55,44,359,304,414,348
199508,30076_20190825140636.jpg,ヤマダ電機なんば,*100,大阪,377,む,2019/8/25 14:06,2-1_all_corrected,90,69,305,204,395,273
200765,30060_20190825193201.jpg,関西スーパー小野原,1001,大阪,31,ろ,2019/8/25 19:31,2-1_all_corrected,80,60,165,233,245,293
200398,30167_20190825181927.jpg,イオン東雲店,*914,習志野,594,あ,2019/8/25 18:18,2-1_all_corrected,37,29,422,45,459,74
199101,30090_20190825112016.jpg,イトーヨーカドー木場 西棟,2107,足立,330,た,2019/8/25 11:19,2-1_all_corrected,74,52,282,249,356,301
201047,30110_20190825202633.jpg,イオン金沢八景,9345,鹿児島,580,め,2019/8/25 20:26,2-1_all_corrected,55,42,336,175,391,217
200195,30046_20190825171644.jpg,マミーマート船橋日大[地上],**38,習志野,340,そ,2019/8/25 17:16,2-1_all_corrected,53,43,277,125,330,168
199334,30111_20190825124930.jpg,イオン稲毛,2217,千葉,331,ゆ,2019/8/25 12:48,2-1_all_corrected,56,43,339,145,395,188
199554,30103_20190825142132.jpg,八尾老原１丁目,2000,大阪,331,つ,2019/8/25 14:21,2-1_all_corrected,56,43,267,182,323,225
199766,30144_20190825153141.jpg,イオン幕張,*927,千葉,536,め,2019/8/25 15:31,2-1_all_corrected,78,59,193,260,271,319
199933,30110_20190825162127.jpg,イオン金沢八景,5391,横浜,580,は,2019/8/25 16:20,2-1_all_corrected,70,55,163,240,233,295
200534,30167_20190825184639.jpg,イオン東雲店,1229,足立,334,ほ,2019/8/25 18:46,2-1_all_corrected,43,33,361,75,404,108
199598,30078_20190825143550.jpg,イオンスタイル仙台卸町店,9450,仙台,580,ぬ,2019/8/25 14:35,2-1_all_corrected,56,45,333,100,389,145
200701,30169_20190825191621.jpg,イオン相模原ショッピングセンター,5025,相模,530,の,2019/8/25 19:15,2-1_all_corrected,54,42,433,11,487,53
201085,30147_20190825203945.jpg,三井のリパーク 厚木文化会館,5370,相模,300,ろ,2019/8/25 20:39,2-1_all_corrected,86,58,273,246,359,304
199934,30144_20190825162134.jpg,イオン幕張,2344,千葉,502,む,2019/8/25 16:21,2-1_all_corrected,58,38,176,145,234,183
199994,30078_20190825163457.jpg,イオンスタイル仙台卸町店,*181,仙台,300,ま,2019/8/25 16:34,2-1_all_corrected,91,63,294,344,385,407
200593,30169_20190825190040.jpg,イオン相模原ショッピングセンター,*318,横浜,358,み,2019/8/25 19:00,2-1_all_corrected,103,77,169,345,272,422
199538,30167_20190825141606.jpg,イオン東雲店,*118,世田谷,311,み,2019/8/25 14:15,2-1_all_corrected,85,67,130,295,215,362
199369,30111_20190825130924.jpg,イオン稲毛,1001,千葉,373,ゆ,2019/8/25 13:08,2-1_all_corrected,69,53,401,236,470,289
200764,30078_20190825193124.jpg,イオンスタイル仙台卸町店,9119,仙台,530,そ,2019/8/25 19:31,2-1_all_corrected,98,65,268,350,366,415
199152,30144_20190825114011.jpg,イオン幕張,6929,千葉,530,な,2019/8/25 11:39,2-1_all_corrected,53,39,202,119,255,158
201219,30074_20190825221259.jpg,マックスバリュ北1条東,6083,札幌,100,つ,2019/8/25 22:12,2-1_all_corrected,52,44,39,178,91,222
199393,30110_20190825131839.jpg,イオン金沢八景,2210,横浜,334,そ,2019/8/25 13:18,2-1_all_corrected,55,47,92,159,147,206
201031,30169_20190825202202.jpg,イオン相模原ショッピングセンター,*123,相模,591,け,2019/8/25 20:21,2-1_all_corrected,72,55,331,45,403,100
200587,30070_20190825185828.jpg,カナートモール住道第一,**55,大阪,31,に,2019/8/25 18:57,2-1_all_corrected,84,62,168,219,252,281
199170,30169_20190825114716.jpg,イオン相模原ショッピングセンター,*283,相模,583,ゆ,2019/8/25 11:46,2-1_all_corrected,88,74,132,227,220,301
199973,30167_20190825163012.jpg,イオン東雲店,3709,足立,330,ぬ,2019/8/25 16:29,2-1_all_corrected,53,42,314,137,367,179
199380,30091_20190825131435.jpg,イトーヨーカドー木場 立体,1127,足立,537,も,2019/8/25 13:14,2-1_all_corrected,53,42,340,136,393,178
200770,30167_20190825193358.jpg,イオン東雲店,8688,足立,530,の,2019/8/25 19:33,2-1_all_corrected,50,39,374,279,424,318
200922,30078_20190825195057.jpg,イオンスタイル仙台卸町店,1080,仙台,300,ろ,2019/8/25 19:50,2-1_all_corrected,81,59,358,290,439,349
199373,30111_20190825131040.jpg,イオン稲毛,1764,千葉,330,て,2019/8/25 13:09,2-1_all_corrected,50,49,230,130,280,179
200347,30167_20190825180621.jpg,イオン東雲店,7163,足立,580,ろ,2019/8/25 18:05,2-1_all_corrected,36,28,382,68,418,96
200723,30045_20190825191848.jpg,マックスバリュー徳川明倫,1010,名古屋,31,ゆ,2019/8/25 19:18,2-1_all_corrected,76,59,117,204,193,263
199571,30144_20190825142808.jpg,イオン幕張,***7,野田,586,を,2019/8/25 14:27,2-1_all_corrected,55,40,189,194,244,234
199929,30110_20190825162109.jpg,イオン金沢八景,*108,品川,343,ろ,2019/8/25 16:20,2-1_all_corrected,94,77,70,238,164,315
200340,30144_20190825180402.jpg,イオン幕張,2012,千葉,535,る,2019/8/25 18:03,2-1_all_corrected,83,57,267,286,350,343
199329,30144_20190825124649.jpg,イオン幕張,8948,千葉,330,と,2019/8/25 12:46,2-1_all_corrected,46,31,183,55,229,86
199918,30169_20190825161757.jpg,イオン相模原ショッピングセンター,3933,横浜,302,や,2019/8/25 16:17,2-1_all_corrected,66,54,124,258,190,312
199124,30110_20190825113157.jpg,イオン金沢八景,6801,横浜,505,つ,2019/8/25 11:31,2-1_all_corrected,55,44,451,136,506,180
201065,30091_20190825203226.jpg,イトーヨーカドー木場 立体,2778,千葉,480,れ,2019/8/25 20:31,2-1_all_corrected,45,37,345,108,390,145
199988,30167_20190825163421.jpg,イオン東雲店,1212,熊本,348,す,2019/8/25 16:33,2-1_all_corrected,70,64,113,166,183,230
199729,30144_20190825151856.jpg,イオン幕張,5888,習志野,331,す,2019/8/25 15:18,2-1_all_corrected,65,42,207,174,272,216
200118,30103_20190825170157.jpg,八尾老原１丁目,***8,大阪,30,た,2019/8/25 17:01,2-1_all_corrected,69,55,232,189,301,244
199375,30168_20190825131254.jpg,イオン東雲店（屋上）,**54,練馬,333,ふ,2019/8/25 13:12,2-1_all_corrected,57,40,254,169,311,209
199178,30110_20190825114959.jpg,イオン金沢八景,7724,横浜,530,ほ,2019/8/25 11:49,2-1_all_corrected,75,60,297,205,372,265
199185,30169_20190825115319.jpg,イオン相模原ショッピングセンター,6000,相模,339,そ,2019/8/25 11:52,2-1_all_corrected,55,42,349,118,404,160
199727,30078_20190825151816.jpg,イオンスタイル仙台卸町店,*111,仙台,340,ぬ,2019/8/25 15:17,2-1_all_corrected,59,37,348,121,407,158
199388,30167_20190825131751.jpg,イオン東雲店,7197,練馬,500,う,2019/8/25 13:17,2-1_all_corrected,51,40,306,151,357,191
199512,30144_20190825140712.jpg,イオン幕張,8453,千葉,581,き,2019/8/25 14:06,2-1_all_corrected,55,41,200,134,255,175
199981,30169_20190825163230.jpg,イオン相模原ショッピングセンター,*712,群馬,586,ほ,2019/8/25 16:32,2-1_all_corrected,67,54,232,169,299,223
200383,30169_20190825181707.jpg,イオン相模原ショッピングセンター,***1,相模,803,と,2019/8/25 18:16,2-1_all_corrected,69,52,315,146,384,198
199919,30169_20190825161803.jpg,イオン相模原ショッピングセンター,9013,横浜,502,み,2019/8/25 16:17,2-1_all_corrected,46,35,313,125,359,160
199583,30085_20190825142954.jpg,業務スーパー南津守,*111,なにわ,30,そ,2019/8/25 14:29,2-1_all_corrected,51,39,372,187,423,226
199584,30167_20190825143011.jpg,イオン東雲店,4704,足立,481,り,2019/8/25 14:29,2-1_all_corrected,45,39,322,154,367,193
200496,30139_20190825184151.jpg,イオン板橋ショッピングセンター,***1,練馬,30,ね,2019/8/25 18:41,2-1_all_corrected,72,54,249,260,321,314
200491,30169_20190825184008.jpg,イオン相模原ショッピングセンター,2902,多摩,530,さ,2019/8/25 18:39,2-1_all_corrected,86,81,420,359,506,440
200453,30111_20190825183035.jpg,イオン稲毛,6808,袖ヶ浦,300,め,2019/8/25 18:29,2-1_all_corrected,50,39,135,108,185,147
198972,30060_20190825103506.jpg,関西スーパー小野原,1233,大阪,303,す,2019/8/25 10:34,2-1_all_corrected,74,62,480,205,554,267
199606,30110_20190825143857.jpg,イオン金沢八景,*346,横浜,304,ち,2019/8/25 14:38,2-1_all_corrected,42,33,403,62,445,95
200202,30110_20190825171816.jpg,イオン金沢八景,1513,横浜,531,ら,2019/8/25 17:17,2-1_all_corrected,43,36,159,144,202,180
198981,30111_20190825103828.jpg,イオン稲毛,2083,千葉,530,ぬ,2019/8/25 10:37,2-1_all_corrected,54,40,189,133,243,173
199853,30144_20190825155922.jpg,イオン幕張,*730,習志野,580,に,2019/8/25 15:58,2-1_all_corrected,77,55,253,275,330,330
200454,30072_20190825183135.jpg,関西スーパー京阪大和田１F,6712,大阪,302,も,2019/8/25 18:31,2-1_all_corrected,54,42,425,148,479,190
199209,30085_20190825120138.jpg,業務スーパー南津守,*111,なにわ,30,は,2019/8/25 12:01,2-1_all_corrected,44,32,306,170,350,202
200269,30090_20190825173604.jpg,イトーヨーカドー木場 西棟,**32,足立,343,ひ,2019/8/25 17:35,2-1_all_corrected,47,35,176,175,223,210
200407,30169_20190825182132.jpg,イオン相模原ショッピングセンター,*111,相模,590,さ,2019/8/25 18:21,2-1_all_corrected,74,59,281,120,355,179
200603,30060_20190825190322.jpg,関西スーパー小野原,3976,大阪,480,ひ,2019/8/25 19:03,2-1_all_corrected,69,66,521,360,590,426
200294,30167_20190825174442.jpg,イオン東雲店,6360,品川,302,ま,2019/8/25 17:44,2-1_all_corrected,91,57,20,393,111,450
198917,30072_20190825100811.jpg,関西スーパー京阪大和田１F,*563,京都,800,せ,2019/8/25 10:07,2-1_all_corrected,45,40,0,138,45,178
201174,30169_20190825213345.jpg,イオン相模原ショッピングセンター,2770,多摩,500,ろ,2019/8/25 21:33,2-1_all_corrected,55,41,370,126,425,167
200436,30167_20190825182809.jpg,イオン東雲店,5109,足立,330,な,2019/8/25 18:27,2-1_all_corrected,82,69,43,347,125,416
200604,30110_20190825190408.jpg,イオン金沢八景,*100,横浜,545,ほ,2019/8/25 19:03,2-1_all_corrected,65,58,485,146,550,204
199831,30111_20190825155114.jpg,イオン稲毛,4744,千葉,500,な,2019/8/25 15:48,2-1_all_corrected,85,64,241,254,326,318
200099,30144_20190825165921.jpg,イオン幕張,*529,千葉,336,せ,2019/8/25 16:58,2-1_all_corrected,82,54,156,277,238,331
199290,30072_20190825123123.jpg,関西スーパー京阪大和田１F,6548,なにわ,800,あ,2019/8/25 12:30,2-1_all_corrected,75,62,12,220,87,282
200036,30111_20190825164243.jpg,イオン稲毛,**17,千葉,364,の,2019/8/25 16:41,2-1_all_corrected,69,53,338,180,407,233
199855,30144_20190825160104.jpg,イオン幕張,*811,千葉,536,み,2019/8/25 16:00,2-1_all_corrected,63,40,149,144,212,184
200669,30111_20190825191348.jpg,イオン稲毛,8317,千葉,502,ま,2019/8/25 19:13,2-1_all_corrected,61,44,199,163,260,207
199631,30167_20190825144642.jpg,イオン東雲店,*126,千葉,337,る,2019/8/25 14:46,2-1_all_corrected,46,36,351,106,397,142
199864,30167_20190825160312.jpg,イオン東雲店,7095,品川,580,か,2019/8/25 16:02,2-1_all_corrected,95,65,53,385,148,450
200437,30057_20190825182809.jpg,ライフ東府中,*875,多摩,330,ゆ,2019/8/25 18:27,2-1_all_corrected,50,40,237,104,287,144
201181,30046_20190825213917.jpg,マミーマート船橋日大[地上],1224,習志野,585,を,2019/8/25 21:38,2-1_all_corrected,67,54,394,212,461,266
198916,30072_20190825100735.jpg,関西スーパー京阪大和田１F,*563,京都,800,せ,2019/8/25 10:07,2-1_all_corrected,66,56,144,155,210,211
200408,30167_20190825182143.jpg,イオン東雲店,**12,足立,339,ゆ,2019/8/25 18:21,2-1_all_corrected,54,44,309,116,363,160
200098,30169_20190825165907.jpg,イオン相模原ショッピングセンター,9892,川崎,300,ゆ,2019/8/25 16:58,2-1_all_corrected,79,57,327,65,406,122
200292,30078_20190825174435.jpg,イオンスタイル仙台卸町店,2303,福島,330,も,2019/8/25 17:44,2-1_all_corrected,51,35,340,101,391,136
198911,30072_20190825100423.jpg,関西スーパー京阪大和田１F,2004,大阪,581,そ,2019/8/25 10:03,2-1_all_corrected,75,60,129,237,204,297
200430,30111_20190825182648.jpg,イオン稲毛,*412,千葉,534,そ,2019/8/25 18:26,2-1_all_corrected,47,37,95,101,142,138
200602,30110_20190825190249.jpg,イオン金沢八景,9420,横浜,304,ぬ,2019/8/25 19:02,2-1_all_corrected,47,35,298,87,345,122
200406,30169_20190825182126.jpg,イオン相模原ショッピングセンター,2750,相模,580,ら,2019/8/25 18:20,2-1_all_corrected,77,63,293,97,370,160
200257,30045_20190825173208.jpg,マックスバリュー徳川明倫,*358,名古屋,32,つ,2019/8/25 17:31,2-1_all_corrected,51,39,323,117,374,156
199237,30167_20190825121206.jpg,イオン東雲店,4345,川崎,501,て,2019/8/25 12:11,2-1_all_corrected,77,59,178,245,255,304
200445,30057_20190825182855.jpg,ライフ東府中,2260,多摩,580,ゆ,2019/8/25 18:28,2-1_all_corrected,52,41,350,190,402,231
199845,30110_20190825155720.jpg,イオン金沢八景,*753,横浜,347,ひ,2019/8/25 15:56,2-1_all_corrected,83,69,198,183,281,252
199422,30144_20190825133429.jpg,イオン幕張,2410,千葉,331,に,2019/8/25 13:33,2-1_all_corrected,76,51,189,217,265,268
199873,30169_20190825160616.jpg,イオン相模原ショッピングセンター,9041,野田,300,さ,2019/8/25 16:05,2-1_all_corrected,59,28,150,207,209,235
200480,30046_20190825183836.jpg,マミーマート船橋日大[地上],7884,習志野,530,さ,2019/8/25 18:38,2-1_all_corrected,34,29,155,82,189,111
199242,30110_20190825121354.jpg,イオン金沢八景,5165,横浜,303,ち,2019/8/25 12:13,2-1_all_corrected,81,62,289,184,370,246
199070,30001_20190825110938.jpg,関西スーパー高石駅前,1039,なにわ,480,て,2019/8/25 11:09,2-1_all_corrected,74,55,357,109,431,164
200017,30144_20190825163849.jpg,イオン幕張,*178,千葉,338,に,2019/8/25 16:38,2-1_all_corrected,54,43,110,218,164,261
200225,30014_20190825172536.jpg,フォルテ蘇我ベルク棟,***5,千葉,30,ひ,2019/8/25 17:25,2-1_all_corrected,53,44,159,40,212,84
199681,30144_20190825150604.jpg,イオン幕張,3615,千葉,130,さ,2019/8/25 15:05,2-1_all_corrected,77,57,301,282,378,339
199447,30039_20190825134503.jpg,イトーヨーカドー大井町,*212,品川,343,む,2019/8/25 13:44,2-1_all_corrected,70,55,268,139,338,194
201191,30167_20190825214312.jpg,イオン東雲店,6103,品川,302,む,2019/8/25 21:42,2-1_all_corrected,88,54,4,396,92,450
199478,30144_20190825135814.jpg,イオン幕張,2286,神戸,501,は,2019/8/25 13:57,2-1_all_corrected,78,49,255,263,333,312
200249,30110_20190825172958.jpg,イオン金沢八景,1483,横浜,480,そ,2019/8/25 17:29,2-1_all_corrected,55,41,316,144,371,185
200612,30167_20190825190627.jpg,イオン東雲店,5298,習志野,504,に,2019/8/25 19:06,2-1_all_corrected,44,37,302,231,346,268
201162,30098_20190825212319.jpg,BRANCH仙台（東棟）,*211,仙台,333,ぬ,2019/8/25 21:22,2-1_all_corrected,104,74,183,324,287,398
199482,30071_20190825135949.jpg,カナートモール住道第二,***2,大阪,30,ね,2019/8/25 13:59,2-1_all_corrected,48,38,305,197,353,235
199449,30144_20190825134527.jpg,イオン幕張,5059,袖ヶ浦,530,て,2019/8/25 13:45,2-1_all_corrected,83,58,226,291,309,349
199688,30144_20190825150751.jpg,イオン幕張,1248,千葉,531,も,2019/8/25 15:07,2-1_all_corrected,60,46,286,177,346,223
200247,30144_20190825172946.jpg,イオン幕張,3938,習志野,530,の,2019/8/25 17:29,2-1_all_corrected,76,52,267,256,343,308
199881,30169_20190825160833.jpg,イオン相模原ショッピングセンター,8453,相模,502,と,2019/8/25 16:07,2-1_all_corrected,51,42,303,213,354,255
199415,30144_20190825132837.jpg,イオン幕張,1001,千葉,562,な,2019/8/25 13:28,2-1_all_corrected,44,33,126,62,170,95
199844,30144_20190825155718.jpg,イオン幕張,1306,千葉,502,さ,2019/8/25 15:56,2-1_all_corrected,49,34,144,99,193,133
200215,30091_20190825172057.jpg,イトーヨーカドー木場 立体,*613,多摩,337,ね,2019/8/25 17:20,2-1_all_corrected,67,55,318,86,385,141
200279,30144_20190825173956.jpg,イオン幕張,***1,千葉,30,む,2019/8/25 17:39,2-1_all_corrected,37,40,169,151,206,191
199226,30078_20190825120832.jpg,イオンスタイル仙台卸町店,**51,仙台,300,ね,2019/8/25 12:07,2-1_all_corrected,82,59,363,231,445,290
199642,30090_20190825145118.jpg,イトーヨーカドー木場 西棟,5898,足立,502,そ,2019/8/25 14:50,2-1_all_corrected,57,42,286,183,343,225
200246,30111_20190825172943.jpg,イオン稲毛,6277,千葉,301,ゆ,2019/8/25 17:27,2-1_all_corrected,57,43,342,151,399,194
201152,30110_20190825211935.jpg,イオン金沢八景,***2,横浜,379,る,2019/8/25 21:19,2-1_all_corrected,52,43,261,147,313,190
199689,30110_20190825150753.jpg,イオン金沢八景,5552,横浜,331,て,2019/8/25 15:07,2-1_all_corrected,52,41,364,102,416,143
201155,30110_20190825212001.jpg,イオン金沢八景,5506,横浜,303,る,2019/8/25 21:19,2-1_all_corrected,71,59,340,100,411,159
199810,30144_20190825154424.jpg,イオン幕張,8158,豊田,300,す,2019/8/25 15:44,2-1_all_corrected,55,37,201,124,256,161
199217,30167_20190825120539.jpg,イオン東雲店,4026,足立,302,ろ,2019/8/25 12:05,2-1_all_corrected,42,33,411,62,453,95
200248,30144_20190825172953.jpg,イオン幕張,3284,習志野,333,ね,2019/8/25 17:29,2-1_all_corrected,71,50,187,174,258,224
200421,30160_20190825182435.jpg,マックスバリュ米野木店（平面）,2222,名古屋,328,か,2019/8/25 18:24,2-1_all_corrected,72,51,204,125,276,176
201197,30078_20190825215159.jpg,イオンスタイル仙台卸町店,*301,宮城,331,の,2019/8/25 21:51,2-1_all_corrected,90,63,228,305,318,368
200841,30144_20190825194057.jpg,イオン幕張,3877,千葉,330,ゆ,2019/8/25 19:40,2-1_all_corrected,53,39,165,115,218,154
200089,30169_20190825165645.jpg,イオン相模原ショッピングセンター,*316,相模,337,な,2019/8/25 16:56,2-1_all_corrected,92,71,307,124,399,195
199680,30078_20190825150603.jpg,イオンスタイル仙台卸町店,*777,宮城,322,ほ,2019/8/25 15:05,2-1_all_corrected,65,56,327,99,392,155
200042,30144_20190825164458.jpg,イオン幕張,4336,千葉,581,く,2019/8/25 16:44,2-1_all_corrected,66,42,173,224,239,266
199479,30060_20190825135852.jpg,関西スーパー小野原,8832,大阪,503,ほ,2019/8/25 13:58,2-1_all_corrected,67,65,469,272,536,337
200614,30169_20190825190648.jpg,イオン相模原ショッピングセンター,*917,相模,533,め,2019/8/25 19:06,2-1_all_corrected,77,51,327,219,404,270
200792,30085_20190825193637.jpg,業務スーパー南津守,***5,なにわ,30,さ,2019/8/25 19:36,2-1_all_corrected,80,56,223,370,303,426
200554,30062_20190825184953.jpg,ミスミモール,1001,神戸,31,ろ,2019/8/25 18:49,2-1_all_corrected,75,61,165,182,240,243
200302,30144_20190825174644.jpg,イオン幕張,3408,千葉,430,そ,2019/8/25 17:46,2-1_all_corrected,57,44,218,206,275,250
200598,30167_20190825190151.jpg,イオン東雲店,***1,八王子,402,う,2019/8/25 19:01,2-1_all_corrected,50,39,339,267,389,306
200106,30169_20190825165955.jpg,イオン相模原ショッピングセンター,2745,相模,580,に,2019/8/25 16:59,2-1_all_corrected,79,64,269,95,348,159
200750,30144_20190825192659.jpg,イオン幕張,**44,習志野,336,ま,2019/8/25 19:26,2-1_all_corrected,44,37,285,115,329,152
199502,30144_20190825140516.jpg,イオン幕張,8684,習志野,330,ぬ,2019/8/25 14:04,2-1_all_corrected,84,58,194,297,278,355
199166,30169_20190825114554.jpg,イオン相模原ショッピングセンター,1029,相模,535,な,2019/8/25 11:45,2-1_all_corrected,85,66,293,114,378,180
201246,30023_20190825224933.jpg,ピットデザイン山科東野,7777,京都,522,み,2019/8/25 22:49,2-1_all_corrected,77,61,249,52,326,113
200704,30169_20190825191626.jpg,イオン相模原ショッピングセンター,5025,豊橋,530,れ,2019/8/25 19:15,2-1_all_corrected,54,42,433,11,487,53
199135,30167_20190825113455.jpg,イオン東雲店,*673,春日部,880,り,2019/8/25 11:34,2-1_all_corrected,28,33,25,50,53,83
199763,30168_20190825153043.jpg,イオン東雲店（屋上）,5595,野田,500,わ,2019/8/25 15:30,2-1_all_corrected,86,62,364,312,450,374
199797,30144_20190825153856.jpg,イオン幕張,1215,千葉,540,ほ,2019/8/25 15:38,2-1_all_corrected,54,39,225,158,279,197
200969,30144_20190825195654.jpg,イオン幕張,2801,世田谷,310,す,2019/8/25 19:56,2-1_all_corrected,78,55,225,231,303,286
199338,30110_20190825125023.jpg,イオン金沢八景,9334,横浜,530,そ,2019/8/25 12:49,2-1_all_corrected,83,63,341,242,424,305
201241,30169_20190825224102.jpg,イオン相模原ショッピングセンター,*891,相模,301,も,2019/8/25 22:40,2-1_all_corrected,92,78,424,355,516,433
200732,30111_20190825192140.jpg,イオン稲毛,1375,千葉,531,ね,2019/8/25 19:21,2-1_all_corrected,70,56,413,257,483,313
200597,30110_20190825190147.jpg,イオン金沢八景,1111,横浜,346,み,2019/8/25 19:01,2-1_all_corrected,79,66,163,185,242,251
198831,30072_20190825092111.jpg,関西スーパー京阪大和田１F,6286,なにわ,830,あ,2019/8/25 9:20,2-1_all_corrected,74,63,18,213,92,276
200769,30060_20190825193324.jpg,関西スーパー小野原,1001,大阪,31,ろ,2019/8/25 19:33,2-1_all_corrected,49,44,380,74,429,118
199390,30169_20190825131816.jpg,イオン相模原ショッピングセンター,6157,多摩,330,さ,2019/8/25 13:17,2-1_all_corrected,49,39,302,130,351,169
201225,30169_20190825221502.jpg,イオン相模原ショッピングセンター,5525,相模,580,う,2019/8/25 22:14,2-1_all_corrected,57,44,333,135,390,179
201017,30025_20190825201631.jpg,ツルハドラッグあすと長町,5637,仙台,500,ま,2019/8/25 20:16,2-1_all_corrected,61,61,129,72,190,133
200932,30167_20190825195218.jpg,イオン東雲店,3504,足立,302,ね,2019/8/25 19:51,2-1_all_corrected,45,34,303,217,348,251
201028,30169_20190825202013.jpg,イオン相模原ショッピングセンター,**33,相模,367,ぬ,2019/8/25 20:19,2-1_all_corrected,80,65,388,271,468,336
199308,30144_20190825124103.jpg,イオン幕張,***4,足立,340,て,2019/8/25 12:40,2-1_all_corrected,59,43,138,148,197,191
200357,30167_20190825181016.jpg,イオン東雲店,*720,足立,338,せ,2019/8/25 18:09,2-1_all_corrected,78,66,91,275,169,341
199798,30144_20190825154045.jpg,イオン幕張,6217,八王子,501,と,2019/8/25 15:40,2-1_all_corrected,59,43,113,162,172,205
200506,30110_20190825184239.jpg,イオン金沢八景,7117,横浜,303,る,2019/8/25 18:41,2-1_all_corrected,68,54,350,142,418,196
200392,30063_20190825181843.jpg,コーナン相模原小山モール,1000,相模,32,も,2019/8/25 18:18,2-1_all_corrected,42,34,362,74,404,108
200530,30046_20190825184616.jpg,マミーマート船橋日大[地上],2661,柏,500,わ,2019/8/25 18:45,2-1_all_corrected,36,32,153,57,189,89
199301,30150_20190825123805.jpg,テックランド大阪野田店,1118,なにわ,356,す,2019/8/25 12:37,2-1_all_corrected,55,39,194,195,249,234
199778,30144_20190825153523.jpg,イオン幕張,9970,千葉,580,た,2019/8/25 15:34,2-1_all_corrected,55,39,139,118,194,157
199581,30110_20190825142938.jpg,イオン金沢八景,*521,横浜,539,す,2019/8/25 14:29,2-1_all_corrected,55,42,126,125,181,167
200943,30111_20190825195345.jpg,イオン稲毛,2010,千葉,345,さ,2019/8/25 19:53,2-1_all_corrected,53,40,162,122,215,162
200729,30167_20190825192046.jpg,イオン東雲店,6434,足立,503,の,2019/8/25 19:20,2-1_all_corrected,38,32,375,77,413,109
199785,30169_20190825153659.jpg,イオン相模原ショッピングセンター,7602,相模,502,ね,2019/8/25 15:36,2-1_all_corrected,83,61,306,86,389,147
199173,30110_20190825114815.jpg,イオン金沢八景,1210,横浜,537,の,2019/8/25 11:47,2-1_all_corrected,81,57,250,184,331,241
200583,30167_20190825185720.jpg,イオン東雲店,*703,足立,346,め,2019/8/25 18:56,2-1_all_corrected,43,32,369,41,412,73
200584,30144_20190825185726.jpg,イオン幕張,**88,千葉,372,ね,2019/8/25 18:57,2-1_all_corrected,45,41,210,145,255,186
199379,30110_20190825131424.jpg,イオン金沢八景,7003,横浜,580,た,2019/8/25 13:13,2-1_all_corrected,45,37,97,165,142,202
201209,30167_20190825220249.jpg,イオン東雲店,1517,世田谷,480,り,2019/8/25 22:02,2-1_all_corrected,85,69,129,359,214,428
201004,30110_20190825201024.jpg,イオン金沢八景,5268,横浜,504,ひ,2019/8/25 20:06,2-1_all_corrected,73,59,249,277,322,336
201003,30091_20190825200939.jpg,イトーヨーカドー木場 立体,4061,練馬,300,み,2019/8/25 20:09,2-1_all_corrected,56,41,258,76,314,117
200146,30169_20190825170745.jpg,イオン相模原ショッピングセンター,2130,相模,502,ね,2019/8/25 17:06,2-1_all_corrected,81,65,293,108,374,173
200374,30078_20190825181408.jpg,イオンスタイル仙台卸町店,3306,相模,580,せ,2019/8/25 18:13,2-1_all_corrected,77,56,264,167,341,223
200179,30110_20190825171403.jpg,イオン金沢八景,5200,横浜,334,さ,2019/8/25 17:13,2-1_all_corrected,75,60,219,235,294,295
199313,30110_20190825124336.jpg,イオン金沢八景,1626,横浜,333,て,2019/8/25 12:43,2-1_all_corrected,71,53,190,144,261,197
201058,30111_20190825203113.jpg,イオン稲毛,5577,千葉,341,ね,2019/8/25 20:30,2-1_all_corrected,51,44,139,115,190,159
200124,30110_20190825170317.jpg,イオン金沢八景,5694,横浜,505,た,2019/8/25 17:02,2-1_all_corrected,76,57,300,91,376,148
199143,30167_20190825113734.jpg,イオン東雲店,**86,足立,533,ろ,2019/8/25 11:37,2-1_all_corrected,65,65,1,287,66,352
199385,30085_20190825131709.jpg,業務スーパー南津守,1122,なにわ,31,ま,2019/8/25 13:16,2-1_all_corrected,53,42,295,220,348,262
200123,30111_20190825170253.jpg,イオン稲毛,2747,千葉,583,え,2019/8/25 17:02,2-1_all_corrected,56,42,139,153,195,195
200547,30167_20190825184805.jpg,イオン東雲店,***1,足立,357,む,2019/8/25 18:47,2-1_all_corrected,69,59,236,159,305,218
199347,30078_20190825125316.jpg,イオンスタイル仙台卸町店,8888,仙台,315,ろ,2019/8/25 12:52,2-1_all_corrected,58,42,249,38,307,80
201033,30046_20190825202224.jpg,マミーマート船橋日大[地上],*626,習志野,336,ほ,2019/8/25 20:22,2-1_all_corrected,73,61,443,188,516,249
199516,30167_20190825140759.jpg,イオン東雲店,7977,足立,302,ち,2019/8/25 14:07,2-1_all_corrected,73,57,279,214,352,271
200549,30167_20190825184823.jpg,イオン東雲店,***1,足立,357,む,2019/8/25 18:48,2-1_all_corrected,87,64,144,326,231,390
200112,30045_20190825170047.jpg,マックスバリュー徳川明倫,*358,名古屋,32,ひ,2019/8/25 17:00,2-1_all_corrected,51,44,499,170,550,214
200576,30078_20190825185554.jpg,イオンスタイル仙台卸町店,6082,仙台,580,せ,2019/8/25 18:55,2-1_all_corrected,88,48,271,181,359,229
199529,30090_20190825141233.jpg,イトーヨーカドー木場 西棟,*439,足立,530,あ,2019/8/25 14:12,2-1_all_corrected,78,58,318,280,396,338
200636,30167_20190825191123.jpg,イオン東雲店,8008,多摩,315,て,2019/8/25 19:10,2-1_all_corrected,37,29,387,76,424,105
200252,30111_20190825173034.jpg,イオン稲毛,*719,千葉,534,ま,2019/8/25 17:28,2-1_all_corrected,71,55,323,149,394,204
200094,30078_20190825165827.jpg,イオンスタイル仙台卸町店,3457,宮城,301,も,2019/8/25 16:57,2-1_all_corrected,80,61,175,152,255,213
199656,30078_20190825145512.jpg,イオンスタイル仙台卸町店,5148,仙台,500,は,2019/8/25 14:54,2-1_all_corrected,73,57,404,203,477,260
199490,30078_20190825140124.jpg,イオンスタイル仙台卸町店,1212,宮城,589,を,2019/8/25 14:00,2-1_all_corrected,72,51,261,118,333,169
201179,30169_20190825213724.jpg,イオン相模原ショッピングセンター,9694,横浜,503,ま,2019/8/25 21:37,2-1_all_corrected,78,74,489,363,567,437
199038,30144_20190825105920.jpg,イオン幕張,1950,京都,334,ね,2019/8/25 10:58,2-1_all_corrected,55,39,213,145,268,184
199651,30167_20190825145403.jpg,イオン東雲店,1872,品川,334,と,2019/8/25 14:53,2-1_all_corrected,98,65,35,385,133,450
198914,30169_20190825100539.jpg,イオン相模原ショッピングセンター,4863,札幌,580,も,2019/8/25 10:05,2-1_all_corrected,56,38,154,88,210,126
199658,30001_20190825145634.jpg,関西スーパー高石駅前,7864,和泉,580,め,2019/8/25 14:56,2-1_all_corrected,57,43,417,24,474,67
200435,30078_20190825182808.jpg,イオンスタイル仙台卸町店,1257,仙台,590,の,2019/8/25 18:27,2-1_all_corrected,72,54,220,132,292,186
201184,30091_20190825214027.jpg,イトーヨーカドー木場 立体,*721,足立,333,ね,2019/8/25 21:40,2-1_all_corrected,82,62,113,297,195,359
199452,30039_20190825134621.jpg,イトーヨーカドー大井町,*163,品川,41,に,2019/8/25 13:45,2-1_all_corrected,67,68,116,108,183,176
199660,30167_20190825145810.jpg,イオン東雲店,**33,足立,323,む,2019/8/25 14:57,2-1_all_corrected,53,38,312,152,365,190
199204,30169_20190825115922.jpg,イオン相模原ショッピングセンター,1122,相模,594,う,2019/8/25 11:58,2-1_all_corrected,85,67,159,78,244,145
199250,30080_20190825121644.jpg,フォーレストモール新前橋,***1,前橋,400,む,2019/8/25 12:16,2-1_all_corrected,57,43,308,116,365,159
199096,30078_20190825111617.jpg,イオンスタイル仙台卸町店,9314,仙台,580,ち,2019/8/25 11:15,2-1_all_corrected,88,56,251,300,339,356
199861,30167_20190825160254.jpg,イオン東雲店,1115,足立,340,も,2019/8/25 16:02,2-1_all_corrected,49,36,331,127,380,163
199257,30144_20190825121858.jpg,イオン幕張,*618,千葉,584,か,2019/8/25 12:18,2-1_all_corrected,52,41,142,122,194,163
199859,30144_20190825160242.jpg,イオン幕張,1026,習志野,533,ゆ,2019/8/25 16:02,2-1_all_corrected,71,51,245,228,316,279
199401,30167_20190825132036.jpg,イオン東雲店,***1,杉並,310,と,2019/8/25 13:20,2-1_all_corrected,76,66,164,224,240,290
200237,30144_20190825172710.jpg,イオン幕張,5615,千葉,301,め,2019/8/25 17:26,2-1_all_corrected,85,58,263,291,348,349
200005,30167_20190825163603.jpg,イオン東雲店,1301,福島,501,そ,2019/8/25 16:35,2-1_all_corrected,51,39,348,129,399,168
200291,30144_20190825174433.jpg,イオン幕張,1615,習志野,530,せ,2019/8/25 17:44,2-1_all_corrected,74,50,259,219,333,269
200265,30169_20190825173411.jpg,イオン相模原ショッピングセンター,2112,相模,532,ゆ,2019/8/25 17:33,2-1_all_corrected,60,43,365,35,425,78
200601,30001_20190825190238.jpg,関西スーパー高石駅前,*719,堺,331,さ,2019/8/25 19:02,2-1_all_corrected,56,45,475,49,531,94
200433,30167_20190825182756.jpg,イオン東雲店,5109,足立,330,な,2019/8/25 18:27,2-1_all_corrected,57,46,198,227,255,273
199661,30110_20190825145821.jpg,イオン金沢八景,1215,横浜,543,た,2019/8/25 14:57,2-1_all_corrected,86,91,0,297,86,388
199666,30144_20190825150034.jpg,イオン幕張,2521,千葉,331,さ,2019/8/25 15:00,2-1_all_corrected,90,58,314,392,404,450
199805,30078_20190825154249.jpg,イオンスタイル仙台卸町店,1910,仙台,580,に,2019/8/25 15:42,2-1_all_corrected,72,51,259,146,331,197
199668,30167_20190825150157.jpg,イオン東雲店,**36,足立,348,つ,2019/8/25 15:01,2-1_all_corrected,78,57,279,227,357,284
199869,30144_20190825160511.jpg,イオン幕張,8939,千葉,502,ゆ,2019/8/25 16:04,2-1_all_corrected,72,55,251,222,323,277
200697,30157_20190825191606.jpg,関西スーパー中央,*333,神戸,357,に,2019/8/25 19:15,2-1_all_corrected,74,49,232,401,306,450
199856,30167_20190825160135.jpg,イオン東雲店,1517,世田谷,480,り,2019/8/25 16:01,2-1_all_corrected,40,34,0,56,40,90
198948,30078_20190825102454.jpg,イオンスタイル仙台卸町店,*145,仙台,580,と,2019/8/25 10:24,2-1_all_corrected,94,71,162,295,256,366
200209,30085_20190825171859.jpg,業務スーパー南津守,***5,なにわ,30,さ,2019/8/25 17:18,2-1_all_corrected,67,56,177,333,244,389
199858,30167_20190825160202.jpg,イオン東雲店,1517,世田谷,480,り,2019/8/25 16:01,2-1_all_corrected,84,75,122,352,206,427
199400,30046_20190825132035.jpg,マミーマート船橋日大[地上],8001,習志野,530,ぬ,2019/8/25 13:20,2-1_all_corrected,50,38,213,80,263,118
200004,30167_20190825163547.jpg,イオン東雲店,1301,福島,501,そ,2019/8/25 16:35,2-1_all_corrected,42,36,21,8,63,44
200458,30063_20190825183234.jpg,コーナン相模原小山モール,5139,相模,580,ゆ,2019/8/25 18:32,2-1_all_corrected,68,58,455,135,523,193
201125,30169_20190825210512.jpg,イオン相模原ショッピングセンター,4384,横浜,581,け,2019/8/25 21:04,2-1_all_corrected,54,43,173,124,227,167
200003,30144_20190825163545.jpg,イオン幕張,1218,千葉,543,つ,2019/8/25 16:35,2-1_all_corrected,88,65,327,298,415,363
212911,30078_20190830122214.jpg,イオンスタイル仙台卸町店,9999,山形,335.0,ゆ,2019/8/30 12:21,2-1_all_corrected,103,67,199,383,302,450
215105,30115_20190830210005.jpg,イオン南行徳（平面）,5340,岡山,300.0,ま,2019/8/30 20:59,2-1_all_corrected,69,59,360,147,429,206
213201,30139_20190830140925.jpg,イオン板橋ショッピングセンター,5024,練馬,480.0,れ,2019/8/30 14:09,2-1_all_corrected,73,59,381,306,454,365
214482,30046_20190830182842.jpg,マミーマート船橋日大[地上],1221,千葉,551.0,は,2019/8/30 18:28,2-1_all_corrected,77,70,488,256,565,326
215134,30157_20190830211453.jpg,関西スーパー中央,**77,神戸,-1.0,の,2019/8/30 21:14,2-1_all_corrected,69,56,253,394,322,450
213461,30136_20190830153441.jpg,イオンスタイル新百合ヶ丘,*773,川崎,532.0,さ,2019/8/30 15:34,2-1_all_corrected,104,72,172,184,276,256
213653,30136_20190830161638.jpg,イオンスタイル新百合ヶ丘,**55,川崎,357.0,り,2019/8/30 16:16,2-1_all_corrected,100,73,329,150,429,223
212786,30169_20190830120845.jpg,イオン相模原ショッピングセンター,*735,富士山,300.0,す,2019/8/30 12:08,2-1_all_corrected,87,65,304,86,391,151
214015,30111_20190830172822.jpg,イオン稲毛,5487,千葉,301.0,ら,2019/8/30 17:25,2-1_all_corrected,53,43,197,135,250,178
215193,30039_20190830220136.jpg,イトーヨーカドー大井町,*384,品川,502.0,た,2019/8/30 22:01,2-1_all_corrected,55,46,310,111,365,157
215167,30063_20190830213616.jpg,コーナン相模原小山モール,*358,土浦,-1.0,す,2019/8/30 21:35,2-1_all_corrected,49,45,501,178,550,223
215160,30157_20190830213014.jpg,関西スーパー中央,1010,神戸,-1.0,ね,2019/8/30 21:29,2-1_all_corrected,52,44,186,252,238,296
214046,30072_20190830173142.jpg,関西スーパー京阪大和田１F,2784,大阪,300.0,あ,2019/8/30 17:31,2-1_all_corrected,49,40,111,57,160,97
213638,30136_20190830161410.jpg,イオンスタイル新百合ヶ丘,*710,川崎,335.0,ぬ,2019/8/30 16:13,2-1_all_corrected,73,57,200,136,273,193
214887,30110_20190830194233.jpg,イオン金沢八景,**62,横浜,336.0,の,2019/8/30 19:42,2-1_all_corrected,78,63,441,197,519,260
213404,30046_20190830151443.jpg,マミーマート船橋日大[地上],8803,習志野,583.0,あ,2019/8/30 15:14,2-1_all_corrected,83,57,322,318,405,375
215151,30006_20190830212411.jpg,スギ薬局南千里,*106,大阪,335.0,た,2019/8/30 21:24,2-1_all_corrected,130,114,124,165,254,279
214083,30111_20190830173442.jpg,イオン稲毛,1011,千葉,542.0,ひ,2019/8/30 17:32,2-1_all_corrected,61,42,334,165,395,207
214874,30098_20190830194003.jpg,BRANCH仙台（東棟）,*920,仙台,583.0,は,2019/8/30 19:39,2-1_all_corrected,91,64,330,252,421,316
212328,30078_20190830094152.jpg,イオンスタイル仙台卸町店,*817,仙台,332.0,さ,2019/8/30 9:41,2-1_all_corrected,81,57,209,205,290,262
215132,30145_20190830211434.jpg,イオン高根木戸,8326,習志野,-1.0,ぬ,2019/8/30 21:14,2-1_all_corrected,63,60,465,145,528,205
212541,30139_20190830105318.jpg,イオン板橋ショッピングセンター,5609,練馬,301.0,や,2019/8/30 10:52,2-1_all_corrected,78,57,270,285,348,342
214484,30144_20190830182855.jpg,イオン幕張,3218,千葉,503.0,さ,2019/8/30 18:28,2-1_all_corrected,78,62,427,314,505,376
214642,30169_20190830185308.jpg,イオン相模原ショッピングセンター,5154,沼津,580.0,た,2019/8/30 18:52,2-1_all_corrected,89,69,350,321,439,390
213652,30139_20190830161627.jpg,イオン板橋ショッピングセンター,***1,練馬,30.0,ね,2019/8/30 16:16,2-1_all_corrected,75,57,318,190,393,247
212780,30144_20190830120741.jpg,イオン幕張,*724,習志野,584.0,こ,2019/8/30 12:07,2-1_all_corrected,56,38,153,166,209,204
214477,30144_20190830182747.jpg,イオン幕張,3104,袖ヶ浦,335.0,ほ,2019/8/30 18:27,2-1_all_corrected,69,50,249,198,318,248
214826,30111_20190830193118.jpg,イオン稲毛,6448,川崎,330.0,き,2019/8/30 19:30,2-1_all_corrected,50,43,172,137,222,180
213456,30136_20190830153416.jpg,イオンスタイル新百合ヶ丘,5429,多摩,302.0,ら,2019/8/30 15:33,2-1_all_corrected,91,64,77,224,168,288
213032,30111_20190830130337.jpg,イオン稲毛,3392,千葉,502.0,み,2019/8/30 13:02,2-1_all_corrected,59,45,322,154,381,199
213200,30039_20190830140907.jpg,イトーヨーカドー大井町,1122,品川,31.0,ね,2019/8/30 14:08,2-1_all_corrected,70,57,234,135,304,192
214687,30157_20190830190051.jpg,関西スーパー中央,**10,神戸,31.0,の,2019/8/30 19:00,2-1_all_corrected,71,56,189,390,260,446
215104,30098_20190830205952.jpg,BRANCH仙台（東棟）,*211,仙台,331.0,ぬ,2019/8/30 20:59,2-1_all_corrected,99,68,197,309,296,377
214674,30072_20190830185832.jpg,関西スーパー京阪大和田１F,8877,大阪,333.0,ゆ,2019/8/30 18:58,2-1_all_corrected,78,59,185,157,263,216
214082,30111_20190830173431.jpg,イオン稲毛,5891,千葉,501.0,わ,2019/8/30 17:31,2-1_all_corrected,57,43,337,147,394,190
214875,30169_20190830194006.jpg,イオン相模原ショッピングセンター,9659,相模,502.0,ち,2019/8/30 19:39,2-1_all_corrected,90,72,374,330,464,402
212729,30139_20190830115035.jpg,イオン板橋ショッピングセンター,3671,練馬,480.0,れ,2019/8/30 11:50,2-1_all_corrected,49,41,267,152,316,193
213606,30136_20190830160917.jpg,イオンスタイル新百合ヶ丘,4837,川崎,580.0,こ,2019/8/30 16:08,2-1_all_corrected,87,64,252,104,339,168
214424,30136_20190830181828.jpg,イオンスタイル新百合ヶ丘,3069,川崎,300.0,ろ,2019/8/30 18:17,2-1_all_corrected,78,68,3,382,81,450
214556,30139_20190830183835.jpg,イオン板橋ショッピングセンター,7487,練馬,480.0,れ,2019/8/30 18:38,2-1_all_corrected,55,42,222,264,277,306
212699,30111_20190830113958.jpg,イオン稲毛,8333,千葉,583.0,け,2019/8/30 11:38,2-1_all_corrected,52,44,325,146,377,190
213310,30169_20190830144901.jpg,イオン相模原ショッピングセンター,*611,熊谷,510.0,ね,2019/8/30 14:48,2-1_all_corrected,95,71,238,105,333,176
214103,30111_20190830173638.jpg,イオン稲毛,2960,千葉,331.0,ね,2019/8/30 17:33,2-1_all_corrected,57,43,358,149,415,192
213910,30001_20190830171247.jpg,関西スーパー高石駅前,1122,和泉,31.0,ち,2019/8/30 17:12,2-1_all_corrected,76,53,398,102,474,155
214309,30144_20190830180500.jpg,イオン幕張,**55,千葉,393.0,つ,2019/8/30 18:04,2-1_all_corrected,60,43,222,175,282,218
214938,30043_20190830195729.jpg,ファインシティ東松戸,*131,野田,334.0,た,2019/8/30 19:57,2-1_all_corrected,79,50,77,400,156,450
215244,30144_20190830225126.jpg,イオン幕張,2215,熊谷,-1.0,あ,2019/8/30 22:50,2-1_all_corrected,49,48,38,202,87,250
213178,30078_20190830135851.jpg,イオンスタイル仙台卸町店,5514,仙台,580.0,て,2019/8/30 13:58,2-1_all_corrected,97,48,360,402,457,450
214953,30144_20190830200439.jpg,イオン幕張,9914,千葉,581.0,か,2019/8/30 20:04,2-1_all_corrected,57,41,189,163,246,204
214739,30111_20190830191122.jpg,イオン稲毛,2525,千葉,318.0,や,2019/8/30 19:10,2-1_all_corrected,60,44,313,159,373,203
215049,30144_20190830203619.jpg,イオン幕張,7023,習志野,580.0,た,2019/8/30 20:35,2-1_all_corrected,76,53,271,257,347,310
213140,30045_20190830134431.jpg,マックスバリュー徳川明倫,**77,名古屋,31.0,ほ,2019/8/30 13:44,2-1_all_corrected,62,58,115,177,177,235
213729,30139_20190830163248.jpg,イオン板橋ショッピングセンター,*275,川口,480.0,り,2019/8/30 16:32,2-1_all_corrected,68,58,296,199,364,257
214354,30169_20190830181013.jpg,イオン相模原ショッピングセンター,***5,多摩,30.0,な,2019/8/30 18:09,2-1_all_corrected,79,57,143,13,222,70
214192,30144_20190830174811.jpg,イオン幕張,1116,千葉,544.0,ら,2019/8/30 17:47,2-1_all_corrected,82,58,242,300,324,358
213549,30060_20190830155510.jpg,関西スーパー小野原,1793,大阪,543.0,た,2019/8/30 15:54,2-1_all_corrected,40,35,455,59,495,94
213576,30111_20190830160349.jpg,イオン稲毛,1230,千葉,585.0,ほ,2019/8/30 16:02,2-1_all_corrected,53,44,325,147,378,191
214901,30144_20190830194605.jpg,イオン幕張,*729,千葉,532.0,は,2019/8/30 19:45,2-1_all_corrected,57,42,258,150,315,192
213115,30090_20190830133518.jpg,イトーヨーカドー木場 西棟,**23,習志野,340.0,み,2019/8/30 13:34,2-1_all_corrected,88,63,178,340,266,403
213743,30167_20190830164029.jpg,イオン東雲店,*486,足立,880.0,り,2019/8/30 16:39,2-1_all_corrected,65,60,147,233,212,293
215216,30111_20190830221644.jpg,イオン稲毛,*920,千葉,536.0,む,2019/8/30 22:16,2-1_all_corrected,68,57,279,201,347,258
215227,30090_20190830222734.jpg,イトーヨーカドー木場 西棟,***1,春日部,525.0,や,2019/8/30 22:27,2-1_all_corrected,79,58,199,237,278,295
213316,30144_20190830145016.jpg,イオン幕張,**26,千葉,343.0,む,2019/8/30 14:49,2-1_all_corrected,57,41,212,194,269,235
214301,30167_20190830180357.jpg,イオン東雲店,4704,足立,481.0,り,2019/8/30 18:03,2-1_all_corrected,67,66,153,294,220,360
213540,30169_20190830155407.jpg,イオン相模原ショッピングセンター,***8,多摩,565.0,の,2019/8/30 15:53,2-1_all_corrected,39,30,332,119,371,149
213772,30045_20190830164715.jpg,マックスバリュー徳川明倫,*358,名古屋,32.0,と,2019/8/30 16:46,2-1_all_corrected,47,32,360,103,407,135
215041,30072_20190830203234.jpg,関西スーパー京阪大和田１F,3500,大阪,342.0,め,2019/8/30 20:32,2-1_all_corrected,96,62,208,260,304,322
213726,30111_20190830163204.jpg,イオン稲毛,*655,千葉,301.0,ゆ,2019/8/30 16:30,2-1_all_corrected,57,42,395,131,452,173
214194,30078_20190830174849.jpg,イオンスタイル仙台卸町店,7213,福島,581.0,と,2019/8/30 17:48,2-1_all_corrected,74,57,177,121,251,178
213148,30167_20190830134644.jpg,イオン東雲店,4704,足立,481.0,り,2019/8/30 13:46,2-1_all_corrected,81,71,85,377,166,448
213728,30139_20190830163243.jpg,イオン板橋ショッピングセンター,3671,練馬,480.0,れ,2019/8/30 16:32,2-1_all_corrected,69,59,235,252,304,311
215245,30111_20190830225154.jpg,イオン稲毛,5128,千葉,530.0,や,2019/8/30 22:51,2-1_all_corrected,49,39,135,109,184,148
214535,30101_20190830183628.jpg,にしてつストアレガネット姪浜,**55,福岡,31.0,ね,2019/8/30 18:35,2-1_all_corrected,56,41,221,230,277,271
213710,30139_20190830162539.jpg,イオン板橋ショッピングセンター,5024,練馬,480.0,れ,2019/8/30 16:25,2-1_all_corrected,84,66,401,384,485,450
212863,30169_20190830121510.jpg,イオン相模原ショッピングセンター,*735,富士山,300.0,す,2019/8/30 12:14,2-1_all_corrected,86,66,285,89,371,155
213945,30106_20190830171812.jpg,ジョーシン東大阪長田,***8,大阪,30.0,そ,2019/8/30 17:17,2-1_all_corrected,55,40,244,197,299,237
214970,30144_20190830200833.jpg,イオン幕張,1116,千葉,341.0,る,2019/8/30 20:08,2-1_all_corrected,88,64,444,373,532,437
213500,30167_20190830154059.jpg,イオン東雲店,1786,佐賀,501.0,て,2019/8/30 15:40,2-1_all_corrected,70,56,425,343,495,399
212846,30145_20190830121418.jpg,イオン高根木戸,2003,春日部,130.0,き,2019/8/30 12:13,2-1_all_corrected,43,26,180,134,223,160
213994,30111_20190830172452.jpg,イオン稲毛,3576,千葉,581.0,い,2019/8/30 17:22,2-1_all_corrected,78,60,256,235,334,295
213735,30110_20190830163551.jpg,イオン金沢八景,1180,横浜,581.0,け,2019/8/30 16:35,2-1_all_corrected,70,57,290,226,360,283
214948,30157_20190830200005.jpg,関西スーパー中央,1708,神戸,333.0,つ,2019/8/30 19:59,2-1_all_corrected,50,41,266,261,316,302
212277,30066_20190830091249.jpg,ジョーシン和泉中央,1001,和泉,31.0,と,2019/8/30 9:12,2-1_all_corrected,78,69,102,290,180,359
213703,30139_20190830162414.jpg,イオン板橋ショッピングセンター,3900,練馬,480.0,れ,2019/8/30 16:23,2-1_all_corrected,76,61,310,313,386,374
215064,30125_20190830204224.jpg,カスミ柏たなか駅前店,6643,大宮,580.0,ね,2019/8/30 20:41,2-1_all_corrected,67,56,115,282,182,338
213509,30167_20190830154503.jpg,イオン東雲店,7411,足立,230.0,さ,2019/8/30 15:44,2-1_all_corrected,57,43,313,317,370,360
214383,30111_20190830181314.jpg,イオン稲毛,4007,千葉,302.0,に,2019/8/30 18:11,2-1_all_corrected,60,44,344,187,404,231
214521,30110_20190830183349.jpg,イオン金沢八景,*612,つくば,330.0,ひ,2019/8/30 18:33,2-1_all_corrected,40,31,309,75,349,106
213360,30167_20190830150304.jpg,イオン東雲店,4758,足立,530.0,て,2019/8/30 15:02,2-1_all_corrected,93,59,87,391,180,450
212212,30072_20190830082954.jpg,関西スーパー京阪大和田１F,*762,京都,800.0,せ,2019/8/30 8:29,2-1_all_corrected,54,45,391,181,445,226
214575,30046_20190830184142.jpg,マミーマート船橋日大[地上],1071,習志野,501.0,ま,2019/8/30 18:41,2-1_all_corrected,75,74,507,342,582,416
212682,30136_20190830113405.jpg,イオンスタイル新百合ヶ丘,3008,川崎,300.0,ら,2019/8/30 11:33,2-1_all_corrected,55,49,204,107,259,156
213591,30136_20190830160632.jpg,イオンスタイル新百合ヶ丘,9100,川崎,530.0,す,2019/8/30 16:05,2-1_all_corrected,86,59,300,89,386,148
213553,30144_20190830155537.jpg,イオン幕張,2698,千葉,50.0,や,2019/8/30 15:55,2-1_all_corrected,86,55,300,293,386,348
213795,30039_20190830165655.jpg,イトーヨーカドー大井町,2572,品川,530.0,つ,2019/8/30 16:56,2-1_all_corrected,45,34,298,63,343,97
213130,30060_20190830134004.jpg,関西スーパー小野原,6435,大阪,302.0,み,2019/8/30 13:39,2-1_all_corrected,75,73,520,290,595,363
215250,30169_20190830225709.jpg,イオン相模原ショッピングセンター,*350,相模,337.0,は,2019/8/30 22:56,2-1_all_corrected,86,66,194,263,280,329
215062,30103_20190830204111.jpg,八尾老原１丁目,*113,大阪,352.0,り,2019/8/30 20:40,2-1_all_corrected,68,53,179,157,247,210
213957,30111_20190830171937.jpg,イオン稲毛,*708,千葉,332.0,な,2019/8/30 17:17,2-1_all_corrected,51,41,374,137,425,178
212885,30111_20190830121847.jpg,イオン稲毛,1986,千葉,531.0,ね,2019/8/30 12:17,2-1_all_corrected,57,40,338,150,395,190
213961,30144_20190830172009.jpg,イオン幕張,4886,千葉,501.0,せ,2019/8/30 17:19,2-1_all_corrected,81,51,341,294,422,345
214976,30001_20190830201029.jpg,関西スーパー高石駅前,5726,和泉,583.0,い,2019/8/30 20:10,2-1_all_corrected,75,54,373,142,448,196
215053,30079_20190830203713.jpg,ピットデザイン仙台卸町駅前駐車場,2625,仙台,-1.0,み,2019/8/30 20:36,2-1_all_corrected,79,57,287,146,366,203
212420,30144_20190830100813.jpg,イオン幕張,2800,千葉,480.0,れ,2019/8/30 10:07,2-1_all_corrected,78,57,356,355,434,412
214949,30167_20190830200139.jpg,イオン東雲店,1103,足立,370.0,め,2019/8/30 20:01,2-1_all_corrected,36,29,437,47,473,76
213992,30167_20190830172446.jpg,イオン東雲店,5000,品川,332.0,ひ,2019/8/30 17:24,2-1_all_corrected,94,57,25,393,119,450
214516,30110_20190830183340.jpg,イオン金沢八景,*612,つくば,333.0,ひ,2019/8/30 18:33,2-1_all_corrected,70,55,290,161,360,216
214126,30045_20190830173949.jpg,マックスバリュー徳川明倫,**77,名古屋,31.0,ほ,2019/8/30 17:39,2-1_all_corrected,54,47,223,142,277,189
214542,30139_20190830183723.jpg,イオン板橋ショッピングセンター,3671,練馬,480.0,れ,2019/8/30 18:36,2-1_all_corrected,83,67,390,361,473,428
215000,30131_20190830201746.jpg,ベルク狭山入間川,2267,奄美,-1.0,え,2019/8/30 20:17,2-1_all_corrected,39,29,282,150,321,179
214119,30111_20190830173852.jpg,イオン稲毛,*526,千葉,337.0,む,2019/8/30 17:35,2-1_all_corrected,53,43,351,100,404,143
212222,30145_20190830083358.jpg,イオン高根木戸,*565,練馬,501.0,む,2019/8/30 8:33,2-1_all_corrected,57,41,267,198,324,239
214783,30052_20190830192117.jpg,西友市ヶ尾,***5,横浜,30.0,も,2019/8/30 19:20,2-1_all_corrected,86,67,189,346,275,413
213100,30111_20190830133047.jpg,イオン稲毛,8008,千葉,392.0,ね,2019/8/30 13:29,2-1_all_corrected,55,45,218,135,273,180
214574,30046_20190830184134.jpg,マミーマート船橋日大[地上],1071,習志野,501.0,ま,2019/8/30 18:40,2-1_all_corrected,72,76,522,345,594,421
213597,30045_20190830160725.jpg,マックスバリュー徳川明倫,**18,名古屋,31.0,つ,2019/8/30 16:06,2-1_all_corrected,51,40,252,154,303,194
213081,30078_20190830132212.jpg,イオンスタイル仙台卸町店,*100,岩手,584.0,に,2019/8/30 13:21,2-1_all_corrected,59,43,229,62,288,105
214062,30072_20190830173304.jpg,関西スーパー京阪大和田１F,1573,大阪,302.0,の,2019/8/30 17:32,2-1_all_corrected,92,71,89,271,181,342
214268,30144_20190830175843.jpg,イオン幕張,9100,千葉,400.0,の,2019/8/30 17:58,2-1_all_corrected,75,49,303,211,378,260
214408,30144_20190830181714.jpg,イオン幕張,6678,千葉,302.0,て,2019/8/30 18:16,2-1_all_corrected,45,51,24,238,69,289
213276,30144_20190830143628.jpg,イオン幕張,***7,野田,586.0,を,2019/8/30 14:35,2-1_all_corrected,75,54,266,287,341,341
214053,30078_20190830173209.jpg,イオンスタイル仙台卸町店,*505,仙台,500.0,ふ,2019/8/30 17:31,2-1_all_corrected,59,44,251,117,310,161
215181,30046_20190830214527.jpg,マミーマート船橋日大[地上],***1,習志野,-1.0,て,2019/8/30 21:44,2-1_all_corrected,45,36,314,140,359,176
213612,30136_20190830161012.jpg,イオンスタイル新百合ヶ丘,2003,多摩,533.0,ね,2019/8/30 16:09,2-1_all_corrected,85,59,69,205,154,264
212992,30144_20190830124624.jpg,イオン幕張,8008,千葉,373.0,に,2019/8/30 12:45,2-1_all_corrected,54,38,196,139,250,177
215126,30103_20190830211108.jpg,八尾老原１丁目,1324,なにわ,301.0,な,2019/8/30 21:10,2-1_all_corrected,54,48,173,135,227,183
212767,30144_20190830120254.jpg,イオン幕張,5098,千葉,330.0,そ,2019/8/30 12:02,2-1_all_corrected,56,41,205,127,261,168
214007,30144_20190830172638.jpg,イオン幕張,2480,千葉,331.0,ち,2019/8/30 17:26,2-1_all_corrected,94,66,381,361,475,427
212760,30111_20190830120005.jpg,イオン稲毛,*103,千葉,338.0,る,2019/8/30 11:58,2-1_all_corrected,57,43,354,149,411,192
214038,30144_20190830173103.jpg,イオン幕張,1030,千葉,348.0,に,2019/8/30 17:30,2-1_all_corrected,90,67,337,343,427,410
213670,30136_20190830161921.jpg,イオンスタイル新百合ヶ丘,2347,川崎,501.0,た,2019/8/30 16:18,2-1_all_corrected,91,63,34,226,125,289
214203,30045_20190830175047.jpg,マックスバリュー徳川明倫,**22,名古屋,31.0,む,2019/8/30 17:50,2-1_all_corrected,58,44,249,151,307,195
214694,30072_20190830190203.jpg,関西スーパー京阪大和田１F,2525,大阪,831.0,け,2019/8/30 19:01,2-1_all_corrected,84,54,456,148,540,202
215110,30163_20190830210227.jpg,コープ葛飾白鳥店(地上),***8,足立,-1.0,す,2019/8/30 21:01,2-1_all_corrected,52,41,265,56,317,97
213213,30139_20190830141356.jpg,イオン板橋ショッピングセンター,*275,川口,480.0,り,2019/8/30 14:13,2-1_all_corrected,53,43,281,229,334,272
213677,30139_20190830162026.jpg,イオン板橋ショッピングセンター,1282,越谷,480.0,り,2019/8/30 16:20,2-1_all_corrected,72,66,347,290,419,356
213270,30078_20190830143345.jpg,イオンスタイル仙台卸町店,3325,宮城,581.0,う,2019/8/30 14:33,2-1_all_corrected,50,43,145,97,195,140
214055,30072_20190830173221.jpg,関西スーパー京阪大和田１F,2784,大阪,300.0,あ,2019/8/30 17:31,2-1_all_corrected,48,38,123,39,171,77
215173,30006_20190830214024.jpg,スギ薬局南千里,*106,大阪,335.0,た,2019/8/30 21:40,2-1_all_corrected,91,56,344,43,435,99
212735,30001_20190830115153.jpg,関西スーパー高石駅前,7788,和泉,556.0,む,2019/8/30 11:51,2-1_all_corrected,94,68,409,207,503,275
213277,30139_20190830143703.jpg,イオン板橋ショッピングセンター,***1,練馬,30.0,ね,2019/8/30 14:36,2-1_all_corrected,48,36,327,141,375,177
214604,30167_20190830184802.jpg,イオン東雲店,1993,足立,330.0,ろ,2019/8/30 18:47,2-1_all_corrected,82,60,222,246,304,306
214436,30157_20190830182016.jpg,関西スーパー中央,3630,神戸,330.0,や,2019/8/30 18:19,2-1_all_corrected,55,47,129,364,184,411
215142,30039_20190830211933.jpg,イトーヨーカドー大井町,*127,品川,341.0,ろ,2019/8/30 21:19,2-1_all_corrected,67,61,255,118,322,179
214090,30144_20190830173519.jpg,イオン幕張,2128,足立,502.0,つ,2019/8/30 17:34,2-1_all_corrected,89,67,338,342,427,409
214858,30062_20190830193625.jpg,ミスミモール,*358,神戸,31.0,と,2019/8/30 19:35,2-1_all_corrected,84,64,267,181,351,245
212951,30144_20190830122858.jpg,イオン幕張,*303,千葉,538.0,そ,2019/8/30 12:28,2-1_all_corrected,54,40,114,120,168,160
213622,30110_20190830161201.jpg,イオン金沢八景,6960,横浜,583.0,あ,2019/8/30 16:11,2-1_all_corrected,55,43,254,79,309,122
215145,30139_20190830212159.jpg,イオン板橋ショッピングセンター,5024,練馬,480.0,れ,2019/8/30 21:21,2-1_all_corrected,78,61,310,349,388,410
214834,30144_20190830193228.jpg,イオン幕張,9971,千葉,583.0,あ,2019/8/30 19:32,2-1_all_corrected,82,55,230,323,312,378
212757,30103_20190830115826.jpg,八尾老原１丁目,1122,大阪,31.0,る,2019/8/30 11:58,2-1_all_corrected,77,60,269,206,346,266
215129,30023_20190830211203.jpg,ピットデザイン山科東野,7777,京都,522.0,み,2019/8/30 21:11,2-1_all_corrected,72,59,261,36,333,95
212902,30111_20190830122134.jpg,イオン稲毛,*873,千葉,583.0,に,2019/8/30 12:19,2-1_all_corrected,53,43,336,135,389,178
214833,30078_20190830193215.jpg,イオンスタイル仙台卸町店,9119,仙台,530.0,そ,2019/8/30 19:31,2-1_all_corrected,88,63,221,266,309,329
214496,30111_20190830183050.jpg,イオン稲毛,8769,千葉,581.0,せ,2019/8/30 18:30,2-1_all_corrected,69,58,258,208,327,266
215120,30110_20190830210836.jpg,イオン金沢八景,1103,横浜,396.0,そ,2019/8/30 21:08,2-1_all_corrected,48,35,353,44,401,79
213647,30139_20190830161536.jpg,イオン板橋ショッピングセンター,7487,練馬,480.0,れ,2019/8/30 16:15,2-1_all_corrected,83,64,252,339,335,403
212173,30167_20190830080031.jpg,イオン東雲店,7411,足立,230.0,さ,2019/8/30 8:00,2-1_all_corrected,56,44,297,321,353,365
215127,30074_20190830211118.jpg,マックスバリュ北1条東,3712,札幌,302.0,む,2019/8/30 21:10,2-1_all_corrected,47,46,198,105,245,151
215197,30025_20190830220341.jpg,ツルハドラッグあすと長町,*111,仙台,-1.0,と,2019/8/30 22:03,2-1_all_corrected,50,44,485,186,535,230
212187,30072_20190830081559.jpg,関西スーパー京阪大和田１F,1568,大阪,130.0,あ,2019/8/30 8:15,2-1_all_corrected,68,59,67,182,135,241
212984,30139_20190830124316.jpg,イオン板橋ショッピングセンター,2525,練馬,559.0,み,2019/8/30 12:42,2-1_all_corrected,78,59,258,267,336,326
214419,30144_20190830181755.jpg,イオン幕張,1505,千葉,531.0,ほ,2019/8/30 18:17,2-1_all_corrected,51,42,128,113,179,155
213407,30136_20190830151622.jpg,イオンスタイル新百合ヶ丘,*787,八王子,331.0,も,2019/8/30 15:15,2-1_all_corrected,49,31,361,125,410,156
215152,30167_20190830212421.jpg,イオン東雲店,8000,多摩,335.0,て,2019/8/30 21:24,2-1_all_corrected,51,36,357,122,408,158
214018,30144_20190830172843.jpg,イオン幕張,4773,習志野,530.0,す,2019/8/30 17:28,2-1_all_corrected,85,65,403,344,488,409
215101,30139_20190830205837.jpg,イオン板橋ショッピングセンター,*275,川口,480.0,り,2019/8/30 20:58,2-1_all_corrected,74,64,282,317,356,381
213030,30144_20190830130321.jpg,イオン幕張,*406,習志野,580.0,そ,2019/8/30 13:02,2-1_all_corrected,63,42,160,219,223,261
215139,30145_20190830211715.jpg,イオン高根木戸,*727,習志野,343.0,さ,2019/8/30 21:16,2-1_all_corrected,72,54,307,182,379,236
213465,30078_20190830153503.jpg,イオンスタイル仙台卸町店,1664,仙台,480.0,う,2019/8/30 15:34,2-1_all_corrected,72,53,284,160,356,213
212785,30078_20190830120832.jpg,イオンスタイル仙台卸町店,1105,宮城,583.0,め,2019/8/30 12:08,2-1_all_corrected,86,59,196,238,282,297
214812,30001_20190830192936.jpg,関西スーパー高石駅前,*103,和泉,336.0,む,2019/8/30 19:29,2-1_all_corrected,96,66,393,247,489,313
214481,30139_20190830182831.jpg,イオン板橋ショッピングセンター,3900,練馬,480.0,れ,2019/8/30 18:28,2-1_all_corrected,79,64,390,342,469,406
213091,30072_20190830132554.jpg,関西スーパー京阪大和田１F,2671,滋賀,300.0,わ,2019/8/30 13:25,2-1_all_corrected,52,36,364,28,416,64
214871,30079_20190830193916.jpg,ピットデザイン仙台卸町駅前駐車場,9348,仙台,500.0,ま,2019/8/30 19:38,2-1_all_corrected,84,59,277,181,361,240
214278,30144_20190830180050.jpg,イオン幕張,3588,習志野,583.0,つ,2019/8/30 18:00,2-1_all_corrected,66,43,240,208,306,251
214427,30111_20190830181913.jpg,イオン稲毛,9374,千葉,502.0,て,2019/8/30 18:17,2-1_all_corrected,71,69,492,338,563,407
213602,30144_20190830160839.jpg,イオン幕張,*707,習志野,345.0,に,2019/8/30 16:08,2-1_all_corrected,86,59,293,313,379,372
213259,30072_20190830143042.jpg,関西スーパー京阪大和田１F,*810,大阪,544.0,ら,2019/8/30 14:30,2-1_all_corrected,55,44,344,94,399,138
215162,30139_20190830213127.jpg,イオン板橋ショッピングセンター,3900,練馬,480.0,れ,2019/8/30 21:31,2-1_all_corrected,75,60,315,336,390,396
214249,30144_20190830175630.jpg,イオン幕張,*860,千葉,331.0,て,2019/8/30 17:56,2-1_all_corrected,73,52,174,192,247,244
212976,30169_20190830124053.jpg,イオン相模原ショッピングセンター,*735,富士山,300.0,す,2019/8/30 12:40,2-1_all_corrected,80,63,301,86,381,149
213098,30144_20190830132928.jpg,イオン幕張,*904,袖ヶ浦,330.0,ち,2019/8/30 13:29,2-1_all_corrected,58,41,153,156,211,197
214010,30111_20190830172659.jpg,イオン稲毛,6004,千葉,530.0,に,2019/8/30 17:24,2-1_all_corrected,55,42,355,129,410,171
213497,30078_20190830154036.jpg,イオンスタイル仙台卸町店,9999,山形,335.0,ゆ,2019/8/30 15:40,2-1_all_corrected,66,62,153,121,219,183
215136,30103_20190830211610.jpg,八尾老原１丁目,*415,なにわ,583.0,ま,2019/8/30 21:15,2-1_all_corrected,68,53,214,191,282,244
215131,30143_20190830211348.jpg,イオン久里浜,8008,横浜,599.0,は,2019/8/30 21:13,2-1_all_corrected,41,33,407,133,448,166
214487,30137_20190830182903.jpg,イオンスタイル品川シーサイド,**33,川崎,357.0,や,2019/8/30 18:28,2-1_all_corrected,85,59,384,391,469,450
213000,30046_20190830125015.jpg,マミーマート船橋日大[地上],1031,習志野,535.0,の,2019/8/30 12:49,2-1_all_corrected,40,31,201,67,241,98
213835,30144_20190830170247.jpg,イオン幕張,1653,千葉,581.0,く,2019/8/30 17:02,2-1_all_corrected,57,40,182,150,239,190
212746,30045_20190830115405.jpg,マックスバリュー徳川明倫,1010,名古屋,31.0,も,2019/8/30 11:53,2-1_all_corrected,52,41,258,136,310,177
215107,30111_20190830210109.jpg,イオン稲毛,1958,千葉,330.0,ま,2019/8/30 21:00,2-1_all_corrected,50,37,400,122,450,159
214530,30144_20190830183523.jpg,イオン幕張,*675,習志野,501.0,せ,2019/8/30 18:34,2-1_all_corrected,75,53,233,241,308,294
214361,30111_20190830181100.jpg,イオン稲毛,5104,千葉,530.0,の,2019/8/30 18:09,2-1_all_corrected,63,42,313,152,376,194
214966,30167_20190830200736.jpg,イオン東雲店,4704,足立,481.0,り,2019/8/30 20:07,2-1_all_corrected,38,32,25,53,63,85
214992,30151_20190830201632.jpg,テックランド今福東店,*716,大阪,585.0,こ,2019/8/30 20:15,2-1_all_corrected,71,54,367,204,438,258
215249,30169_20190830225703.jpg,イオン相模原ショッピングセンター,*350,相模,337.0,は,2019/8/30 22:56,2-1_all_corrected,72,54,300,166,372,220
215028,30111_20190830202728.jpg,イオン稲毛,6036,千葉,338.0,た,2019/8/30 20:27,2-1_all_corrected,43,31,438,69,481,100
213314,30090_20190830144957.jpg,イトーヨーカドー木場 西棟,**71,習志野,332.0,ま,2019/8/30 14:49,2-1_all_corrected,54,39,323,169,377,208
214555,30167_20190830183820.jpg,イオン東雲店,1117,足立,340.0,せ,2019/8/30 18:37,2-1_all_corrected,51,39,372,250,423,289
213770,30078_20190830164658.jpg,イオンスタイル仙台卸町店,*555,仙台,581.0,か,2019/8/30 16:46,2-1_all_corrected,80,61,175,224,255,285
212656,30137_20190830112549.jpg,イオンスタイル品川シーサイド,*228,品川,342.0,ね,2019/8/30 11:25,2-1_all_corrected,75,56,206,125,281,181
214138,30169_20190830174119.jpg,イオン相模原ショッピングセンター,5884,多摩,533.0,ゆ,2019/8/30 17:40,2-1_all_corrected,58,45,176,117,234,162
214904,30111_20190830194657.jpg,イオン稲毛,7234,千葉,500.0,そ,2019/8/30 19:46,2-1_all_corrected,46,33,407,90,453,123
215019,30169_20190830202443.jpg,イオン相模原ショッピングセンター,8205,相模,300.0,ろ,2019/8/30 20:24,2-1_all_corrected,75,60,282,98,357,158
213128,30139_20190830133848.jpg,イオン板橋ショッピングセンター,*275,川口,480.0,り,2019/8/30 13:38,2-1_all_corrected,48,38,233,139,281,177
214590,30169_20190830184552.jpg,イオン相模原ショッピングセンター,3811,とちぎ,330.0,ひ,2019/8/30 18:45,2-1_all_corrected,86,72,390,319,476,391
215214,30111_20190830221533.jpg,イオン稲毛,*920,千葉,536.0,む,2019/8/30 22:14,2-1_all_corrected,41,33,80,82,121,115
213117,30001_20190830133527.jpg,関西スーパー高石駅前,3552,和泉,301.0,ち,2019/8/30 13:35,2-1_all_corrected,97,66,325,163,422,229
213325,30169_20190830145621.jpg,イオン相模原ショッピングセンター,*705,相模,335.0,す,2019/8/30 14:55,2-1_all_corrected,66,65,433,219,499,284
214735,30144_20190830191005.jpg,イオン幕張,1987,千葉,530.0,に,2019/8/30 19:09,2-1_all_corrected,74,50,279,244,353,294
212267,30163_20190830090634.jpg,コープ葛飾白鳥店(地上),***8,足立,30.0,す,2019/8/30 9:06,2-1_all_corrected,71,54,338,172,409,226
212856,30078_20190830121452.jpg,イオンスタイル仙台卸町店,4848,仙台,580.0,き,2019/8/30 12:14,2-1_all_corrected,82,58,293,230,375,288
214993,30167_20190830201657.jpg,イオン東雲店,8228,練馬,530.0,も,2019/8/30 20:16,2-1_all_corrected,50,42,324,98,374,140
214369,30111_20190830181129.jpg,イオン稲毛,1523,千葉,331.0,や,2019/8/30 18:09,2-1_all_corrected,68,53,324,162,392,215
215089,30063_20190830205241.jpg,コーナン相模原小山モール,4681,八王子,501.0,て,2019/8/30 20:52,2-1_all_corrected,79,63,472,203,551,266
214394,30111_20190830181445.jpg,イオン稲毛,1020,千葉,550.0,ち,2019/8/30 18:13,2-1_all_corrected,54,41,224,156,278,197
214969,30167_20190830200759.jpg,イオン東雲店,4704,足立,481.0,り,2019/8/30 20:07,2-1_all_corrected,67,63,122,300,189,363
213714,30045_20190830162653.jpg,マックスバリュー徳川明倫,***5,名古屋,30.0,み,2019/8/30 16:26,2-1_all_corrected,51,42,184,148,235,190
213129,30167_20190830133956.jpg,イオン東雲店,7411,足立,230.0,さ,2019/8/30 13:39,2-1_all_corrected,59,41,307,337,366,378
215018,30110_20190830202435.jpg,イオン金沢八景,*222,横浜,355.0,も,2019/8/30 20:24,2-1_all_corrected,50,42,279,64,329,106
213572,30110_20190830160144.jpg,イオン金沢八景,4020,横浜,330.0,い,2019/8/30 16:01,2-1_all_corrected,67,56,352,116,419,172
213740,30167_20190830163951.jpg,イオン東雲店,*486,足立,880.0,り,2019/8/30 16:39,2-1_all_corrected,28,34,38,33,66,67
212666,30078_20190830112814.jpg,イオンスタイル仙台卸町店,2317,仙台,530.0,た,2019/8/30 11:27,2-1_all_corrected,70,54,328,157,398,211
215027,30167_20190830202723.jpg,イオン東雲店,8228,足立,530.0,も,2019/8/30 20:26,2-1_all_corrected,86,67,150,294,236,361
215020,30169_20190830202448.jpg,イオン相模原ショッピングセンター,8205,相模,300.0,ろ,2019/8/30 20:24,2-1_all_corrected,73,57,345,53,418,110
215029,30172_20190830202732.jpg,ピットデザインすわの町,1725,熊本,-1.0,な,2019/8/30 20:26,2-1_all_corrected,32,26,502,60,534,86
213118,30078_20190830133544.jpg,イオンスタイル仙台卸町店,7881,山形,580.0,さ,2019/8/30 13:35,2-1_all_corrected,98,52,220,398,318,450
213127,30078_20190830133806.jpg,イオンスタイル仙台卸町店,*835,仙台,583.0,あ,2019/8/30 13:37,2-1_all_corrected,62,45,301,155,363,200
213315,30072_20190830145000.jpg,関西スーパー京阪大和田１F,*126,大阪,584.0,も,2019/8/30 14:49,2-1_all_corrected,72,53,81,121,153,174
214795,30114_20190830192410.jpg,イオン南行徳（立体）,2770,足立,580.0,か,2019/8/30 19:23,2-1_all_corrected,72,61,200,291,272,352
212650,30072_20190830112444.jpg,関西スーパー京阪大和田１F,1062,なにわ,100.0,い,2019/8/30 11:24,2-1_all_corrected,67,57,115,189,182,246
214571,30167_20190830184127.jpg,イオン東雲店,4726,足立,-1.0,あ,2019/8/30 18:40,2-1_all_corrected,35,31,518,128,553,159
214585,30169_20190830184518.jpg,イオン相模原ショッピングセンター,3917,多摩,580.0,の,2019/8/30 18:44,2-1_all_corrected,74,59,131,146,205,205
215201,30169_20190830220959.jpg,イオン相模原ショッピングセンター,*666,八王子,483.0,ね,2019/8/30 22:09,2-1_all_corrected,96,70,302,78,398,148
213906,30111_20190830171148.jpg,イオン稲毛,3605,袖ヶ浦,100.0,さ,2019/8/30 17:10,2-1_all_corrected,54,45,275,161,329,206
214911,30167_20190830194848.jpg,イオン東雲店,6833,品川,302.0,に,2019/8/30 19:48,2-1_all_corrected,94,55,52,394,146,449
212829,30163_20190830121314.jpg,コープ葛飾白鳥店(地上),1151,豊橋,-1.0,を,2019/8/30 12:12,2-1_all_corrected,36,31,452,380,488,411
214540,30072_20190830183706.jpg,関西スーパー京阪大和田１F,*225,大阪,586.0,ま,2019/8/30 18:36,2-1_all_corrected,67,64,0,201,67,265
213568,30111_20190830160028.jpg,イオン稲毛,3362,千葉,503.0,た,2019/8/30 15:59,2-1_all_corrected,79,58,289,227,368,285
213762,30144_20190830164522.jpg,イオン幕張,5107,習志野,530.0,に,2019/8/30 16:45,2-1_all_corrected,58,39,229,122,287,161
212476,30144_20190830103111.jpg,イオン幕張,*881,千葉,530.0,ま,2019/8/30 10:30,2-1_all_corrected,47,34,105,190,152,224
212449,30144_20190830102029.jpg,イオン幕張,3199,千葉,580.0,み,2019/8/30 10:19,2-1_all_corrected,55,38,166,172,221,210
214974,30139_20190830200931.jpg,イオン板橋ショッピングセンター,*275,川口,480.0,り,2019/8/30 20:09,2-1_all_corrected,70,59,345,238,415,297
213997,30167_20190830172511.jpg,イオン東雲店,7411,足立,230.0,さ,2019/8/30 17:24,2-1_all_corrected,69,54,348,343,417,397
213399,30167_20190830151330.jpg,イオン東雲店,7411,足立,230.0,さ,2019/8/30 15:13,2-1_all_corrected,59,42,355,349,414,391
214980,30168_20190830201222.jpg,イオン東雲店（屋上）,3696,習志野,330.0,き,2019/8/30 20:12,2-1_all_corrected,43,33,185,111,228,144
212274,30072_20190830091123.jpg,関西スーパー京阪大和田１F,**11,大阪,31.0,ま,2019/8/30 9:10,2-1_all_corrected,78,66,160,301,238,367
214389,30111_20190830181414.jpg,イオン稲毛,2601,千葉,580.0,も,2019/8/30 18:12,2-1_all_corrected,58,45,220,181,278,226
214973,30144_20190830200850.jpg,イオン幕張,3912,千葉,563.0,く,2019/8/30 20:08,2-1_all_corrected,46,47,1,196,47,243
213193,30139_20190830140548.jpg,イオン板橋ショッピングセンター,1282,越谷,480.0,り,2019/8/30 14:05,2-1_all_corrected,64,64,409,279,473,343
214342,30110_20190830180836.jpg,イオン金沢八景,*627,三重,333.0,に,2019/8/30 18:08,2-1_all_corrected,49,40,382,70,431,110
214374,30139_20190830181200.jpg,イオン板橋ショッピングセンター,*275,川口,480.0,り,2019/8/30 18:11,2-1_all_corrected,76,59,380,292,456,351
214373,30072_20190830181155.jpg,関西スーパー京阪大和田１F,7612,大阪,302.0,ぬ,2019/8/30 18:11,2-1_all_corrected,94,86,1,349,95,435
214525,30139_20190830183409.jpg,イオン板橋ショッピングセンター,5024,練馬,480.0,れ,2019/8/30 18:33,2-1_all_corrected,76,64,359,360,435,424
213763,30072_20190830164545.jpg,関西スーパー京阪大和田１F,5234,大阪,583.0,い,2019/8/30 16:44,2-1_all_corrected,94,72,26,368,120,440
213936,30144_20190830171753.jpg,イオン幕張,3214,千葉,301.0,る,2019/8/30 17:17,2-1_all_corrected,71,52,133,184,204,236
212642,30085_20190830112308.jpg,業務スーパー南津守,***5,なにわ,30.0,ひ,2019/8/30 11:22,2-1_all_corrected,51,41,437,206,488,247
215231,30079_20190830223108.jpg,ピットデザイン仙台卸町駅前駐車場,9690,宮城,-1.0,ほ,2019/8/30 22:30,2-1_all_corrected,58,42,332,139,390,181
214926,30167_20190830195250.jpg,イオン東雲店,1993,足立,330.0,ろ,2019/8/30 19:52,2-1_all_corrected,85,62,223,254,308,316
214328,30090_20190830180716.jpg,イトーヨーカドー木場 西棟,7195,練馬,501.0,ら,2019/8/30 18:06,2-1_all_corrected,55,42,277,174,332,216
212219,30072_20190830083326.jpg,関西スーパー京阪大和田１F,1724,なにわ,830.0,い,2019/8/30 8:32,2-1_all_corrected,73,55,25,169,98,224
213331,30144_20190830145738.jpg,イオン幕張,1258,千葉,80.0,あ,2019/8/30 14:57,2-1_all_corrected,54,43,160,132,214,175
212228,30167_20190830083616.jpg,イオン東雲店,7411,足立,230.0,さ,2019/8/30 8:35,2-1_all_corrected,56,42,299,318,355,360
213954,30111_20190830171924.jpg,イオン稲毛,9920,千葉,530.0,な,2019/8/30 17:17,2-1_all_corrected,55,47,183,153,238,200
214140,30045_20190830174126.jpg,マックスバリュー徳川明倫,1010,名古屋,31.0,ゆ,2019/8/30 17:40,2-1_all_corrected,69,55,206,160,275,215
214375,30072_20190830181201.jpg,関西スーパー京阪大和田１F,7612,大阪,302.0,ぬ,2019/8/30 18:11,2-1_all_corrected,78,53,402,140,480,193
214972,30144_20190830200845.jpg,イオン幕張,3912,千葉,583.0,も,2019/8/30 20:08,2-1_all_corrected,40,30,171,43,211,73
213502,30111_20190830154141.jpg,イオン稲毛,*527,千葉,334.0,る,2019/8/30 15:40,2-1_all_corrected,70,52,306,191,376,243
214981,30106_20190830201228.jpg,ジョーシン東大阪長田,*928,なにわ,335.0,な,2019/8/30 20:11,2-1_all_corrected,61,45,167,176,228,221
213996,30111_20190830172457.jpg,イオン稲毛,2331,千葉,581.0,せ,2019/8/30 17:22,2-1_all_corrected,78,59,219,227,297,286
214182,30167_20190830174614.jpg,イオン東雲店,6406,足立,500.0,え,2019/8/30 17:45,2-1_all_corrected,79,63,82,306,161,369
213013,30085_20190830125445.jpg,業務スーパー南津守,***1,なにわ,30.0,の,2019/8/30 12:54,2-1_all_corrected,54,35,235,232,289,267
213645,30060_20190830161517.jpg,関西スーパー小野原,7856,大阪,583.0,け,2019/8/30 16:14,2-1_all_corrected,84,76,476,246,560,322
212763,30111_20190830120058.jpg,イオン稲毛,9188,千葉,530.0,ね,2019/8/30 11:58,2-1_all_corrected,53,40,179,149,232,189
212307,30111_20190830092708.jpg,イオン稲毛,**88,千葉,347.0,せ,2019/8/30 9:26,2-1_all_corrected,57,42,372,161,429,203
214209,30001_20190830175133.jpg,関西スーパー高石駅前,*937,和泉,581.0,さ,2019/8/30 17:51,2-1_all_corrected,91,65,271,247,362,312
212936,30072_20190830122613.jpg,関西スーパー京阪大和田１F,*223,大阪,345.0,と,2019/8/30 12:25,2-1_all_corrected,55,45,23,88,78,133
215125,30136_20190830211030.jpg,イオンスタイル新百合ヶ丘,3993,川崎,330.0,も,2019/8/30 21:10,2-1_all_corrected,111,78,109,355,220,433
213642,30139_20190830161502.jpg,イオン板橋ショッピングセンター,1208,練馬,344.0,さ,2019/8/30 16:14,2-1_all_corrected,99,65,352,385,451,450
213817,30144_20190830170044.jpg,イオン幕張,*814,千葉,334.0,ら,2019/8/30 17:00,2-1_all_corrected,50,35,189,96,239,131
212752,30167_20190830115720.jpg,イオン東雲店,5493,品川,302.0,ね,2019/8/30 11:56,2-1_all_corrected,90,50,51,398,141,448
213479,30144_20190830153808.jpg,イオン幕張,1080,千葉,333.0,さ,2019/8/30 15:37,2-1_all_corrected,54,38,254,107,308,145
213687,30144_20190830162133.jpg,イオン幕張,*358,習志野,483.0,い,2019/8/30 16:21,2-1_all_corrected,69,54,277,218,346,272
215140,30001_20190830211737.jpg,関西スーパー高石駅前,*742,岡山,583.0,え,2019/8/30 21:17,2-1_all_corrected,89,62,228,242,317,304
214862,30157_20190830193655.jpg,関西スーパー中央,1010,神戸,31.0,ね,2019/8/30 19:36,2-1_all_corrected,55,43,200,282,255,325
215147,30139_20190830212229.jpg,イオン板橋ショッピングセンター,1282,越谷,480.0,り,2019/8/30 21:21,2-1_all_corrected,78,61,289,353,367,414
213244,30078_20190830142519.jpg,イオンスタイル仙台卸町店,1887,仙台,580.0,ひ,2019/8/30 14:24,2-1_all_corrected,73,54,188,108,261,162
215171,30169_20190830213826.jpg,イオン相模原ショッピングセンター,*666,八王子,483.0,ね,2019/8/30 21:37,2-1_all_corrected,58,42,330,260,388,302
212996,30110_20190830124730.jpg,イオン金沢八景,1966,横浜,480.0,せ,2019/8/30 12:47,2-1_all_corrected,59,43,280,150,339,193
215149,30139_20190830212329.jpg,イオン板橋ショッピングセンター,3671,練馬,480.0,れ,2019/8/30 21:23,2-1_all_corrected,78,67,276,309,354,376
214296,30167_20190830180317.jpg,イオン東雲店,4704,足立,481.0,り,2019/8/30 18:02,2-1_all_corrected,35,31,8,55,43,86
212330,30072_20190830094337.jpg,関西スーパー京阪大和田１F,**11,大阪,31.0,ま,2019/8/30 9:43,2-1_all_corrected,82,61,23,162,105,223
213216,30139_20190830141427.jpg,イオン板橋ショッピングセンター,3900,練馬,480.0,れ,2019/8/30 14:13,2-1_all_corrected,70,56,269,260,339,316
212901,30111_20190830122130.jpg,イオン稲毛,8952,千葉,502.0,ふ,2019/8/30 12:19,2-1_all_corrected,54,45,259,185,313,230
213827,30078_20190830170149.jpg,イオンスタイル仙台卸町店,1124,大宮,547.0,さ,2019/8/30 17:01,2-1_all_corrected,66,56,367,139,433,195
214034,30167_20190830173007.jpg,イオン東雲店,**21,大宮,431.0,て,2019/8/30 17:29,2-1_all_corrected,54,39,336,154,390,193
212753,30111_20190830115732.jpg,イオン稲毛,1120,千葉,533.0,つ,2019/8/30 11:56,2-1_all_corrected,54,45,266,182,320,227
212561,30132_20190830105854.jpg,イオンスタイル東神奈川,***3,横浜,585.0,る,2019/8/30 10:58,2-1_all_corrected,71,58,211,170,282,228
213471,30167_20190830153608.jpg,イオン東雲店,3730,品川,502.0,さ,2019/8/30 15:35,2-1_all_corrected,63,57,439,337,502,394
212765,30139_20190830120158.jpg,イオン板橋ショッピングセンター,5024,練馬,480.0,れ,2019/8/30 12:01,2-1_all_corrected,72,54,345,263,417,317
214459,30103_20190830182456.jpg,八尾老原１丁目,9999,大阪,31.0,む,2019/8/30 18:24,2-1_all_corrected,55,44,209,204,264,248
215123,30079_20190830211011.jpg,ピットデザイン仙台卸町駅前駐車場,*333,仙台,580.0,に,2019/8/30 21:09,2-1_all_corrected,81,71,253,330,334,401
214653,30006_20190830185507.jpg,スギ薬局南千里,2811,大阪,332.0,ふ,2019/8/30 18:55,2-1_all_corrected,90,53,367,48,457,101
214698,30001_20190830190242.jpg,関西スーパー高石駅前,3138,和泉,480.0,と,2019/8/30 19:02,2-1_all_corrected,77,60,323,186,400,246
213449,30136_20190830153221.jpg,イオンスタイル新百合ヶ丘,7404,川崎,501.0,つ,2019/8/30 15:31,2-1_all_corrected,81,64,368,52,449,116
214806,30157_20190830192824.jpg,関西スーパー中央,**77,神戸,31.0,の,2019/8/30 19:28,2-1_all_corrected,54,44,152,332,206,376
212709,30139_20190830114243.jpg,イオン板橋ショッピングセンター,*275,川口,480.0,り,2019/8/30 11:42,2-1_all_corrected,75,59,386,308,461,367
214638,30144_20190830185251.jpg,イオン幕張,***7,習志野,314.0,な,2019/8/30 18:52,2-1_all_corrected,80,60,304,290,384,350
212997,30110_20190830124832.jpg,イオン金沢八景,4699,横浜,580.0,ひ,2019/8/30 12:48,2-1_all_corrected,52,45,121,233,173,278
215177,30137_20190830214248.jpg,イオンスタイル品川シーサイド,1941,品川,332.0,り,2019/8/30 21:42,2-1_all_corrected,96,52,422,398,518,450
214435,30139_20190830182008.jpg,イオン板橋ショッピングセンター,1282,越谷,480.0,り,2019/8/30 18:19,2-1_all_corrected,69,66,409,314,478,380
214607,30144_20190830184817.jpg,イオン幕張,1118,千葉,351.0,つ,2019/8/30 18:47,2-1_all_corrected,58,42,217,156,275,198
212738,30062_20190830115245.jpg,ミスミモール,1010,神戸,31.0,と,2019/8/30 11:52,2-1_all_corrected,80,72,79,232,159,304
213289,30139_20190830144005.jpg,イオン板橋ショッピングセンター,7487,練馬,480.0,れ,2019/8/30 14:39,2-1_all_corrected,71,58,209,278,280,336
214067,30060_20190830173330.jpg,関西スーパー小野原,3406,大阪,480.0,な,2019/8/30 17:32,2-1_all_corrected,85,65,412,385,497,450
176675,30144_20190816125241.jpg,イオン幕張,8640,福岡,302,ぬ,2019/8/16 12:52,2-1_all_corrected,74,48,231,230,305,278
177798,30144_20190816200417.jpg,イオン幕張,1383,千葉,330,け,2019/8/16 20:03,2-1_all_corrected,41,31,227,23,268,54
176820,30144_20190816140225.jpg,イオン幕張,7361,習志野,501,む,2019/8/16 14:02,2-1_all_corrected,56,35,192,124,248,159
177796,30062_20190816200408.jpg,ミスミモール,1188,神戸,31,さ,2019/8/16 20:03,2-1_all_corrected,66,58,233,154,299,212
177339,30144_20190816171132.jpg,イオン幕張,9314,千葉,302,す,2019/8/16 17:11,2-1_all_corrected,54,41,149,126,203,167
176471,30014_20190816105812.jpg,フォルテ蘇我ベルク棟,**11,千葉,31,に,2019/8/16 10:57,2-1_all_corrected,70,69,7,221,77,290
177736,30078_20190816193547.jpg,イオンスタイル仙台卸町店,3034,京都,330,せ,2019/8/16 19:35,2-1_all_corrected,86,62,175,280,261,342
177300,30144_20190816165630.jpg,イオン幕張,*117,千葉,372,む,2019/8/16 16:55,2-1_all_corrected,76,55,277,258,353,313
176817,30078_20190816140036.jpg,イオンスタイル仙台卸町店,*815,仙台,430,せ,2019/8/16 14:00,2-1_all_corrected,88,60,332,285,420,345
177797,30144_20190816200412.jpg,イオン幕張,1383,千葉,330,ほ,2019/8/16 20:03,2-1_all_corrected,46,39,280,93,326,132
176819,30060_20190816140143.jpg,関西スーパー小野原,1012,大阪,548,そ,2019/8/16 14:01,2-1_all_corrected,57,42,339,121,396,163
176674,30169_20190816125217.jpg,イオン相模原ショッピングセンター,8888,相模,482,は,2019/8/16 12:51,2-1_all_corrected,86,66,243,246,329,312
177907,30111_20190816210610.jpg,イオン稲毛,9410,千葉,302,き,2019/8/16 21:05,2-1_all_corrected,42,31,433,57,475,88
177739,30144_20190816193742.jpg,イオン幕張,7755,野田,530,ろ,2019/8/16 19:37,2-1_all_corrected,77,53,211,264,288,317
177396,30045_20190816173059.jpg,マックスバリュー徳川明倫,1010,名古屋,31,ゆ,2019/8/16 17:30,2-1_all_corrected,68,52,210,146,278,198
177161,30111_20190816161155.jpg,イオン稲毛,3852,千葉,580,ま,2019/8/16 16:10,2-1_all_corrected,55,43,345,109,400,152
177192,30110_20190816161744.jpg,イオン金沢八景,1218,横浜,358,ま,2019/8/16 16:17,2-1_all_corrected,69,64,49,264,118,328
176931,30091_20190816144544.jpg,イトーヨーカドー木場 立体,4865,足立,530,す,2019/8/16 14:45,2-1_all_corrected,71,55,220,181,291,236
176909,30078_20190816143643.jpg,イオンスタイル仙台卸町店,6548,宮城,300,や,2019/8/16 14:36,2-1_all_corrected,82,57,183,190,265,247
177228,30072_20190816162957.jpg,関西スーパー京阪大和田１F,*721,大阪,345,す,2019/8/16 16:29,2-1_all_corrected,66,53,531,100,597,153
177022,30001_20190816152748.jpg,関西スーパー高石駅前,1001,和泉,570,や,2019/8/16 15:27,2-1_all_corrected,75,50,420,89,495,139
176309,30163_20190816091045.jpg,コープ葛飾白鳥店(地上),***8,足立,30,す,2019/8/16 9:10,2-1_all_corrected,71,53,321,165,392,218
177875,30111_20190816204704.jpg,イオン稲毛,5647,千葉,302,す,2019/8/16 20:46,2-1_all_corrected,50,42,116,124,166,166
177049,30144_20190816153659.jpg,イオン幕張,3226,千葉,301,ゆ,2019/8/16 15:36,2-1_all_corrected,75,51,317,274,392,325
177244,30110_20190816163459.jpg,イオン金沢八景,7089,宇都宮,330,そ,2019/8/16 16:34,2-1_all_corrected,55,44,363,112,418,156
177082,30072_20190816154834.jpg,関西スーパー京阪大和田１F,***7,大阪,30,ち,2019/8/16 15:48,2-1_all_corrected,91,76,173,223,264,299
177288,30078_20190816165232.jpg,イオンスタイル仙台卸町店,4603,仙台,580,に,2019/8/16 16:52,2-1_all_corrected,82,55,244,210,326,265
177618,30079_20190816185831.jpg,ピットデザイン仙台卸町駅前駐車場,*919,仙台,330,ひ,2019/8/16 18:58,2-1_all_corrected,56,46,285,131,341,177
177047,30072_20190816153556.jpg,関西スーパー京阪大和田１F,***7,大阪,30,ち,2019/8/16 15:35,2-1_all_corrected,76,58,270,274,346,332
176965,30070_20190816150611.jpg,カナートモール住道第一,**11,大阪,31,ま,2019/8/16 15:05,2-1_all_corrected,50,40,250,94,300,134
177424,30144_20190816174146.jpg,イオン幕張,1117,千葉,535,ら,2019/8/16 17:41,2-1_all_corrected,76,54,349,273,425,327
176791,30014_20190816135008.jpg,フォルテ蘇我ベルク棟,***3,千葉,30,ち,2019/8/16 13:49,2-1_all_corrected,56,40,114,33,170,73
177287,30001_20190816165232.jpg,関西スーパー高石駅前,3176,大阪,581,た,2019/8/16 16:52,2-1_all_corrected,81,64,393,172,474,236
178007,30079_20190816222228.jpg,ピットデザイン仙台卸町駅前駐車場,1330,仙台,530,て,2019/8/16 22:22,2-1_all_corrected,75,65,259,380,334,445
177414,30022_20190816173601.jpg,業務スーパー平野駅前,1122,なにわ,31,ぬ,2019/8/16 17:35,2-1_all_corrected,80,72,44,60,124,132
177880,30163_20190816204845.jpg,コープ葛飾白鳥店(地上),***8,足立,30,そ,2019/8/16 20:48,2-1_all_corrected,65,59,109,158,174,217
177869,30110_20190816204227.jpg,イオン金沢八景,***8,横浜,397,は,2019/8/16 20:41,2-1_all_corrected,64,58,493,130,557,188
177856,30111_20190816203758.jpg,イオン稲毛,3003,千葉,346,ひ,2019/8/16 20:37,2-1_all_corrected,57,43,267,150,324,193
177052,30144_20190816153856.jpg,イオン幕張,5325,習志野,501,み,2019/8/16 15:38,2-1_all_corrected,91,61,288,385,379,446
177867,30169_20190816204156.jpg,イオン相模原ショッピングセンター,3370,多摩,337,ま,2019/8/16 20:41,2-1_all_corrected,48,35,335,110,383,145
178013,30103_20190816222959.jpg,八尾老原１丁目,*855,なにわ,301,ひ,2019/8/16 22:29,2-1_all_corrected,58,41,296,210,354,251
177037,30144_20190816153239.jpg,イオン幕張,5123,千葉,331,ゆ,2019/8/16 15:32,2-1_all_corrected,57,38,176,173,233,211
176572,30072_20190816115220.jpg,関西スーパー京阪大和田１F,6279,姫路,300,み,2019/8/16 11:52,2-1_all_corrected,50,38,362,59,412,97
177234,30144_20190816163313.jpg,イオン幕張,2344,千葉,502,む,2019/8/16 16:32,2-1_all_corrected,51,35,191,99,242,134
177233,30001_20190816163242.jpg,関西スーパー高石駅前,*503,大阪,342,さ,2019/8/16 16:32,2-1_all_corrected,78,57,383,107,461,164
178015,30103_20190816223407.jpg,八尾老原１丁目,6146,大阪,503,ゆ,2019/8/16 22:33,2-1_all_corrected,70,51,223,203,293,254
177268,30110_20190816164640.jpg,イオン金沢八景,*227,横浜,339,に,2019/8/16 16:46,2-1_all_corrected,69,65,69,194,138,259
176976,30111_20190816151005.jpg,イオン稲毛,2950,習志野,301,み,2019/8/16 15:09,2-1_all_corrected,55,43,340,141,395,184
177868,30103_20190816204213.jpg,八尾老原１丁目,***1,大阪,30,は,2019/8/16 20:41,2-1_all_corrected,90,61,345,283,435,344
177054,30090_20190816153942.jpg,イトーヨーカドー木場 西棟,*111,足立,347,つ,2019/8/16 15:39,2-1_all_corrected,54,43,274,181,328,224
177259,30110_20190816164306.jpg,イオン金沢八景,5050,横浜,367,に,2019/8/16 16:42,2-1_all_corrected,40,31,389,121,429,152
177235,30070_20190816163323.jpg,カナートモール住道第一,**33,大宮,31,ふ,2019/8/16 16:32,2-1_all_corrected,53,41,279,99,332,140
177499,30169_20190816181329.jpg,イオン相模原ショッピングセンター,**11,多摩,377,め,2019/8/16 18:13,2-1_all_corrected,53,44,166,89,219,133
177036,30157_20190816153217.jpg,関西スーパー中央,5678,神戸,30,ら,2019/8/16 15:31,2-1_all_corrected,54,66,8,250,62,316
177376,30045_20190816172416.jpg,マックスバリュー徳川明倫,**11,名古屋,31,め,2019/8/16 17:23,2-1_all_corrected,47,38,295,122,342,160
177715,30062_20190816192821.jpg,ミスミモール,8888,神戸,30,さ,2019/8/16 19:27,2-1_all_corrected,67,57,342,152,409,209
177385,30111_20190816172705.jpg,イオン稲毛,1788,千葉,332,と,2019/8/16 17:26,2-1_all_corrected,71,54,329,134,400,188
176605,30169_20190816121233.jpg,イオン相模原ショッピングセンター,*112,多摩,301,ろ,2019/8/16 12:11,2-1_all_corrected,74,52,312,179,386,231
177186,30090_20190816161514.jpg,イトーヨーカドー木場 西棟,5975,品川,480,く,2019/8/16 16:14,2-1_all_corrected,53,39,201,189,254,228
176669,30144_20190816125027.jpg,イオン幕張,6183,千葉,502,た,2019/8/16 12:50,2-1_all_corrected,50,38,172,89,222,127
177925,30067_20190816211237.jpg,ピットデザイン茨木宮島,8008,大阪,31,て,2019/8/16 21:12,2-1_all_corrected,71,55,255,262,326,317
177126,30167_20190816160438.jpg,イオン東雲店,4482,習志野,480,れ,2019/8/16 16:04,2-1_all_corrected,41,34,28,2,69,36
177121,30111_20190816160229.jpg,イオン稲毛,1116,千葉,545,さ,2019/8/16 16:01,2-1_all_corrected,55,43,350,135,405,178
177117,30110_20190816160039.jpg,イオン金沢八景,1515,富士山,500,す,2019/8/16 16:00,2-1_all_corrected,49,43,404,78,453,121
177573,30079_20190816184015.jpg,ピットデザイン仙台卸町駅前駐車場,4626,長岡,300,め,2019/8/16 18:39,2-1_all_corrected,91,89,48,258,139,347
177741,30111_20190816193924.jpg,イオン稲毛,1375,千葉,531,ね,2019/8/16 19:38,2-1_all_corrected,70,57,399,251,469,308
176835,30060_20190816140926.jpg,関西スーパー小野原,3282,大阪,530,に,2019/8/16 14:09,2-1_all_corrected,71,58,300,299,371,357
177341,30144_20190816171348.jpg,イオン幕張,1105,習志野,536,と,2019/8/16 17:13,2-1_all_corrected,67,51,177,183,244,234
177187,30072_20190816161519.jpg,関西スーパー京阪大和田１F,1201,なにわ,584,そ,2019/8/16 16:14,2-1_all_corrected,83,71,150,169,233,240
176267,30167_20190816083250.jpg,イオン東雲店,7411,足立,230,さ,2019/8/16 8:32,2-1_all_corrected,56,40,270,293,326,333
177510,30072_20190816181608.jpg,関西スーパー京阪大和田１F,4812,大阪,583,か,2019/8/16 18:15,2-1_all_corrected,77,53,334,103,411,156
177948,30169_20190816213006.jpg,イオン相模原ショッピングセンター,**33,豊橋,367,ぬ,2019/8/16 21:29,2-1_all_corrected,65,58,232,138,297,196
177384,30111_20190816172700.jpg,イオン稲毛,3151,千葉,330,の,2019/8/16 17:26,2-1_all_corrected,53,47,205,153,258,200
177521,30062_20190816182145.jpg,ミスミモール,**18,神戸,31,ち,2019/8/16 18:21,2-1_all_corrected,50,41,422,122,472,163
177915,30157_20190816210839.jpg,関西スーパー中央,**77,神戸,31,の,2019/8/16 21:08,2-1_all_corrected,68,54,370,329,438,383
176805,30144_20190816135612.jpg,イオン幕張,1027,習志野,301,に,2019/8/16 13:55,2-1_all_corrected,59,39,225,151,284,190
176668,30006_20190816124925.jpg,スギ薬局南千里,3863,大阪,302,や,2019/8/16 12:49,2-1_all_corrected,139,120,17,200,156,320
177785,30078_20190816195849.jpg,イオンスタイル仙台卸町店,7117,仙台,332,な,2019/8/16 19:58,2-1_all_corrected,90,63,235,208,325,271
177538,30078_20190816182645.jpg,イオンスタイル仙台卸町店,8008,仙台,350,ひ,2019/8/16 18:26,2-1_all_corrected,78,54,347,295,425,349
176251,30167_20190816075952.jpg,イオン東雲店,6012,名古屋,530,ひ,2019/8/16 7:59,2-1_all_corrected,44,33,233,182,277,215
177732,30090_20190816193350.jpg,イトーヨーカドー木場 西棟,*907,品川,335,も,2019/8/16 19:33,2-1_all_corrected,81,61,279,288,360,349
176614,30072_20190816121825.jpg,関西スーパー京阪大和田１F,1906,大阪,583,う,2019/8/16 12:17,2-1_all_corrected,99,83,39,239,138,322
177190,30078_20190816161708.jpg,イオンスタイル仙台卸町店,2018,仙台,331,ら,2019/8/16 16:16,2-1_all_corrected,82,59,334,234,416,293
176883,30060_20190816142842.jpg,関西スーパー小野原,3919,大阪,581,あ,2019/8/16 14:28,2-1_all_corrected,67,67,177,225,244,292
176877,30045_20190816142657.jpg,マックスバリュー徳川明倫,**33,名古屋,31,み,2019/8/16 14:26,2-1_all_corrected,50,41,237,122,287,163
177704,30144_20190816192538.jpg,イオン幕張,1176,千葉,302,て,2019/8/16 19:25,2-1_all_corrected,60,43,186,140,246,183
176622,30078_20190816122118.jpg,イオンスタイル仙台卸町店,8324,宮城,581,ね,2019/8/16 12:20,2-1_all_corrected,82,55,223,218,305,273
176870,30167_20190816142328.jpg,イオン東雲店,6200,足立,530,な,2019/8/16 14:23,2-1_all_corrected,55,45,221,185,276,230
177956,30039_20190816213815.jpg,イトーヨーカドー大井町,8888,品川,30,す,2019/8/16 21:37,2-1_all_corrected,61,41,260,118,321,159
177358,30072_20190816171920.jpg,関西スーパー京阪大和田１F,8789,大阪,583,い,2019/8/16 17:18,2-1_all_corrected,74,53,51,149,125,202
177969,30167_20190816215152.jpg,イオン東雲店,4635,足立,481,り,2019/8/16 21:51,2-1_all_corrected,64,62,304,187,368,249
177531,30110_20190816182435.jpg,イオン金沢八景,*689,横浜,580,も,2019/8/16 18:24,2-1_all_corrected,56,42,290,82,346,124
177703,30078_20190816192534.jpg,イオンスタイル仙台卸町店,**65,仙台,583,ち,2019/8/16 19:25,2-1_all_corrected,78,58,242,211,320,269
176824,30144_20190816140442.jpg,イオン幕張,6256,千葉,301,む,2019/8/16 14:04,2-1_all_corrected,61,42,201,176,262,218
177130,30167_20190816160524.jpg,イオン東雲店,4482,習志野,480,れ,2019/8/16 16:04,2-1_all_corrected,43,36,368,108,411,144
177933,30167_20190816211628.jpg,イオン東雲店,**18,品川,398,な,2019/8/16 21:15,2-1_all_corrected,55,45,442,310,497,355
176815,30001_20190816135952.jpg,関西スーパー高石駅前,2074,和泉,581,と,2019/8/16 13:59,2-1_all_corrected,94,75,226,283,320,358
177366,30110_20190816172104.jpg,イオン金沢八景,*504,横浜,580,よ,2019/8/16 17:20,2-1_all_corrected,54,46,189,242,243,288
177392,30169_20190816172913.jpg,イオン相模原ショッピングセンター,*103,多摩,340,ら,2019/8/16 17:28,2-1_all_corrected,56,45,148,130,204,175
176411,30072_20190816102016.jpg,関西スーパー京阪大和田１F,8572,なにわ,800,す,2019/8/16 10:19,2-1_all_corrected,66,56,338,156,404,212
177760,30168_20190816194743.jpg,イオン東雲店（屋上）,*604,春日部,331,た,2019/8/16 19:47,2-1_all_corrected,70,53,348,121,418,174
177794,30169_20190816200300.jpg,イオン相模原ショッピングセンター,9158,多摩,480,ち,2019/8/16 20:02,2-1_all_corrected,84,65,249,298,333,363
176646,30169_20190816123749.jpg,イオン相模原ショッピングセンター,1962,相模,331,た,2019/8/16 12:37,2-1_all_corrected,80,58,379,155,459,213
177935,30169_20190816211652.jpg,イオン相模原ショッピングセンター,8317,相模,490,こ,2019/8/16 21:16,2-1_all_corrected,65,58,118,141,183,199
176445,30144_20190816103938.jpg,イオン幕張,**36,千葉,315,た,2019/8/16 10:39,2-1_all_corrected,75,50,352,234,427,284
176822,30144_20190816140235.jpg,イオン幕張,6286,千葉,502,ぬ,2019/8/16 14:02,2-1_all_corrected,50,37,150,83,200,120
177564,30167_20190816183837.jpg,イオン東雲店,*111,所沢,346,ろ,2019/8/16 18:38,2-1_all_corrected,67,56,438,371,505,427
176670,30111_20190816125058.jpg,イオン稲毛,***5,千葉,30,や,2019/8/16 12:50,2-1_all_corrected,59,43,331,152,390,195
176489,30090_20190816110959.jpg,イトーヨーカドー木場 西棟,7955,足立,301,ら,2019/8/16 11:09,2-1_all_corrected,87,63,249,314,336,377
177086,30078_20190816154937.jpg,イオンスタイル仙台卸町店,8215,横浜,504,む,2019/8/16 15:49,2-1_all_corrected,77,58,311,247,388,305
177849,30169_20190816203627.jpg,イオン相模原ショッピングセンター,8008,宮崎,548,え,2019/8/16 20:35,2-1_all_corrected,50,42,211,91,261,133
177623,30111_20190816190030.jpg,イオン稲毛,**22,袖ヶ浦,587,う,2019/8/16 18:59,2-1_all_corrected,96,133,502,315,598,448
177427,30110_20190816174210.jpg,イオン金沢八景,*361,横浜,530,ね,2019/8/16 17:41,2-1_all_corrected,73,60,219,156,292,216
176733,30052_20190816132812.jpg,西友市ヶ尾,***8,横浜,30,ふ,2019/8/16 13:27,2-1_all_corrected,73,57,243,251,316,308
177276,30111_20190816164828.jpg,イオン稲毛,3605,袖ヶ浦,100,さ,2019/8/16 16:46,2-1_all_corrected,56,45,256,154,312,199
177646,30090_20190816190620.jpg,イトーヨーカドー木場 西棟,5311,土浦,300,ら,2019/8/16 19:05,2-1_all_corrected,77,54,194,275,271,329
176555,30039_20190816114307.jpg,イトーヨーカドー大井町,8478,品川,330,に,2019/8/16 11:42,2-1_all_corrected,67,54,239,121,306,175
177677,30157_20190816191957.jpg,関西スーパー中央,**77,神戸,31,の,2019/8/16 19:19,2-1_all_corrected,71,54,398,355,469,409
176335,30083_20190816093100.jpg,フォーエルナゴヤドーム駅前,8000,名古屋,30,そ,2019/8/16 9:30,2-1_all_corrected,58,45,278,199,336,244
176369,30022_20190816095409.jpg,業務スーパー平野駅前,**88,なにわ,-1,ぬ,2019/8/16 9:53,2-1_all_corrected,78,63,147,75,225,138
177426,30144_20190816174208.jpg,イオン幕張,4491,足立,502,の,2019/8/16 17:41,2-1_all_corrected,63,42,163,176,226,218
177270,30167_20190816164648.jpg,イオン東雲店,7411,足立,230,さ,2019/8/16 16:46,2-1_all_corrected,54,40,320,306,374,346
176360,30167_20190816094636.jpg,イオン東雲店,7411,足立,230,さ,2019/8/16 9:46,2-1_all_corrected,57,42,326,317,383,359
176393,30110_20190816100752.jpg,イオン金沢八景,1009,品川,408,ね,2019/8/16 10:07,2-1_all_corrected,46,36,444,116,490,152
176305,30167_20190816090811.jpg,イオン東雲店,7411,足立,230,さ,2019/8/16 9:07,2-1_all_corrected,57,41,296,316,353,357
177450,30144_20190816175038.jpg,イオン幕張,***6,成田,533,の,2019/8/16 17:50,2-1_all_corrected,44,41,60,168,104,209
177492,30167_20190816181051.jpg,イオン東雲店,4482,習志野,480,れ,2019/8/16 18:10,2-1_all_corrected,66,57,341,178,407,235
177461,30144_20190816175454.jpg,イオン幕張,*933,千葉,301,は,2019/8/16 17:54,2-1_all_corrected,68,51,221,197,289,248
177263,30072_20190816164413.jpg,関西スーパー京阪大和田１F,*308,大阪,581,せ,2019/8/16 16:43,2-1_all_corrected,62,63,0,234,62,297
177051,30072_20190816153751.jpg,関西スーパー京阪大和田１F,*126,大阪,344,に,2019/8/16 15:37,2-1_all_corrected,55,36,164,125,219,161
177297,30045_20190816165538.jpg,マックスバリュー徳川明倫,*358,名古屋,32,と,2019/8/16 16:55,2-1_all_corrected,55,42,285,137,340,179
177855,30079_20190816203756.jpg,ピットデザイン仙台卸町駅前駐車場,**11,宮城,355,な,2019/8/16 20:37,2-1_all_corrected,76,63,210,242,286,305
177252,30072_20190816163913.jpg,関西スーパー京阪大和田１F,2212,大阪,580,さ,2019/8/16 16:38,2-1_all_corrected,104,83,20,315,124,398
177897,30078_20190816210214.jpg,イオンスタイル仙台卸町店,*310,仙台,584,を,2019/8/16 21:01,2-1_all_corrected,84,63,240,160,324,223
178017,30045_20190816223446.jpg,マックスバリュー徳川明倫,**33,名古屋,30,そ,2019/8/16 22:34,2-1_all_corrected,64,58,127,158,191,216
177058,30144_20190816154113.jpg,イオン幕張,9986,千葉,580,さ,2019/8/16 15:40,2-1_all_corrected,52,35,186,110,238,145
176546,30144_20190816114028.jpg,イオン幕張,1619,千葉,502,め,2019/8/16 11:40,2-1_all_corrected,55,42,150,122,205,164
176910,30144_20190816143809.jpg,イオン幕張,3691,八王子,400,わ,2019/8/16 14:37,2-1_all_corrected,60,47,122,177,182,224
177092,30167_20190816155109.jpg,イオン東雲店,7411,足立,230,さ,2019/8/16 15:50,2-1_all_corrected,51,39,290,273,341,312
176386,30083_20190816100210.jpg,フォーエルナゴヤドーム駅前,8000,名古屋,30,そ,2019/8/16 10:01,2-1_all_corrected,69,56,340,248,409,304
177095,30157_20190816155224.jpg,関西スーパー中央,5678,神戸,30,ら,2019/8/16 15:52,2-1_all_corrected,72,58,275,343,347,401
177896,30063_20190816210143.jpg,コーナン相模原小山モール,**13,相模,430,ま,2019/8/16 21:00,2-1_all_corrected,75,57,245,306,320,363
177298,30033_20190816165606.jpg,マックスバリュ南15条,8008,札幌,31,も,2019/8/16 16:55,2-1_all_corrected,92,72,431,353,523,425
176986,30132_20190816151247.jpg,イオンスタイル東神奈川,***8,横浜,30,に,2019/8/16 15:12,2-1_all_corrected,57,41,244,156,301,197
177050,30144_20190816153704.jpg,イオン幕張,2277,千葉,532,ゆ,2019/8/16 15:36,2-1_all_corrected,63,41,260,198,323,239
177122,30001_20190816160256.jpg,関西スーパー高石駅前,7788,和泉,556,む,2019/8/16 16:02,2-1_all_corrected,102,76,330,277,432,353
176800,30144_20190816135344.jpg,イオン幕張,*817,千葉,332,た,2019/8/16 13:53,2-1_all_corrected,64,42,247,234,311,276
177541,30078_20190816182745.jpg,イオンスタイル仙台卸町店,1476,仙台,501,ち,2019/8/16 18:27,2-1_all_corrected,87,63,434,375,521,438
177583,30060_20190816184453.jpg,関西スーパー小野原,1717,大阪,585,て,2019/8/16 18:44,2-1_all_corrected,69,68,480,344,549,412
177789,30144_20190816195941.jpg,イオン幕張,6579,千葉,400,の,2019/8/16 19:59,2-1_all_corrected,91,59,248,389,339,448
176664,30144_20190816124602.jpg,イオン幕張,6271,品川,400,ふ,2019/8/16 12:45,2-1_all_corrected,79,55,278,287,357,342
177943,30091_20190816212438.jpg,イトーヨーカドー木場 立体,8888,習志野,340,み,2019/8/16 21:24,2-1_all_corrected,89,69,63,355,152,424
177711,30144_20190816192741.jpg,イオン幕張,*919,千葉,336,ら,2019/8/16 19:27,2-1_all_corrected,83,60,252,290,335,350
177727,30039_20190816193107.jpg,イトーヨーカドー大井町,7333,品川,331,ま,2019/8/16 19:30,2-1_all_corrected,68,64,136,179,204,243
177515,30144_20190816181839.jpg,イオン幕張,2018,千葉,537,ら,2019/8/16 18:18,2-1_all_corrected,56,41,221,147,277,188
177344,30111_20190816171535.jpg,イオン稲毛,1000,千葉,370,む,2019/8/16 17:15,2-1_all_corrected,58,45,319,149,377,194
177975,30167_20190816215709.jpg,イオン東雲店,4635,足立,481,り,2019/8/16 21:56,2-1_all_corrected,76,64,164,326,240,390
176830,30144_20190816140643.jpg,イオン幕張,*703,千葉,549,む,2019/8/16 14:06,2-1_all_corrected,69,50,205,197,274,247
176457,30072_20190816104658.jpg,関西スーパー京阪大和田１F,9871,大阪,503,ひ,2019/8/16 10:46,2-1_all_corrected,85,64,57,181,142,245
177549,30169_20190816183001.jpg,イオン相模原ショッピングセンター,1108,相模,340,ぬ,2019/8/16 18:29,2-1_all_corrected,102,83,181,335,283,418
177582,30144_20190816184440.jpg,イオン幕張,*879,千葉,530,つ,2019/8/16 18:44,2-1_all_corrected,69,53,267,183,336,236
177918,30169_20190816210924.jpg,イオン相模原ショッピングセンター,*816,多摩,341,す,2019/8/16 21:08,2-1_all_corrected,83,70,403,308,486,378
177540,30110_20190816182657.jpg,イオン金沢八景,*874,横浜,330,ほ,2019/8/16 18:26,2-1_all_corrected,49,37,323,61,372,98
176466,30144_20190816105323.jpg,イオン幕張,*178,水戸,586,な,2019/8/16 10:52,2-1_all_corrected,81,58,228,292,309,350
176839,30062_20190816141139.jpg,ミスミモール,*330,神戸,383,て,2019/8/16 14:11,2-1_all_corrected,52,42,418,122,470,164
177547,30078_20190816182821.jpg,イオンスタイル仙台卸町店,*572,仙台,501,い,2019/8/16 18:27,2-1_all_corrected,69,62,182,145,251,207
177311,30022_20190816170206.jpg,業務スーパー平野駅前,1122,なにわ,31,ぬ,2019/8/16 17:01,2-1_all_corrected,75,68,120,61,195,129
176435,30082_20190816103421.jpg,今池ビル,***8,奈良,30,せ,2019/8/16 10:33,2-1_all_corrected,44,31,344,179,388,210
177342,30167_20190816171409.jpg,イオン東雲店,*111,足立,360,に,2019/8/16 17:13,2-1_all_corrected,51,43,445,322,496,365
177945,30098_20190816212751.jpg,BRANCH仙台（東棟）,1111,仙台,312,さ,2019/8/16 21:27,2-1_all_corrected,94,69,330,320,424,389
176897,30110_20190816143430.jpg,イオン金沢八景,4992,横浜,581,か,2019/8/16 14:34,2-1_all_corrected,52,45,76,143,128,188
176863,30072_20190816142047.jpg,関西スーパー京阪大和田１F,1123,大阪,592,く,2019/8/16 14:20,2-1_all_corrected,73,58,275,139,348,197
176864,30167_20190816142106.jpg,イオン東雲店,7411,足立,230,さ,2019/8/16 14:20,2-1_all_corrected,49,33,295,270,344,303
205363,30111_20190827184642.jpg,イオン稲毛,3633,千葉,583,せ,2019/8/27 18:46,2-1_all_corrected,54,42,125,147,179,189
204413,30144_20190827134721.jpg,イオン幕張,*331,千葉,543,ち,2019/8/27 13:46,2-1_all_corrected,53,39,177,107,230,146
204077,30110_20190827111533.jpg,イオン金沢八景,*181,横浜,583,こ,2019/8/27 11:15,2-1_all_corrected,51,40,318,44,369,84
205397,30169_20190827185559.jpg,イオン相模原ショッピングセンター,7312,相模,330,て,2019/8/27 18:55,2-1_all_corrected,55,46,121,234,176,280
204626,30091_20190827144836.jpg,イトーヨーカドー木場 立体,1234,足立,319,と,2019/8/27 14:48,2-1_all_corrected,54,39,323,133,377,172
205167,30051_20190827175438.jpg,スエヒロ館新百合ヶ丘,1001,横浜,31,つ,2019/8/27 17:54,2-1_all_corrected,59,45,254,180,313,225
205193,30144_20190827180249.jpg,イオン幕張,3939,習志野,586,け,2019/8/27 18:02,2-1_all_corrected,77,53,286,295,363,348
204227,30046_20190827122832.jpg,マミーマート船橋日大[地上],8888,習志野,349,ね,2019/8/27 12:28,2-1_all_corrected,91,79,390,164,481,243
205568,30132_20190827193901.jpg,イオンスタイル東神奈川,***8,横浜,30,に,2019/8/27 19:38,2-1_all_corrected,55,41,258,173,313,214
205339,30144_20190827183941.jpg,イオン幕張,*910,千葉,334,た,2019/8/27 18:39,2-1_all_corrected,54,40,236,114,290,154
205102,30111_20190827173834.jpg,イオン稲毛,1188,千葉,380,さ,2019/8/27 17:38,2-1_all_corrected,57,42,354,139,411,181
205595,30046_20190827194958.jpg,マミーマート船橋日大[地上],*494,習志野,501,ら,2019/8/27 19:49,2-1_all_corrected,34,29,184,34,218,63
205354,30167_20190827184407.jpg,イオン東雲店,*220,足立,302,の,2019/8/27 18:43,2-1_all_corrected,75,60,205,230,280,290
205962,30169_20190827220516.jpg,イオン相模原ショッピングセンター,9718,相模,301,ま,2019/8/27 22:04,2-1_all_corrected,82,73,434,321,516,394
205398,30072_20190827185605.jpg,関西スーパー京阪大和田１F,1323,神戸,531,ち,2019/8/27 18:55,2-1_all_corrected,39,29,351,19,390,48
204423,30145_20190827135004.jpg,イオン高根木戸,*538,習志野,583,う,2019/8/27 13:49,2-1_all_corrected,62,42,289,57,351,99
204071,30111_20190827111253.jpg,イオン稲毛,5545,千葉,330,て,2019/8/27 11:11,2-1_all_corrected,55,44,200,116,255,160
204627,30001_20190827144851.jpg,関西スーパー高石駅前,3338,滋賀,331,せ,2019/8/27 14:48,2-1_all_corrected,83,59,348,169,431,228
205150,30110_20190827175124.jpg,イオン金沢八景,**34,横浜,362,な,2019/8/27 17:51,2-1_all_corrected,75,62,213,229,288,291
204674,30046_20190827150020.jpg,マミーマート船橋日大[地上],9738,習志野,330,に,2019/8/27 15:00,2-1_all_corrected,44,33,189,55,233,88
203836,30136_20190827090850.jpg,イオンスタイル新百合ヶ丘,4979,横浜,504,て,2019/8/27 9:08,2-1_all_corrected,95,69,282,101,377,170
205799,30169_20190827211640.jpg,イオン相模原ショッピングセンター,5910,相模,583,い,2019/8/27 21:16,2-1_all_corrected,85,70,345,275,430,345
205567,30103_20190827193848.jpg,八尾老原１丁目,8008,和泉,31,す,2019/8/27 19:38,2-1_all_corrected,99,66,408,363,507,429
204819,30167_20190827154618.jpg,イオン東雲店,7411,足立,230,さ,2019/8/27 15:45,2-1_all_corrected,53,39,314,295,367,334
205558,30111_20190827193530.jpg,イオン稲毛,5000,千葉,506,は,2019/8/27 19:34,2-1_all_corrected,43,31,423,61,466,92
205763,30145_20190827205725.jpg,イオン高根木戸,3985,習志野,580,せ,2019/8/27 20:57,2-1_all_corrected,50,38,334,152,384,190
204014,30169_20190827105140.jpg,イオン相模原ショッピングセンター,7382,相模,480,こ,2019/8/27 10:51,2-1_all_corrected,99,75,128,113,227,188
205764,30167_20190827205753.jpg,イオン東雲店,6316,練馬,500,う,2019/8/27 20:57,2-1_all_corrected,88,66,73,374,161,440
204195,30111_20190827120820.jpg,イオン稲毛,1005,所沢,536,ら,2019/8/27 12:07,2-1_all_corrected,60,45,335,162,395,207
205076,30078_20190827172924.jpg,イオンスタイル仙台卸町店,**88,仙台,583,ひ,2019/8/27 17:28,2-1_all_corrected,82,57,325,279,407,336
205244,30138_20190827181738.jpg,イオンスタイル湘南茅ヶ崎,6129,多摩,400,に,2019/8/27 18:17,2-1_all_corrected,59,41,234,142,293,183
204907,30167_20190827162022.jpg,イオン東雲店,7411,足立,230,さ,2019/8/27 16:20,2-1_all_corrected,54,38,306,296,360,334
203921,30060_20190827100220.jpg,関西スーパー小野原,1027,大阪,538,つ,2019/8/27 10:01,2-1_all_corrected,68,68,524,276,592,344
204936,30072_20190827163455.jpg,関西スーパー京阪大和田１F,6189,大阪,502,る,2019/8/27 16:33,2-1_all_corrected,96,74,56,376,152,450
205470,30167_20190827191226.jpg,イオン東雲店,8115,越谷,503,い,2019/8/27 19:12,2-1_all_corrected,47,34,320,130,367,164
205484,30111_20190827191429.jpg,イオン稲毛,1510,千葉,532,け,2019/8/27 19:13,2-1_all_corrected,54,40,142,133,196,173
205413,30169_20190827185826.jpg,イオン相模原ショッピングセンター,**37,相模,333,な,2019/8/27 18:57,2-1_all_corrected,68,63,354,245,422,308
204955,30111_20190827164138.jpg,イオン稲毛,8071,千葉,330,ち,2019/8/27 16:40,2-1_all_corrected,71,55,320,143,391,198
203747,30072_20190827081018.jpg,関西スーパー京阪大和田１F,3022,奈良,830,あ,2019/8/27 8:09,2-1_all_corrected,65,60,225,158,290,218
205422,30144_20190827185918.jpg,イオン幕張,*322,千葉,331,ね,2019/8/27 18:58,2-1_all_corrected,91,64,257,339,348,403
204158,30066_20190827115611.jpg,ジョーシン和泉中央,***3,和泉,30,ゆ,2019/8/27 11:55,2-1_all_corrected,54,41,259,195,313,236
204990,30144_20190827170007.jpg,イオン幕張,**20,春日部,336,そ,2019/8/27 16:59,2-1_all_corrected,77,56,182,217,259,273
205273,30072_20190827182311.jpg,関西スーパー京阪大和田１F,3636,豊橋,531,ゆ,2019/8/27 18:22,2-1_all_corrected,71,53,332,102,403,155
204133,30062_20190827114120.jpg,ミスミモール,*123,神戸,31,ぬ,2019/8/27 11:40,2-1_all_corrected,84,64,290,206,374,270
205218,30159_20190827180901.jpg,イオン臼井,9021,千葉,330,と,2019/8/27 18:08,2-1_all_corrected,54,45,254,143,308,188
204762,30111_20190827152622.jpg,イオン稲毛,4013,千葉,502,ゆ,2019/8/27 15:25,2-1_all_corrected,73,54,391,147,464,201
204937,30144_20190827163541.jpg,イオン幕張,1103,千葉,554,ら,2019/8/27 16:35,2-1_all_corrected,46,33,216,59,262,92
203916,30045_20190827095757.jpg,マックスバリュー徳川明倫,**33,名古屋,31,も,2019/8/27 9:57,2-1_all_corrected,56,44,256,177,312,221
204595,30046_20190827144151.jpg,マミーマート船橋日大[地上],7793,習志野,530,な,2019/8/27 14:41,2-1_all_corrected,51,34,245,68,296,102
203911,30045_20190827095555.jpg,マックスバリュー徳川明倫,8008,名古屋,31,さ,2019/8/27 9:55,2-1_all_corrected,68,55,249,153,317,208
205039,30070_20190827171756.jpg,カナートモール住道第一,***8,大阪,30,ま,2019/8/27 17:17,2-1_all_corrected,57,36,222,127,279,163
205650,30110_20190827200809.jpg,イオン金沢八景,7074,横浜,301,ろ,2019/8/27 20:07,2-1_all_corrected,51,41,319,91,370,132
204915,30091_20190827162307.jpg,イトーヨーカドー木場 立体,5885,足立,331,さ,2019/8/27 16:22,2-1_all_corrected,53,44,270,59,323,103
205202,30078_20190827180426.jpg,イオンスタイル仙台卸町店,*615,湘南,335,ほ,2019/8/27 18:03,2-1_all_corrected,75,54,257,115,332,169
204111,30167_20190827113225.jpg,イオン東雲店,***3,横浜,30,ち,2019/8/27 11:32,2-1_all_corrected,56,42,313,159,369,201
205205,30144_20190827180502.jpg,イオン幕張,1225,千葉,351,も,2019/8/27 18:04,2-1_all_corrected,94,61,216,316,310,377
205063,30060_20190827172518.jpg,関西スーパー小野原,3406,大阪,480,な,2019/8/27 17:24,2-1_all_corrected,87,66,448,382,535,448
205438,30110_20190827190538.jpg,イオン金沢八景,*612,つくば,333,ひ,2019/8/27 19:05,2-1_all_corrected,69,58,424,215,493,273
204189,30144_20190827120415.jpg,イオン幕張,1212,千葉,564,ゆ,2019/8/27 12:03,2-1_all_corrected,54,41,211,118,265,159
205260,30111_20190827182110.jpg,イオン稲毛,4730,千葉,302,そ,2019/8/27 18:20,2-1_all_corrected,67,59,279,165,346,224
204174,30167_20190827120112.jpg,イオン東雲店,4505,足立,481,り,2019/8/27 12:00,2-1_all_corrected,49,41,331,152,380,193
204722,30091_20190827151515.jpg,イトーヨーカドー木場 立体,3968,足立,57,ろ,2019/8/27 15:14,2-1_all_corrected,54,42,245,185,299,227
204173,30168_20190827120105.jpg,イオン東雲店（屋上）,7995,足立,332,の,2019/8/27 12:00,2-1_all_corrected,80,78,520,270,600,348
205267,30144_20190827182146.jpg,イオン幕張,2324,千葉,583,え,2019/8/27 18:21,2-1_all_corrected,84,61,366,320,450,381
204970,30167_20190827165146.jpg,イオン東雲店,1005,成田,531,み,2019/8/27 16:51,2-1_all_corrected,57,45,254,185,311,230
205499,30167_20190827191905.jpg,イオン東雲店,5697,足立,331,め,2019/8/27 19:18,2-1_all_corrected,68,53,410,342,478,395
204110,30045_20190827113049.jpg,マックスバリュー徳川明倫,*358,名古屋,32,と,2019/8/27 11:30,2-1_all_corrected,82,74,19,305,101,379
204128,30144_20190827113841.jpg,イオン幕張,1000,千葉,368,ら,2019/8/27 11:38,2-1_all_corrected,55,42,132,129,187,171
203935,30062_20190827101212.jpg,ミスミモール,***5,神戸,30,に,2019/8/27 10:11,2-1_all_corrected,54,42,402,137,456,179
204545,30106_20190827142712.jpg,ジョーシン東大阪長田,1122,大阪,31,た,2019/8/27 14:26,2-1_all_corrected,74,57,255,170,329,227
205464,30169_20190827191023.jpg,イオン相模原ショッピングセンター,***5,多摩,30,な,2019/8/27 19:09,2-1_all_corrected,52,43,160,112,212,155
204314,30111_20190827131357.jpg,イオン稲毛,2478,千葉,330,そ,2019/8/27 13:13,2-1_all_corrected,69,56,369,231,438,287
204985,30045_20190827165647.jpg,マックスバリュー徳川明倫,**18,名古屋,31,や,2019/8/27 16:56,2-1_all_corrected,69,64,26,265,95,329
205259,30045_20190827182107.jpg,マックスバリュー徳川明倫,**22,名古屋,31,る,2019/8/27 18:20,2-1_all_corrected,69,55,175,176,244,231
204971,30046_20190827165212.jpg,マミーマート船橋日大[地上],1916,とちぎ,500,も,2019/8/27 16:51,2-1_all_corrected,49,40,246,92,295,132
204181,30136_20190827120241.jpg,イオンスタイル新百合ヶ丘,8431,川崎,580,い,2019/8/27 12:02,2-1_all_corrected,82,63,178,279,260,342
204715,30063_20190827151311.jpg,コーナン相模原小山モール,1001,横浜,31,る,2019/8/27 15:12,2-1_all_corrected,75,54,118,237,193,291
205091,30169_20190827173426.jpg,イオン相模原ショッピングセンター,3983,多摩,502,た,2019/8/27 17:24,2-1_all_corrected,78,60,311,99,389,159
205268,30078_20190827182149.jpg,イオンスタイル仙台卸町店,*726,仙台,330,ろ,2019/8/27 18:21,2-1_all_corrected,57,40,239,48,296,88
205406,30006_20190827185650.jpg,スギ薬局南千里,*168,横浜,583,ひ,2019/8/27 18:56,2-1_all_corrected,86,56,274,22,360,78
205250,30111_20190827181908.jpg,イオン稲毛,4863,千葉,301,ね,2019/8/27 18:18,2-1_all_corrected,44,36,83,81,127,117
205096,30144_20190827173700.jpg,イオン幕張,8625,千葉,583,く,2019/8/27 17:36,2-1_all_corrected,89,66,243,355,332,421
205779,30111_20190827210820.jpg,イオン稲毛,*519,袖ヶ浦,430,て,2019/8/27 21:07,2-1_all_corrected,72,56,322,190,394,246
204658,30110_20190827145614.jpg,イオン金沢八景,3127,横浜,530,み,2019/8/27 14:55,2-1_all_corrected,49,37,412,127,461,164
204455,30111_20190827135902.jpg,イオン稲毛,1950,千葉,583,や,2019/8/27 13:58,2-1_all_corrected,53,42,189,162,242,204
204038,30144_20190827110330.jpg,イオン幕張,2020,千葉,334,む,2019/8/27 11:03,2-1_all_corrected,57,41,127,105,184,146
205121,30144_20190827174320.jpg,イオン幕張,1179,千葉,530,の,2019/8/27 17:42,2-1_all_corrected,76,57,310,253,386,310
204669,30078_20190827145926.jpg,イオンスタイル仙台卸町店,3295,秋田,330,る,2019/8/27 14:58,2-1_all_corrected,47,50,151,65,198,115
203814,30167_20190827085831.jpg,イオン東雲店,1964,練馬,400,ぬ,2019/8/27 8:58,2-1_all_corrected,68,52,226,203,294,255
204464,30136_20190827140001.jpg,イオンスタイル新百合ヶ丘,2024,多摩,583,こ,2019/8/27 13:59,2-1_all_corrected,43,47,119,184,162,231
204266,30111_20190827124616.jpg,イオン稲毛,*358,習志野,342,や,2019/8/27 12:44,2-1_all_corrected,67,57,409,226,476,283
205172,30136_20190827175504.jpg,イオンスタイル新百合ヶ丘,8170,川崎,330,な,2019/8/27 17:54,2-1_all_corrected,110,79,160,183,270,262
204261,30136_20190827124458.jpg,イオンスタイル新百合ヶ丘,8205,川崎,301,す,2019/8/27 12:44,2-1_all_corrected,88,63,391,92,479,155
205715,30167_20190827203449.jpg,イオン東雲店,1993,品川,332,る,2019/8/27 20:34,2-1_all_corrected,89,53,110,395,199,448
204268,30110_20190827124636.jpg,イオン金沢八景,3202,横浜,505,ち,2019/8/27 12:46,2-1_all_corrected,51,48,74,242,125,290
205588,30046_20190827194742.jpg,マミーマート船橋日大[地上],*175,習志野,300,ね,2019/8/27 19:47,2-1_all_corrected,55,46,360,153,415,199
203815,30167_20190827085854.jpg,イオン東雲店,1964,練馬,400,ぬ,2019/8/27 8:58,2-1_all_corrected,68,52,226,203,294,255
205127,30144_20190827174356.jpg,イオン幕張,6269,千葉,310,ち,2019/8/27 17:43,2-1_all_corrected,38,35,387,47,425,82
205315,30078_20190827183310.jpg,イオンスタイル仙台卸町店,***1,仙台,335,な,2019/8/27 18:32,2-1_all_corrected,85,58,207,221,292,279
204030,30167_20190827110016.jpg,イオン東雲店,4822,足立,301,す,2019/8/27 10:59,2-1_all_corrected,83,64,0,386,83,450
205324,30111_20190827183609.jpg,イオン稲毛,9885,千葉,530,な,2019/8/27 18:35,2-1_all_corrected,61,43,332,131,393,174
205747,30157_20190827204818.jpg,関西スーパー中央,*314,神戸,547,た,2019/8/27 20:47,2-1_all_corrected,70,54,257,357,327,411
204453,30046_20190827135849.jpg,マミーマート船橋日大[地上],4063,習志野,580,ぬ,2019/8/27 13:58,2-1_all_corrected,41,31,174,91,215,122
204205,30169_20190827121440.jpg,イオン相模原ショッピングセンター,2014,相模,532,は,2019/8/27 12:14,2-1_all_corrected,56,47,211,119,267,166
205714,30111_20190827203333.jpg,イオン稲毛,1020,千葉,590,て,2019/8/27 20:32,2-1_all_corrected,60,45,202,166,262,211
204293,30144_20190827130023.jpg,イオン幕張,*622,千葉,336,に,2019/8/27 13:00,2-1_all_corrected,49,39,139,91,188,130
204431,30078_20190827135436.jpg,イオンスタイル仙台卸町店,**12,仙台,585,け,2019/8/27 13:54,2-1_all_corrected,77,60,163,221,240,281
204258,30167_20190827124409.jpg,イオン東雲店,**54,越谷,200,さ,2019/8/27 12:43,2-1_all_corrected,96,61,116,389,212,450
204223,30006_20190827122536.jpg,スギ薬局南千里,3330,大阪,581,な,2019/8/27 12:25,2-1_all_corrected,133,115,8,138,141,253
205553,30169_20190827193426.jpg,イオン相模原ショッピングセンター,*200,福井,483,く,2019/8/27 19:34,2-1_all_corrected,89,70,298,314,387,384
204481,30111_20190827140620.jpg,イオン稲毛,*629,千葉,334,ら,2019/8/27 14:05,2-1_all_corrected,67,56,269,162,336,218
205130,30144_20190827174537.jpg,イオン幕張,7000,千葉,326,め,2019/8/27 17:45,2-1_all_corrected,78,49,212,215,290,264
205106,30144_20190827173916.jpg,イオン幕張,1920,千葉,331,ひ,2019/8/27 17:38,2-1_all_corrected,82,57,252,294,334,351
204676,30137_20190827150043.jpg,イオンスタイル品川シーサイド,1011,品川,362,の,2019/8/27 15:00,2-1_all_corrected,86,66,448,314,534,380
205591,30072_20190827194900.jpg,関西スーパー京阪大和田１F,8877,大阪,333,ゆ,2019/8/27 19:48,2-1_all_corrected,99,81,73,272,172,353
205101,30110_20190827173812.jpg,イオン金沢八景,*504,横浜,500,よ,2019/8/27 17:37,2-1_all_corrected,53,39,372,121,425,160
205358,30120_20190827184443.jpg,イオン長浦（第１・第２）,*119,袖ヶ浦,583,は,2019/8/27 18:44,2-1_all_corrected,64,60,185,214,249,274
204625,30072_20190827144833.jpg,関西スーパー京阪大和田１F,1841,大阪,581,た,2019/8/27 14:48,2-1_all_corrected,40,28,300,9,340,37
205199,30078_20190827180402.jpg,イオンスタイル仙台卸町店,9037,仙台,300,は,2019/8/27 18:03,2-1_all_corrected,73,55,346,139,419,194
205152,30144_20190827175153.jpg,イオン幕張,6866,千葉,580,も,2019/8/27 17:51,2-1_all_corrected,40,42,171,147,211,189
205164,30046_20190827175359.jpg,マミーマート船橋日大[地上],7475,習志野,330,ち,2019/8/27 17:53,2-1_all_corrected,45,33,168,29,213,62
204042,30001_20190827110520.jpg,関西スーパー高石駅前,***8,和泉,30,ら,2019/8/27 11:05,2-1_all_corrected,45,35,321,1,366,36
205100,30167_20190827173751.jpg,イオン東雲店,**21,大宮,431,て,2019/8/27 17:37,2-1_all_corrected,83,61,128,307,211,368
204225,30167_20190827122600.jpg,イオン東雲店,3009,足立,481,り,2019/8/27 12:25,2-1_all_corrected,47,39,297,157,344,196
205935,30167_20190827215010.jpg,イオン東雲店,4127,品川,501,ほ,2019/8/27 21:49,2-1_all_corrected,84,70,56,298,140,368
204420,30167_20190827134940.jpg,イオン東雲店,*163,春日部,534,る,2019/8/27 13:49,2-1_all_corrected,87,62,45,388,132,450
204276,30078_20190827125243.jpg,イオンスタイル仙台卸町店,1677,高崎,480,う,2019/8/27 12:52,2-1_all_corrected,74,54,242,145,316,199
205165,30144_20190827175411.jpg,イオン幕張,6950,千葉,530,た,2019/8/27 17:53,2-1_all_corrected,61,43,229,201,290,244
204849,30144_20190827155300.jpg,イオン幕張,*930,千葉,339,ふ,2019/8/27 15:52,2-1_all_corrected,77,53,230,225,307,278
204081,30062_20190827111740.jpg,ミスミモール,5678,神戸,30,ね,2019/8/27 11:17,2-1_all_corrected,85,77,67,259,152,336
205214,30169_20190827180732.jpg,イオン相模原ショッピングセンター,*902,相模,580,と,2019/8/27 18:07,2-1_all_corrected,85,74,456,311,541,385
205442,30157_20190827190623.jpg,関西スーパー中央,2702,神戸,531,て,2019/8/27 19:05,2-1_all_corrected,46,31,112,107,158,138
205445,30039_20190827190635.jpg,イトーヨーカドー大井町,1888,品川,583,き,2019/8/27 19:06,2-1_all_corrected,68,68,119,138,187,206
205213,30139_20190827180704.jpg,イオン板橋ショッピングセンター,1212,練馬,341,て,2019/8/27 18:06,2-1_all_corrected,53,42,260,185,313,227
204131,30144_20190827114022.jpg,イオン幕張,1246,千葉,530,ま,2019/8/27 11:39,2-1_all_corrected,56,42,186,170,242,212
205480,30078_20190827191349.jpg,イオンスタイル仙台卸町店,*263,仙台,500,ろ,2019/8/27 19:13,2-1_all_corrected,82,57,324,293,406,350
205010,30078_20190827170748.jpg,イオンスタイル仙台卸町店,2545,仙台,580,の,2019/8/27 17:07,2-1_all_corrected,77,54,247,183,324,237
206008,30167_20190827224640.jpg,イオン東雲店,3939,習志野,336,る,2019/8/27 22:46,2-1_all_corrected,68,55,418,374,486,429
205249,30046_20190827181902.jpg,マミーマート船橋日大[地上],*338,習志野,331,む,2019/8/27 18:18,2-1_all_corrected,36,28,176,60,212,88
204196,30078_20190827120825.jpg,イオンスタイル仙台卸町店,***3,仙台,586,ゆ,2019/8/27 12:08,2-1_all_corrected,75,54,213,137,288,191
203971,30144_20190827103050.jpg,イオン幕張,3199,千葉,580,み,2019/8/27 10:30,2-1_all_corrected,51,40,167,126,218,166
205271,30144_20190827182218.jpg,イオン幕張,*313,習志野,335,ろ,2019/8/27 18:21,2-1_all_corrected,60,43,256,177,316,220
205427,30046_20190827190137.jpg,マミーマート船橋日大[地上],*821,習志野,534,む,2019/8/27 19:01,2-1_all_corrected,39,31,134,29,173,60
204357,30136_20190827132513.jpg,イオンスタイル新百合ヶ丘,1348,横浜,580,ね,2019/8/27 13:24,2-1_all_corrected,67,60,318,145,385,205
205411,30169_20190827185820.jpg,イオン相模原ショッピングセンター,**37,相模,333,な,2019/8/27 18:57,2-1_all_corrected,45,41,217,125,262,166
205416,30169_20190827185853.jpg,イオン相模原ショッピングセンター,1012,多摩,349,さ,2019/8/27 18:58,2-1_all_corrected,92,77,383,350,475,427
205475,30144_20190827191319.jpg,イオン幕張,1081,千葉,581,か,2019/8/27 19:12,2-1_all_corrected,45,33,171,80,216,113
205812,30169_20190827212335.jpg,イオン相模原ショッピングセンター,9380,相模,580,や,2019/8/27 21:23,2-1_all_corrected,82,62,263,133,345,195
204598,30060_20190827144358.jpg,関西スーパー小野原,***7,大阪,536,は,2019/8/27 14:43,2-1_all_corrected,68,59,361,255,429,314
205678,30169_20190827201939.jpg,イオン相模原ショッピングセンター,3311,相模,331,は,2019/8/27 20:19,2-1_all_corrected,101,84,189,226,290,310
205486,30111_20190827191440.jpg,イオン稲毛,6672,千葉,530,に,2019/8/27 19:13,2-1_all_corrected,60,44,355,141,415,185
205224,30078_20190827181033.jpg,イオンスタイル仙台卸町店,7934,仙台,580,つ,2019/8/27 18:10,2-1_all_corrected,71,58,165,112,236,170
205472,30137_20190827191251.jpg,イオンスタイル品川シーサイド,4645,足立,301,み,2019/8/27 19:12,2-1_all_corrected,78,58,126,145,204,203
206007,30167_20190827224634.jpg,イオン東雲店,3939,習志野,336,る,2019/8/27 22:46,2-1_all_corrected,58,45,350,319,408,364
204139,30072_20190827114409.jpg,関西スーパー京阪大和田１F,5055,大阪,531,せ,2019/8/27 11:42,2-1_all_corrected,102,84,54,262,156,346
205649,30110_20190827200804.jpg,イオン金沢八景,7074,横浜,301,ろ,2019/8/27 20:07,2-1_all_corrected,76,72,39,224,115,296
204902,30046_20190827161742.jpg,マミーマート船橋日大[地上],1054,習志野,330,ぬ,2019/8/27 16:17,2-1_all_corrected,41,30,155,59,196,89
205488,30046_20190827191516.jpg,マミーマート船橋日大[地上],**77,習志野,386,つ,2019/8/27 19:14,2-1_all_corrected,65,56,297,108,362,164
204969,30111_20190827165122.jpg,イオン稲毛,**77,千葉,357,の,2019/8/27 16:50,2-1_all_corrected,52,43,315,177,367,220
205279,30022_20190827182432.jpg,業務スーパー平野駅前,**11,大阪,31,な,2019/8/27 18:23,2-1_all_corrected,95,87,8,235,103,322
205089,30091_20190827173416.jpg,イトーヨーカドー木場 立体,3968,足立,57,ろ,2019/8/27 17:33,2-1_all_corrected,74,55,300,142,374,197
204732,30144_20190827152027.jpg,イオン幕張,9852,千葉,503,せ,2019/8/27 15:19,2-1_all_corrected,58,41,264,150,322,191
204958,30103_20190827164418.jpg,八尾老原１丁目,1001,大阪,31,み,2019/8/27 16:43,2-1_all_corrected,90,68,328,273,418,341
205426,30070_20190827190110.jpg,カナートモール住道第一,***2,大阪,30,も,2019/8/27 19:00,2-1_all_corrected,79,61,67,246,146,307
205277,30167_20190827182401.jpg,イオン東雲店,*801,足立,335,に,2019/8/27 18:23,2-1_all_corrected,40,32,400,56,440,88
205058,30111_20190827172323.jpg,イオン稲毛,3605,袖ヶ浦,100,さ,2019/8/27 17:21,2-1_all_corrected,68,57,291,169,359,226
204146,30072_20190827114712.jpg,関西スーパー京阪大和田１F,**87,大阪,342,つ,2019/8/27 11:46,2-1_all_corrected,68,53,56,125,124,178
205299,30167_20190827182950.jpg,イオン東雲店,4704,足立,481,り,2019/8/27 18:29,2-1_all_corrected,79,68,101,380,180,448
203952,30001_20190827101943.jpg,関西スーパー高石駅前,*523,和泉,534,ら,2019/8/27 10:19,2-1_all_corrected,101,74,174,319,275,393
204170,30167_20190827120035.jpg,イオン東雲店,4505,足立,481,り,2019/8/27 12:00,2-1_all_corrected,36,32,48,42,84,74
204973,30139_20190827165340.jpg,イオン板橋ショッピングセンター,***1,練馬,30,ね,2019/8/27 16:53,2-1_all_corrected,56,45,273,216,329,261
204719,30078_20190827151457.jpg,イオンスタイル仙台卸町店,***5,仙台,351,か,2019/8/27 15:14,2-1_all_corrected,52,36,271,81,323,117
204177,30167_20190827120143.jpg,イオン東雲店,7995,足立,302,の,2019/8/27 12:01,2-1_all_corrected,83,61,136,274,219,335
205297,30072_20190827182922.jpg,関西スーパー京阪大和田１F,7692,大阪,581,の,2019/8/27 18:27,2-1_all_corrected,97,72,126,359,223,431
205698,30104_20190827202626.jpg,カスミフードスクエア咲が丘,***2,習志野,332,ら,2019/8/27 20:25,2-1_all_corrected,81,54,269,364,350,418
204781,30137_20190827153541.jpg,イオンスタイル品川シーサイド,8393,水戸,301,ほ,2019/8/27 15:35,2-1_all_corrected,77,57,137,143,214,200
205005,30070_20190827170500.jpg,カナートモール住道第一,***2,大阪,30,も,2019/8/27 17:04,2-1_all_corrected,43,36,210,87,253,123
203930,30144_20190827100807.jpg,イオン幕張,1112,習志野,341,と,2019/8/27 10:07,2-1_all_corrected,70,51,207,183,277,234
205239,30144_20190827181556.jpg,イオン幕張,1571,千葉,581,き,2019/8/27 18:15,2-1_all_corrected,87,63,259,348,346,411
205696,30167_20190827202534.jpg,イオン東雲店,2538,品川,302,み,2019/8/27 20:25,2-1_all_corrected,76,57,121,283,197,340
205450,30144_20190827190824.jpg,イオン幕張,1102,千葉,319,ひ,2019/8/27 19:07,2-1_all_corrected,44,33,215,49,259,82
205457,30144_20190827190908.jpg,イオン幕張,**77,千葉,567,さ,2019/8/27 19:08,2-1_all_corrected,86,64,336,345,422,409
205296,30072_20190827182908.jpg,関西スーパー京阪大和田１F,8918,大阪,581,ね,2019/8/27 18:28,2-1_all_corrected,38,73,0,341,38,414
204512,30132_20190827142106.jpg,イオンスタイル東神奈川,9789,横浜,480,た,2019/8/27 14:20,2-1_all_corrected,77,65,171,374,248,439
205262,30063_20190827182119.jpg,コーナン相模原小山モール,***5,多摩,30,は,2019/8/27 18:20,2-1_all_corrected,72,57,73,239,145,296
205639,30135_20190827200517.jpg,イオン西新井,*710,春日部,483,さ,2019/8/27 20:04,2-1_all_corrected,55,46,205,177,260,223
205057,30157_20190827172244.jpg,関西スーパー中央,*626,神戸,586,く,2019/8/27 17:22,2-1_all_corrected,45,76,510,221,555,297
205265,30078_20190827182135.jpg,イオンスタイル仙台卸町店,5965,仙台,580,と,2019/8/27 18:21,2-1_all_corrected,100,69,206,373,306,442
205601,30045_20190827195207.jpg,マックスバリュー徳川明倫,***3,名古屋,30,る,2019/8/27 19:51,2-1_all_corrected,75,66,20,281,95,347
205061,30144_20190827172358.jpg,イオン幕張,4129,千葉,581,い,2019/8/27 17:23,2-1_all_corrected,55,42,197,156,252,198
203998,30111_20190827104449.jpg,イオン稲毛,***7,袖ヶ浦,356,て,2019/8/27 10:44,2-1_all_corrected,66,57,449,208,515,265
205253,30144_20190827182018.jpg,イオン幕張,*373,成田,331,ま,2019/8/27 18:19,2-1_all_corrected,77,53,274,237,351,290
205095,30078_20190827173622.jpg,イオンスタイル仙台卸町店,*520,仙台,330,ひ,2019/8/27 17:36,2-1_all_corrected,53,45,329,85,382,130
205809,30145_20190827212038.jpg,イオン高根木戸,*717,習志野,341,と,2019/8/27 21:20,2-1_all_corrected,67,64,466,219,533,283
204745,30167_20190827152204.jpg,イオン東雲店,*207,品川,334,ぬ,2019/8/27 15:21,2-1_all_corrected,57,43,327,302,384,345
205458,30169_20190827190920.jpg,イオン相模原ショッピングセンター,8889,相模,580,ゆ,2019/8/27 19:08,2-1_all_corrected,85,70,333,322,418,392
204926,30132_20190827162825.jpg,イオンスタイル東神奈川,1038,横浜,581,か,2019/8/27 16:28,2-1_all_corrected,57,43,357,194,414,237
203931,30066_20190827100851.jpg,ジョーシン和泉中央,***5,和泉,30,み,2019/8/27 10:08,2-1_all_corrected,67,56,207,171,274,227
205494,30046_20190827191731.jpg,マミーマート船橋日大[地上],2101,習志野,530,り,2019/8/27 19:17,2-1_all_corrected,41,32,242,31,283,63
205460,30144_20190827190933.jpg,イオン幕張,8505,習志野,301,ひ,2019/8/27 19:09,2-1_all_corrected,80,54,234,225,314,279
205176,30136_20190827175529.jpg,イオンスタイル新百合ヶ丘,7297,川崎,301,そ,2019/8/27 17:55,2-1_all_corrected,81,62,437,69,518,131
205975,30137_20190827222022.jpg,イオンスタイル品川シーサイド,7788,品川,324,ら,2019/8/27 21:22,2-1_all_corrected,77,58,166,138,243,196
205185,30111_20190827175827.jpg,イオン稲毛,**85,千葉,584,あ,2019/8/27 17:57,2-1_all_corrected,54,42,298,144,352,186
205523,30137_20190827192558.jpg,イオンスタイル品川シーサイド,5395,岐阜,300,ろ,2019/8/27 19:25,2-1_all_corrected,58,45,189,68,247,113
205944,30169_20190827215304.jpg,イオン相模原ショッピングセンター,6862,多摩,580,ね,2019/8/27 21:52,2-1_all_corrected,56,45,148,160,204,205
204092,30078_20190827112103.jpg,イオンスタイル仙台卸町店,9119,仙台,530,そ,2019/8/27 11:20,2-1_all_corrected,91,67,382,357,473,424
204059,30144_20190827111013.jpg,イオン幕張,6782,千葉,502,は,2019/8/27 11:09,2-1_all_corrected,61,40,185,153,246,193
205319,30144_20190827183519.jpg,イオン幕張,6571,習志野,583,い,2019/8/27 18:34,2-1_all_corrected,62,41,254,198,316,239
205584,30062_20190827194236.jpg,ミスミモール,1188,神戸,31,さ,2019/8/27 19:42,2-1_all_corrected,52,46,305,129,357,175
205721,30098_20190827203628.jpg,BRANCH仙台（東棟）,*211,仙台,333,ぬ,2019/8/27 20:36,2-1_all_corrected,100,71,234,311,334,382
203816,30167_20190827085922.jpg,イオン東雲店,1964,練馬,400,ぬ,2019/8/27 8:59,2-1_all_corrected,67,52,227,203,294,255
204830,30066_20190827155021.jpg,ジョーシン和泉中央,8008,和泉,31,の,2019/8/27 15:49,2-1_all_corrected,53,41,380,102,433,143
186699,30169_20190820173238.jpg,イオン相模原ショッピングセンター,*997,多摩,503,ま,2019/8/20 17:32,2-1_all_corrected,94,74,334,315,428,389
186807,30144_20190820175937.jpg,イオン幕張,3000,千葉,326,ふ,2019/8/20 17:59,2-1_all_corrected,88,62,296,339,384,401
184939,30167_20190820085952.jpg,イオン東雲店,*809,品川,334,り,2019/8/20 8:59,2-1_all_corrected,94,56,140,394,234,450
186800,30078_20190820175728.jpg,イオンスタイル仙台卸町店,**22,仙台,586,え,2019/8/20 17:57,2-1_all_corrected,69,61,142,140,211,201
185827,30144_20190820145706.jpg,イオン幕張,1031,千葉,344,そ,2019/8/20 14:56,2-1_all_corrected,88,62,310,305,398,367
185818,30076_20190820145437.jpg,ヤマダ電機なんば,*218,三重,336,の,2019/8/20 14:53,2-1_all_corrected,90,68,381,320,471,388
186035,30169_20190820160656.jpg,イオン相模原ショッピングセンター,3865,相模,50,み,2019/8/20 16:06,2-1_all_corrected,48,37,254,196,302,233
187113,30144_20190820191526.jpg,イオン幕張,8558,千葉,531,せ,2019/8/20 19:14,2-1_all_corrected,86,58,294,296,380,354
186690,30091_20190820173122.jpg,イトーヨーカドー木場 立体,3968,足立,57,ろ,2019/8/20 17:30,2-1_all_corrected,55,45,281,107,336,152
185041,30111_20190820101038.jpg,イオン稲毛,2110,川越,531,ひ,2019/8/20 10:10,2-1_all_corrected,138,118,434,323,572,441
186891,30144_20190820181649.jpg,イオン幕張,**27,千葉,302,ち,2019/8/20 18:16,2-1_all_corrected,59,43,157,182,216,225
186865,30144_20190820181327.jpg,イオン幕張,1101,千葉,583,め,2019/8/20 18:13,2-1_all_corrected,72,54,236,232,308,286
187381,30110_20190820205554.jpg,イオン金沢八景,1006,横浜,543,な,2019/8/20 20:55,2-1_all_corrected,77,76,24,312,101,388
185845,30045_20190820150308.jpg,マックスバリュー徳川明倫,**77,名古屋,31,ほ,2019/8/20 15:02,2-1_all_corrected,50,43,220,119,270,162
187388,30144_20190820205934.jpg,イオン幕張,1023,千葉,345,た,2019/8/20 19:57,2-1_all_corrected,73,55,297,236,370,291
185887,30078_20190820152039.jpg,イオンスタイル仙台卸町店,7293,宮城,580,ぬ,2019/8/20 15:20,2-1_all_corrected,88,61,320,269,408,330
187182,30167_20190820193349.jpg,イオン東雲店,3396,品川,302,ひ,2019/8/20 19:33,2-1_all_corrected,86,65,197,274,283,339
187149,30132_20190820192432.jpg,イオンスタイル東神奈川,***8,横浜,30,に,2019/8/20 19:24,2-1_all_corrected,56,43,264,154,320,197
186665,30144_20190820172344.jpg,イオン幕張,*714,袖ヶ浦,332,な,2019/8/20 17:23,2-1_all_corrected,87,67,291,334,378,401
185484,30144_20190820124313.jpg,イオン幕張,5416,習志野,480,り,2019/8/20 12:42,2-1_all_corrected,55,44,232,280,287,324
185477,30111_20190820123716.jpg,イオン稲毛,2836,千葉,500,さ,2019/8/20 12:36,2-1_all_corrected,38,33,63,71,101,104
185483,30110_20190820124236.jpg,イオン金沢八景,3784,横浜,505,な,2019/8/20 12:42,2-1_all_corrected,75,59,174,203,249,262
187329,30111_20190820204012.jpg,イオン稲毛,8571,千葉,502,む,2019/8/20 20:39,2-1_all_corrected,53,42,160,115,213,157
185687,30046_20190820141328.jpg,マミーマート船橋日大[地上],3825,習志野,580,せ,2019/8/20 14:13,2-1_all_corrected,80,62,348,291,428,353
186005,30110_20190820155713.jpg,イオン金沢八景,1024,横浜,352,つ,2019/8/20 15:56,2-1_all_corrected,72,62,139,187,211,249
185412,30078_20190820121417.jpg,イオンスタイル仙台卸町店,*530,仙台,583,つ,2019/8/20 12:13,2-1_all_corrected,79,55,268,199,347,254
186899,30078_20190820181806.jpg,イオンスタイル仙台卸町店,8702,宮城,580,も,2019/8/20 18:17,2-1_all_corrected,72,55,209,119,281,174
186852,30144_20190820181031.jpg,イオン幕張,3318,千葉,301,み,2019/8/20 18:10,2-1_all_corrected,75,50,306,235,381,285
187148,30132_20190820192429.jpg,イオンスタイル東神奈川,***8,横浜,30,に,2019/8/20 19:23,2-1_all_corrected,54,41,252,140,306,181
187170,30169_20190820193133.jpg,イオン相模原ショッピングセンター,2784,相模,501,み,2019/8/20 19:31,2-1_all_corrected,87,75,437,355,524,430
187184,30001_20190820193408.jpg,関西スーパー高石駅前,*227,堺,333,た,2019/8/20 19:33,2-1_all_corrected,71,56,443,97,514,153
187389,30144_20190820205940.jpg,イオン幕張,*503,千葉,585,よ,2019/8/20 19:58,2-1_all_corrected,62,41,221,174,283,215
186855,30078_20190820181044.jpg,イオンスタイル仙台卸町店,1961,宮城,580,さ,2019/8/20 18:10,2-1_all_corrected,74,52,260,168,334,220
185886,30144_20190820152023.jpg,イオン幕張,5063,千葉,330,の,2019/8/20 15:19,2-1_all_corrected,69,50,158,197,227,247
187380,30110_20190820205552.jpg,イオン金沢八景,1006,横浜,543,な,2019/8/20 20:55,2-1_all_corrected,65,53,249,181,314,234
186299,30043_20190820164020.jpg,ファインシティ東松戸,1024,野田,533,ち,2019/8/20 16:39,2-1_all_corrected,72,56,142,318,214,374
186897,30046_20190820181756.jpg,マミーマート船橋日大[地上],*876,練馬,530,に,2019/8/20 18:17,2-1_all_corrected,44,36,227,58,271,94
186609,30052_20190820171034.jpg,西友市ヶ尾,1123,横浜,31,は,2019/8/20 17:10,2-1_all_corrected,50,34,434,190,484,224
186863,30072_20190820181258.jpg,関西スーパー京阪大和田１F,2173,大阪,581,か,2019/8/20 18:12,2-1_all_corrected,77,64,69,241,146,305
186058,30039_20190820161258.jpg,イトーヨーカドー大井町,7110,品川,331,そ,2019/8/20 16:12,2-1_all_corrected,71,55,297,99,368,154
186916,30046_20190820182225.jpg,マミーマート船橋日大[地上],8331,習志野,501,ひ,2019/8/20 18:21,2-1_all_corrected,37,30,135,69,172,99
187457,30091_20190820213757.jpg,イトーヨーカドー木場 立体,2222,徳島,400,ね,2019/8/20 21:37,2-1_all_corrected,82,66,71,333,153,399
187033,30022_20190820185041.jpg,業務スーパー平野駅前,***3,なにわ,30,ぬ,2019/8/20 18:50,2-1_all_corrected,56,42,276,69,332,111
186929,30167_20190820182540.jpg,イオン東雲店,7777,神戸,361,ゆ,2019/8/20 18:25,2-1_all_corrected,51,41,399,276,450,317
185790,30167_20190820144803.jpg,イオン東雲店,**19,足立,342,り,2019/8/20 14:47,2-1_all_corrected,55,43,431,337,486,380
186571,30078_20190820170321.jpg,イオンスタイル仙台卸町店,5252,仙台,330,な,2019/8/20 17:02,2-1_all_corrected,93,60,401,387,494,447
186743,30144_20190820174442.jpg,イオン幕張,6130,山口,501,ひ,2019/8/20 17:44,2-1_all_corrected,82,61,197,289,279,350
187034,30144_20190820185042.jpg,イオン幕張,1451,千葉,500,て,2019/8/20 18:50,2-1_all_corrected,40,40,34,209,74,249
186927,30144_20190820182533.jpg,イオン幕張,***4,品川,357,ま,2019/8/20 18:25,2-1_all_corrected,56,39,167,142,223,181
185558,30111_20190820131758.jpg,イオン稲毛,1307,千葉,583,け,2019/8/20 13:17,2-1_all_corrected,91,72,78,360,169,432
186918,30167_20190820182231.jpg,イオン東雲店,5775,品川,330,ふ,2019/8/20 18:22,2-1_all_corrected,46,33,365,103,411,136
186920,30046_20190820182245.jpg,マミーマート船橋日大[地上],*358,習志野,534,せ,2019/8/20 18:22,2-1_all_corrected,55,44,282,196,337,240
187005,30144_20190820184454.jpg,イオン幕張,5200,千葉,531,す,2019/8/20 18:44,2-1_all_corrected,56,41,235,145,291,186
186781,30110_20190820175359.jpg,イオン金沢八景,1824,横浜,504,み,2019/8/20 17:53,2-1_all_corrected,38,34,302,74,340,108
185104,30167_20190820103620.jpg,イオン東雲店,***3,横浜,30,ち,2019/8/20 10:35,2-1_all_corrected,52,46,449,312,501,358
186775,30144_20190820175252.jpg,イオン幕張,9445,大阪,301,ね,2019/8/20 17:52,2-1_all_corrected,57,41,205,167,262,208
187051,30063_20190820185701.jpg,コーナン相模原小山モール,7385,相模,502,て,2019/8/20 18:56,2-1_all_corrected,65,59,504,166,569,225
186513,30169_20190820165305.jpg,イオン相模原ショッピングセンター,***8,相模,354,る,2019/8/20 16:52,2-1_all_corrected,55,42,375,128,430,170
186980,30136_20190820184016.jpg,イオンスタイル新百合ヶ丘,3069,川崎,300,ら,2019/8/20 18:39,2-1_all_corrected,57,41,326,132,383,173
184875,30072_20190820083709.jpg,関西スーパー京阪大和田１F,*762,京都,800,せ,2019/8/20 8:36,2-1_all_corrected,88,67,134,346,222,413
186170,30110_20190820162344.jpg,イオン金沢八景,5855,横浜,505,な,2019/8/20 16:23,2-1_all_corrected,51,38,351,158,402,196
185533,30157_20190820130915.jpg,関西スーパー中央,4715,堺,300,せ,2019/8/20 13:08,2-1_all_corrected,53,40,48,409,101,449
185195,30110_20190820111059.jpg,イオン金沢八景,1310,横浜,502,と,2019/8/20 11:10,2-1_all_corrected,76,57,302,183,378,240
187060,30144_20190820190006.jpg,イオン幕張,2641,練馬,502,さ,2019/8/20 18:59,2-1_all_corrected,45,38,250,118,295,156
186945,30144_20190820182957.jpg,イオン幕張,*313,習志野,335,ろ,2019/8/20 18:29,2-1_all_corrected,60,44,254,204,314,248
187299,30110_20190820202636.jpg,イオン金沢八景,*511,横浜,345,に,2019/8/20 20:26,2-1_all_corrected,51,44,306,113,357,157
185996,30078_20190820155511.jpg,イオンスタイル仙台卸町店,**66,仙台,333,な,2019/8/20 15:54,2-1_all_corrected,96,65,370,363,466,428
187093,30006_20190820191100.jpg,スギ薬局南千里,3514,大阪,580,や,2019/8/20 19:10,2-1_all_corrected,119,68,130,379,249,447
186780,30111_20190820175334.jpg,イオン稲毛,*901,千葉,581,さ,2019/8/20 17:52,2-1_all_corrected,53,41,187,148,240,189
187467,30110_20190820214527.jpg,イオン金沢八景,6064,横浜,500,ろ,2019/8/20 21:44,2-1_all_corrected,63,55,455,118,518,173
187231,30045_20190820195059.jpg,マックスバリュー徳川明倫,***3,名古屋,30,る,2019/8/20 19:50,2-1_all_corrected,48,37,237,134,285,171
186919,30167_20190820182237.jpg,イオン東雲店,5775,品川,333,ふ,2019/8/20 18:22,2-1_all_corrected,96,62,81,388,177,450
186773,30111_20190820175226.jpg,イオン稲毛,5037,千葉,301,ら,2019/8/20 17:51,2-1_all_corrected,54,43,364,147,418,190
185550,30144_20190820131324.jpg,イオン幕張,3691,袖ヶ浦,530,ね,2019/8/20 13:12,2-1_all_corrected,57,37,199,109,256,146
186742,30144_20190820174421.jpg,イオン幕張,6058,習志野,501,つ,2019/8/20 17:43,2-1_all_corrected,55,41,184,160,239,201
186372,30043_20190820164232.jpg,ファインシティ東松戸,*712,野田,334,は,2019/8/20 16:42,2-1_all_corrected,44,33,418,149,462,182
185167,30009_20190820105942.jpg,西友新北習志野,1004,習志野,334,り,2019/8/20 10:59,2-1_all_corrected,161,95,248,0,409,95
186386,30110_20190820164459.jpg,イオン金沢八景,*310,横浜,563,ぬ,2019/8/20 16:44,2-1_all_corrected,69,58,368,182,437,240
185503,30046_20190820125853.jpg,マミーマート船橋日大[地上],2660,習志野,330,と,2019/8/20 12:58,2-1_all_corrected,39,28,172,46,211,74
187066,30046_20190820190150.jpg,マミーマート船橋日大[地上],2698,習志野,580,の,2019/8/20 19:00,2-1_all_corrected,77,61,389,294,466,355
186711,30078_20190820173553.jpg,イオンスタイル仙台卸町店,4530,仙台,500,は,2019/8/20 17:35,2-1_all_corrected,70,53,267,136,337,189
186944,30072_20190820182904.jpg,関西スーパー京阪大和田１F,9904,大阪,300,め,2019/8/20 18:28,2-1_all_corrected,57,43,88,118,145,161
186727,30144_20190820173946.jpg,イオン幕張,2466,千葉,530,ふ,2019/8/20 17:39,2-1_all_corrected,79,55,254,271,333,326
187068,30144_20190820190232.jpg,イオン幕張,7119,千葉,300,と,2019/8/20 19:02,2-1_all_corrected,46,33,130,80,176,113
185955,30169_20190820154349.jpg,イオン相模原ショッピングセンター,2308,多摩,530,る,2019/8/20 15:43,2-1_all_corrected,54,48,24,299,78,347
184873,30052_20190820083519.jpg,西友市ヶ尾,***5,横浜,30,み,2019/8/20 8:34,2-1_all_corrected,76,52,281,278,357,330
187262,30147_20190820200528.jpg,三井のリパーク 厚木文化会館,*309,大宮,580,る,2019/8/20 20:04,2-1_all_corrected,80,59,218,230,298,289
186182,30169_20190820162707.jpg,イオン相模原ショッピングセンター,2992,相模,580,て,2019/8/20 16:26,2-1_all_corrected,86,66,241,206,327,272
185151,30046_20190820105521.jpg,マミーマート船橋日大[地上],*310,習志野,585,こ,2019/8/20 10:54,2-1_all_corrected,75,66,486,161,561,227
186975,30144_20190820183825.jpg,イオン幕張,3153,千葉,530,ま,2019/8/20 18:38,2-1_all_corrected,71,51,245,193,316,244
185952,30169_20190820154333.jpg,イオン相模原ショッピングセンター,2992,相模,580,て,2019/8/20 15:43,2-1_all_corrected,80,65,239,184,319,249
186981,30046_20190820184018.jpg,マミーマート船橋日大[地上],4386,大宮,502,ぬ,2019/8/20 18:39,2-1_all_corrected,38,29,145,88,183,117
185984,30060_20190820155234.jpg,関西スーパー小野原,1008,大阪,366,す,2019/8/20 15:52,2-1_all_corrected,38,38,405,11,443,49
185187,30167_20190820110628.jpg,イオン東雲店,*810,豊橋,333,み,2019/8/20 11:06,2-1_all_corrected,44,31,297,229,341,260
187072,30144_20190820190428.jpg,イオン幕張,1987,千葉,530,に,2019/8/20 19:04,2-1_all_corrected,56,42,287,159,343,201
185725,30144_20190820142407.jpg,イオン幕張,***7,野田,586,を,2019/8/20 14:23,2-1_all_corrected,41,38,97,166,138,204
186368,30110_20190820164207.jpg,イオン金沢八景,2714,横浜,580,あ,2019/8/20 16:41,2-1_all_corrected,68,56,337,223,405,279
186191,30144_20190820162921.jpg,イオン幕張,1374,袖ヶ浦,530,に,2019/8/20 16:28,2-1_all_corrected,77,54,180,251,257,305
186165,30046_20190820162326.jpg,マミーマート船橋日大[地上],1880,習志野,301,に,2019/8/20 16:23,2-1_all_corrected,91,66,472,152,563,218
186733,30144_20190820174210.jpg,イオン幕張,1995,千葉,531,そ,2019/8/20 17:41,2-1_all_corrected,83,67,445,373,528,440
185348,30068_20190820115739.jpg,ケーヨーデイツー唐木田,1122,多摩,31,ひ,2019/8/20 11:56,2-1_all_corrected,57,45,481,221,538,266
186734,30043_20190820174227.jpg,ファインシティ東松戸,8810,野田,333,ふ,2019/8/20 17:41,2-1_all_corrected,74,51,11,399,85,450
186162,30111_20190820162309.jpg,イオン稲毛,7813,千葉,330,ゆ,2019/8/20 16:22,2-1_all_corrected,79,58,296,207,375,265
187276,30159_20190820201151.jpg,イオン臼井,**88,千葉,370,る,2019/8/20 20:11,2-1_all_corrected,59,45,249,174,308,219
185979,30111_20190820154947.jpg,イオン稲毛,3110,千葉,341,ほ,2019/8/20 15:48,2-1_all_corrected,40,30,48,75,88,105
185377,30066_20190820120450.jpg,ジョーシン和泉中央,***1,和泉,30,ち,2019/8/20 12:04,2-1_all_corrected,70,56,216,230,286,286
185747,30052_20190820142943.jpg,西友市ヶ尾,1010,横浜,31,ほ,2019/8/20 14:29,2-1_all_corrected,79,60,332,270,411,330
185912,30110_20190820153109.jpg,イオン金沢八景,1001,横浜,31,の,2019/8/20 15:30,2-1_all_corrected,67,61,18,192,85,253
185586,30144_20190820133050.jpg,イオン幕張,2368,札幌,583,え,2019/8/20 13:30,2-1_all_corrected,63,43,168,201,231,244
187021,30144_20190820184718.jpg,イオン幕張,7902,八王子,500,わ,2019/8/20 18:46,2-1_all_corrected,83,60,288,308,371,368
185544,30167_20190820131135.jpg,イオン東雲店,1122,足立,325,ぬ,2019/8/20 13:11,2-1_all_corrected,35,36,0,3,35,39
186597,30169_20190820170614.jpg,イオン相模原ショッピングセンター,***8,相模,354,を,2019/8/20 17:05,2-1_all_corrected,45,36,352,61,397,97
186563,30078_20190820170100.jpg,イオンスタイル仙台卸町店,7717,宮城,583,も,2019/8/20 17:00,2-1_all_corrected,68,53,278,108,346,161
186904,30078_20190820181903.jpg,イオンスタイル仙台卸町店,9640,仙台,330,せ,2019/8/20 18:18,2-1_all_corrected,55,44,321,96,376,140
187214,30072_20190820194340.jpg,関西スーパー京阪大和田１F,8141,大阪,800,い,2019/8/20 19:43,2-1_all_corrected,65,59,112,165,177,224
185118,30110_20190820104351.jpg,イオン金沢八景,*331,横浜,540,め,2019/8/20 10:43,2-1_all_corrected,79,54,188,184,267,238
186994,30144_20190820184324.jpg,イオン幕張,4269,習志野,583,い,2019/8/20 18:42,2-1_all_corrected,59,41,203,171,262,212
186960,30169_20190820183442.jpg,イオン相模原ショッピングセンター,1107,相模,587,の,2019/8/20 18:34,2-1_all_corrected,89,71,338,338,427,409
187045,30144_20190820185343.jpg,イオン幕張,8083,千葉,302,す,2019/8/20 18:53,2-1_all_corrected,75,55,288,258,363,313
186967,30144_20190820183622.jpg,イオン幕張,4865,千葉,502,み,2019/8/20 18:35,2-1_all_corrected,77,55,268,248,345,303
186993,30072_20190820184315.jpg,関西スーパー京阪大和田１F,8988,大阪,301,は,2019/8/20 18:42,2-1_all_corrected,68,59,64,169,132,228
187270,30023_20190820200926.jpg,ピットデザイン山科東野,7777,京都,522,み,2019/8/20 20:09,2-1_all_corrected,73,57,295,16,368,73
185976,30066_20190820154817.jpg,ジョーシン和泉中央,**88,和泉,31,は,2019/8/20 15:47,2-1_all_corrected,46,37,353,124,399,161
185949,30078_20190820154238.jpg,イオンスタイル仙台卸町店,7484,仙台,480,う,2019/8/20 15:42,2-1_all_corrected,70,53,304,133,374,186
187417,30144_20190820210934.jpg,イオン幕張,***7,千葉,521,た,2019/8/20 20:58,2-1_all_corrected,57,42,273,177,330,219
185724,30144_20190820142347.jpg,イオン幕張,1045,千葉,580,ひ,2019/8/20 14:23,2-1_all_corrected,55,42,132,156,187,198
185126,30144_20190820104644.jpg,イオン幕張,9257,千葉,301,ら,2019/8/20 10:46,2-1_all_corrected,83,55,293,298,376,353
185542,30144_20190820131120.jpg,イオン幕張,*102,千葉,330,み,2019/8/20 13:10,2-1_all_corrected,40,34,362,61,402,95
186768,30144_20190820175100.jpg,イオン幕張,1005,千葉,587,ゆ,2019/8/20 17:50,2-1_all_corrected,53,32,214,125,267,157
186562,30111_20190820170058.jpg,イオン稲毛,1001,千葉,371,ひ,2019/8/20 17:00,2-1_all_corrected,72,55,316,164,388,219
185121,30144_20190820104422.jpg,イオン幕張,2831,千葉,503,つ,2019/8/20 10:44,2-1_all_corrected,52,41,172,126,224,167
187472,30063_20190820215141.jpg,コーナン相模原小山モール,*483,相模,301,た,2019/8/20 21:51,2-1_all_corrected,60,64,540,166,600,230
185325,30144_20190820115114.jpg,イオン幕張,2511,習志野,583,に,2019/8/20 11:50,2-1_all_corrected,55,36,228,140,283,176
186761,30078_20190820174741.jpg,イオンスタイル仙台卸町店,*711,仙台,332,ひ,2019/8/20 17:47,2-1_all_corrected,59,42,268,71,327,113
186553,30167_20190820165858.jpg,イオン東雲店,*787,足立,583,さ,2019/8/20 16:58,2-1_all_corrected,76,68,111,208,187,276
186598,30144_20190820170618.jpg,イオン幕張,3788,習志野,331,せ,2019/8/20 17:05,2-1_all_corrected,76,49,234,185,310,234
185779,30045_20190820144311.jpg,マックスバリュー徳川明倫,***3,名古屋,30,み,2019/8/20 14:42,2-1_all_corrected,49,38,283,132,332,170
185096,30072_20190820103237.jpg,関西スーパー京阪大和田１F,1991,大阪,581,せ,2019/8/20 10:32,2-1_all_corrected,78,61,130,234,208,295
184750,30072_20190820080302.jpg,関西スーパー京阪大和田１F,1724,なにわ,830,い,2019/8/20 8:02,2-1_all_corrected,72,56,14,139,86,195
186841,30144_20190820180713.jpg,イオン幕張,*124,千葉,335,ふ,2019/8/20 18:06,2-1_all_corrected,52,37,138,110,190,147
186419,30046_20190820164612.jpg,マミーマート船橋日大[地上],*234,習志野,531,に,2019/8/20 16:45,2-1_all_corrected,67,73,533,198,600,271
185859,30144_20190820150934.jpg,イオン幕張,6978,野田,501,な,2019/8/20 15:09,2-1_all_corrected,59,42,225,142,284,184
186042,30110_20190820161011.jpg,イオン金沢八景,2499,横浜,580,よ,2019/8/20 16:09,2-1_all_corrected,68,64,0,227,68,291
185098,30006_20190820103345.jpg,スギ薬局南千里,4633,大阪,302,せ,2019/8/20 10:33,2-1_all_corrected,122,76,160,97,282,173
186877,30144_20190820181432.jpg,イオン幕張,*508,千葉,336,ま,2019/8/20 18:13,2-1_all_corrected,72,54,250,211,322,265
185857,30103_20190820150805.jpg,八尾老原１丁目,***1,奈良,30,た,2019/8/20 15:07,2-1_all_corrected,59,43,232,171,291,214
185602,30078_20190820133737.jpg,イオンスタイル仙台卸町店,*220,仙台,333,み,2019/8/20 13:37,2-1_all_corrected,82,61,357,273,439,334
185232,30144_20190820112340.jpg,イオン幕張,5305,袖ヶ浦,580,ま,2019/8/20 11:23,2-1_all_corrected,86,61,421,330,507,391
186685,30144_20190820173014.jpg,イオン幕張,*128,千葉,343,さ,2019/8/20 17:29,2-1_all_corrected,69,50,155,202,224,252
186682,30144_20190820172813.jpg,イオン幕張,1335,習志野,530,せ,2019/8/20 17:27,2-1_all_corrected,90,60,352,388,442,448
187106,30111_20190820191348.jpg,イオン稲毛,5518,千葉,331,み,2019/8/20 19:13,2-1_all_corrected,53,42,167,150,220,192
185203,30172_20190820111225.jpg,ピットデザインすわの町,*637,久留米,580,み,2019/8/20 11:11,2-1_all_corrected,86,69,171,269,257,338
186815,30144_20190820180145.jpg,イオン幕張,3110,千葉,340,ま,2019/8/20 18:01,2-1_all_corrected,86,63,249,348,335,411
185204,30111_20190820111304.jpg,イオン稲毛,*859,袖ヶ浦,330,ね,2019/8/20 11:11,2-1_all_corrected,56,47,218,143,274,190
187154,30144_20190820192616.jpg,イオン幕張,8823,川口,300,す,2019/8/20 19:25,2-1_all_corrected,75,55,294,250,369,305
185294,30110_20190820114117.jpg,イオン金沢八景,3844,横浜,580,も,2019/8/20 11:40,2-1_all_corrected,68,53,203,135,271,188
184941,30073_20190820090309.jpg,関西スーパー京阪大和田２F,9209,神戸,330,た,2019/8/20 9:02,2-1_all_corrected,75,62,358,174,433,236
185893,30110_20190820152403.jpg,イオン金沢八景,1101,横浜,355,む,2019/8/20 15:23,2-1_all_corrected,46,38,401,84,447,122
187368,30169_20190820205134.jpg,イオン相模原ショッピングセンター,*827,相模,564,け,2019/8/20 20:50,2-1_all_corrected,51,41,92,98,143,139
186043,30072_20190820161043.jpg,関西スーパー京阪大和田１F,*395,和泉,400,と,2019/8/20 16:10,2-1_all_corrected,76,70,0,241,76,311
185063,30144_20190820102007.jpg,イオン幕張,3199,千葉,580,み,2019/8/20 10:19,2-1_all_corrected,53,36,179,136,232,172
186612,30014_20190820171116.jpg,フォルテ蘇我ベルク棟,***5,千葉,30,る,2019/8/20 17:10,2-1_all_corrected,53,44,118,67,171,111
186646,30046_20190820171859.jpg,マミーマート船橋日大[地上],*515,習志野,538,の,2019/8/20 17:18,2-1_all_corrected,55,43,256,126,311,169
186474,30167_20190820164821.jpg,イオン東雲店,3295,足立,460,そ,2019/8/20 16:47,2-1_all_corrected,52,39,282,158,334,197
187109,30111_20190820191426.jpg,イオン稲毛,9794,神戸,509,の,2019/8/20 19:14,2-1_all_corrected,48,38,404,88,452,126
185496,30066_20190820125320.jpg,ジョーシン和泉中央,***1,和泉,30,て,2019/8/20 12:52,2-1_all_corrected,75,59,143,285,218,344
185650,30045_20190820140010.jpg,マックスバリュー徳川明倫,**22,名古屋,31,る,2019/8/20 13:59,2-1_all_corrected,49,41,211,133,260,174
186648,30111_20190820171912.jpg,イオン稲毛,*235,千葉,585,も,2019/8/20 17:18,2-1_all_corrected,53,42,304,139,357,181
186684,30144_20190820172908.jpg,イオン幕張,5062,千葉,302,つ,2019/8/20 17:28,2-1_all_corrected,82,54,299,295,381,349
185233,30144_20190820112345.jpg,イオン幕張,6500,千葉,531,さ,2019/8/20 11:23,2-1_all_corrected,55,41,135,133,190,174
186670,30144_20190820172500.jpg,イオン幕張,5522,千葉,330,ぬ,2019/8/20 17:24,2-1_all_corrected,49,41,74,175,123,216
186026,30106_20190820160329.jpg,ジョーシン東大阪長田,***1,大阪,30,な,2019/8/20 16:02,2-1_all_corrected,73,51,283,284,356,335
185802,30079_20190820145023.jpg,ピットデザイン仙台卸町駅前駐車場,2371,仙台,530,す,2019/8/20 14:50,2-1_all_corrected,39,33,371,61,410,94
187144,30144_20190820192408.jpg,イオン幕張,1214,千葉,339,る,2019/8/20 19:23,2-1_all_corrected,63,42,198,161,261,203
186895,30098_20190820181725.jpg,BRANCH仙台（東棟）,*182,仙台,500,ろ,2019/8/20 18:17,2-1_all_corrected,98,67,315,291,413,358
185248,30144_20190820112756.jpg,イオン幕張,1318,千葉,583,こ,2019/8/20 11:27,2-1_all_corrected,51,33,180,100,231,133
185426,30144_20190820121945.jpg,イオン幕張,1182,習志野,331,る,2019/8/20 12:19,2-1_all_corrected,78,49,233,230,311,279
187385,30144_20190820205705.jpg,イオン幕張,3548,千葉,330,ち,2019/8/20 19:46,2-1_all_corrected,79,56,208,285,287,341
187181,30110_20190820193342.jpg,イオン金沢八景,*621,横浜,539,ら,2019/8/20 19:33,2-1_all_corrected,51,42,464,98,515,140
185877,30139_20190820151624.jpg,イオン板橋ショッピングセンター,***1,練馬,30,ね,2019/8/20 15:15,2-1_all_corrected,71,53,253,237,324,290
185883,30078_20190820151747.jpg,イオンスタイル仙台卸町店,*522,仙台,583,も,2019/8/20 15:17,2-1_all_corrected,77,58,287,215,364,273
187186,30138_20190820193432.jpg,イオンスタイル湘南茅ヶ崎,9515,湘南,400,て,2019/8/20 19:34,2-1_all_corrected,65,41,334,229,399,270
185241,30144_20190820112558.jpg,イオン幕張,5255,千葉,331,さ,2019/8/20 11:25,2-1_all_corrected,51,34,229,129,280,163
185018,30167_20190820095904.jpg,イオン東雲店,1210,足立,341,て,2019/8/20 9:58,2-1_all_corrected,49,37,340,117,389,154
186464,30169_20190820164738.jpg,イオン相模原ショッピングセンター,7312,相模,330,て,2019/8/20 16:47,2-1_all_corrected,55,43,391,81,446,124
185443,30144_20190820122349.jpg,イオン幕張,8900,千葉,580,ふ,2019/8/20 12:23,2-1_all_corrected,58,44,104,152,162,196
186658,30111_20190820172124.jpg,イオン稲毛,2007,千葉,339,ろ,2019/8/20 17:20,2-1_all_corrected,63,44,381,139,444,183
185812,30144_20190820145403.jpg,イオン幕張,4345,習志野,301,つ,2019/8/20 14:53,2-1_all_corrected,49,43,66,218,115,261
187110,30006_20190820191428.jpg,スギ薬局南千里,3514,大阪,580,や,2019/8/20 19:14,2-1_all_corrected,122,71,166,337,288,408
186869,30144_20190820181352.jpg,イオン幕張,*508,千葉,336,ま,2019/8/20 18:13,2-1_all_corrected,48,49,47,190,95,239
186851,30110_20190820181003.jpg,イオン金沢八景,3016,横浜,331,せ,2019/8/20 18:09,2-1_all_corrected,76,61,159,212,235,273
185876,30139_20190820151621.jpg,イオン板橋ショッピングセンター,***1,練馬,30,ね,2019/8/20 15:15,2-1_all_corrected,72,54,255,234,327,288
186632,30045_20190820171528.jpg,マックスバリュー徳川明倫,**77,名古屋,31,ほ,2019/8/20 17:15,2-1_all_corrected,71,55,216,160,287,215
186269,30167_20190820163858.jpg,イオン東雲店,4704,足立,481,り,2019/8/20 16:38,2-1_all_corrected,33,46,374,115,407,161
185276,30144_20190820113748.jpg,イオン幕張,2714,千葉,331,せ,2019/8/20 11:37,2-1_all_corrected,58,43,157,153,215,196
187383,30144_20190820205621.jpg,イオン幕張,*919,千葉,339,す,2019/8/20 19:44,2-1_all_corrected,83,60,334,330,417,390
186498,30167_20190820165055.jpg,イオン東雲店,7162,足立,480,す,2019/8/20 16:50,2-1_all_corrected,74,60,142,145,216,205
185813,30111_20190820145406.jpg,イオン稲毛,2665,千葉,330,つ,2019/8/20 14:53,2-1_all_corrected,69,55,337,158,406,213
186661,30060_20190820172229.jpg,関西スーパー小野原,3406,大阪,480,な,2019/8/20 17:22,2-1_all_corrected,74,56,337,304,411,360
186833,30144_20190820180605.jpg,イオン幕張,7240,千葉,300,も,2019/8/20 18:05,2-1_all_corrected,84,58,232,290,316,348
186659,30144_20190820172138.jpg,イオン幕張,3258,愛媛,330,ま,2019/8/20 17:21,2-1_all_corrected,95,65,279,382,374,447
186030,30073_20190820160534.jpg,関西スーパー京阪大和田２F,2074,なにわ,301,ろ,2019/8/20 16:05,2-1_all_corrected,90,81,499,187,589,268
187324,30110_20190820203919.jpg,イオン金沢八景,*703,横浜,346,む,2019/8/20 20:38,2-1_all_corrected,72,58,499,86,571,144
186692,30169_20190820173200.jpg,イオン相模原ショッピングセンター,5777,多摩,332,の,2019/8/20 17:31,2-1_all_corrected,88,75,399,335,487,410
186805,30110_20190820175928.jpg,イオン金沢八景,2121,横浜,337,ゆ,2019/8/20 17:59,2-1_all_corrected,76,62,156,237,232,299
186650,30144_20190820171925.jpg,イオン幕張,5678,静岡,500,ゆ,2019/8/20 17:19,2-1_all_corrected,95,61,227,365,322,426
186496,30167_20190820165048.jpg,イオン東雲店,1972,山形,580,き,2019/8/20 16:50,2-1_all_corrected,69,62,160,190,229,252
187312,30022_20190820203357.jpg,業務スーパー平野駅前,7654,和泉,330,す,2019/8/20 20:33,2-1_all_corrected,85,75,45,86,130,161
185019,30045_20190820095931.jpg,マックスバリュー徳川明倫,1103,名古屋,31,つ,2019/8/20 9:58,2-1_all_corrected,55,43,213,140,268,183
185489,30110_20190820124524.jpg,イオン金沢八景,9830,横浜,504,な,2019/8/20 12:44,2-1_all_corrected,83,59,267,146,350,205
187127,30070_20190820191918.jpg,カナートモール住道第一,***2,大阪,30,も,2019/8/20 19:18,2-1_all_corrected,84,62,176,220,260,282
185214,30045_20190820111738.jpg,マックスバリュー徳川明倫,**77,名古屋,31,ほ,2019/8/20 11:17,2-1_all_corrected,66,57,255,185,321,242
186725,30085_20190820173915.jpg,業務スーパー南津守,1000,なにわ,30,ち,2019/8/20 17:38,2-1_all_corrected,43,45,107,251,150,296
186187,30167_20190820162811.jpg,イオン東雲店,6668,足立,480,れ,2019/8/20 16:27,2-1_all_corrected,92,66,196,363,288,429
186180,30144_20190820162658.jpg,イオン幕張,1015,千葉,349,む,2019/8/20 16:26,2-1_all_corrected,47,33,171,94,218,127
187052,30110_20190820185722.jpg,イオン金沢八景,*612,つくば,333,ひ,2019/8/20 18:57,2-1_all_corrected,67,60,460,212,527,272
187064,30111_20190820190122.jpg,イオン稲毛,1208,千葉,347,た,2019/8/20 19:00,2-1_all_corrected,51,42,192,98,243,140
186370,30167_20190820164216.jpg,イオン東雲店,2693,品川,400,い,2019/8/20 16:41,2-1_all_corrected,51,44,410,325,461,369
185368,30144_20190820120221.jpg,イオン幕張,6644,千葉,501,ゆ,2019/8/20 12:01,2-1_all_corrected,83,58,322,307,405,365
186519,30167_20190820165336.jpg,イオン東雲店,3321,品川,301,わ,2019/8/20 16:53,2-1_all_corrected,50,37,308,101,358,138
186713,30144_20190820173629.jpg,イオン幕張,1188,習志野,557,も,2019/8/20 17:36,2-1_all_corrected,40,35,242,82,282,117
187063,30046_20190820190115.jpg,マミーマート船橋日大[地上],1443,習志野,501,ゆ,2019/8/20 19:00,2-1_all_corrected,60,41,323,202,383,243
185995,30144_20190820155421.jpg,イオン幕張,1341,千葉,302,ね,2019/8/20 15:54,2-1_all_corrected,92,63,291,383,383,446
187498,30079_20190820222433.jpg,ピットデザイン仙台卸町駅前駐車場,4576,仙台,580,ふ,2019/8/20 22:24,2-1_all_corrected,87,60,314,335,401,395
185109,30144_20190820103934.jpg,イオン幕張,3459,千葉,330,ひ,2019/8/20 10:39,2-1_all_corrected,56,39,189,143,245,182
185303,30144_20190820114501.jpg,イオン幕張,4734,千葉,330,せ,2019/8/20 11:44,2-1_all_corrected,54,39,166,103,220,142
186776,30111_20190820175257.jpg,イオン稲毛,6944,千葉,502,ひ,2019/8/20 17:51,2-1_all_corrected,59,41,359,150,418,191
185590,30045_20190820133337.jpg,マックスバリュー徳川明倫,8008,名古屋,31,さ,2019/8/20 13:33,2-1_all_corrected,57,44,221,149,278,193
187465,30111_20190820214448.jpg,イオン稲毛,*123,千葉,370,も,2019/8/20 21:44,2-1_all_corrected,48,39,173,105,221,144
185564,30110_20190820132059.jpg,イオン金沢八景,6495,横浜,580,は,2019/8/20 13:20,2-1_all_corrected,49,40,408,151,457,191
186712,30169_20190820173624.jpg,イオン相模原ショッピングセンター,5434,多摩,580,ゆ,2019/8/20 17:35,2-1_all_corrected,58,44,357,113,415,157
186978,30169_20190820183936.jpg,イオン相模原ショッピングセンター,1221,相模,536,め,2019/8/20 18:39,2-1_all_corrected,88,75,438,375,526,450
185958,30167_20190820154418.jpg,イオン東雲店,7411,足立,230,さ,2019/8/20 15:43,2-1_all_corrected,45,34,267,240,312,274
187065,30045_20190820190142.jpg,マックスバリュー徳川明倫,1122,名古屋,31,せ,2019/8/20 19:01,2-1_all_corrected,72,62,134,212,206,274
186188,30157_20190820162903.jpg,関西スーパー中央,5678,神戸,30,ら,2019/8/20 16:28,2-1_all_corrected,52,40,295,257,347,297
186511,30167_20190820165243.jpg,イオン東雲店,2293,足立,400,ま,2019/8/20 16:52,2-1_all_corrected,66,57,249,117,315,174
186340,30046_20190820164120.jpg,マミーマート船橋日大[地上],7115,習志野,530,ふ,2019/8/20 16:40,2-1_all_corrected,53,42,267,113,320,155
185757,30144_20190820143449.jpg,イオン幕張,2568,習志野,330,ふ,2019/8/20 14:34,2-1_all_corrected,61,45,183,187,244,232
186542,30110_20190820165656.jpg,イオン金沢八景,2742,横浜,330,と,2019/8/20 16:56,2-1_all_corrected,73,60,224,210,297,270
186748,30169_20190820174546.jpg,イオン相模原ショッピングセンター,7312,相模,330,か,2019/8/20 17:45,2-1_all_corrected,52,40,455,2,507,42
187038,30144_20190820185144.jpg,イオン幕張,3853,千葉,581,こ,2019/8/20 18:51,2-1_all_corrected,79,57,255,272,334,329
186777,30111_20190820175301.jpg,イオン稲毛,2417,千葉,330,る,2019/8/20 17:51,2-1_all_corrected,64,60,380,232,444,292
185750,30072_20190820143151.jpg,関西スーパー京阪大和田１F,5988,大阪,101,い,2019/8/20 14:31,2-1_all_corrected,71,61,327,180,398,241
185302,30167_20190820114448.jpg,イオン東雲店,*951,足立,301,に,2019/8/20 11:44,2-1_all_corrected,54,40,304,163,358,203
187031,30072_20190820185018.jpg,関西スーパー京阪大和田１F,1117,大阪,338,ゆ,2019/8/20 18:49,2-1_all_corrected,48,37,342,47,390,84
187009,30046_20190820184533.jpg,マミーマート船橋日大[地上],***6,習志野,363,り,2019/8/20 18:44,2-1_all_corrected,67,52,362,132,429,184
186913,30144_20190820182112.jpg,イオン幕張,5133,千葉,502,せ,2019/8/20 18:20,2-1_all_corrected,80,57,248,253,328,310
187470,30169_20190820214744.jpg,イオン相模原ショッピングセンター,*350,相模,337,は,2019/8/20 21:47,2-1_all_corrected,70,56,314,148,384,204
187226,30062_20190820194727.jpg,ミスミモール,1188,神戸,31,さ,2019/8/20 19:46,2-1_all_corrected,66,57,274,144,340,201
187014,30009_20190820184633.jpg,西友新北習志野,*475,習志野,580,か,2019/8/20 18:45,2-1_all_corrected,49,40,16,199,65,239
186556,30167_20190820165905.jpg,イオン東雲店,1125,足立,335,の,2019/8/20 16:58,2-1_all_corrected,49,37,334,75,383,112
186764,30144_20190820174832.jpg,イオン幕張,9725,千葉,580,よ,2019/8/20 17:48,2-1_all_corrected,58,42,211,130,269,172
187013,30144_20190820184624.jpg,イオン幕張,9751,千葉,563,あ,2019/8/20 18:46,2-1_all_corrected,43,38,192,107,235,145
186936,30144_20190820182737.jpg,イオン幕張,*317,千葉,584,せ,2019/8/20 18:27,2-1_all_corrected,57,42,262,174,319,216
185124,30072_20190820104457.jpg,関西スーパー京阪大和田１F,1001,大阪,31,ひ,2019/8/20 10:44,2-1_all_corrected,51,37,224,38,275,75
187210,30060_20190820194222.jpg,関西スーパー小野原,4333,大阪,302,ゆ,2019/8/20 19:41,2-1_all_corrected,69,58,402,240,471,298
186907,30072_20190820181945.jpg,関西スーパー京阪大和田１F,**16,大阪,356,て,2019/8/20 18:18,2-1_all_corrected,85,69,499,293,584,362
186739,30144_20190820174337.jpg,イオン幕張,*830,千葉,338,つ,2019/8/20 17:43,2-1_all_corrected,40,48,6,229,46,277
185980,30110_20190820155123.jpg,イオン金沢八景,8686,横浜,535,る,2019/8/20 15:50,2-1_all_corrected,80,62,280,213,360,275
186534,30144_20190820165515.jpg,イオン幕張,1362,千葉,580,ゆ,2019/8/20 16:54,2-1_all_corrected,55,39,167,149,222,188
187082,30144_20190820190816.jpg,イオン幕張,4784,千葉,501,わ,2019/8/20 19:07,2-1_all_corrected,70,53,223,196,293,249
186701,30167_20190820173245.jpg,イオン東雲店,**21,大宮,431,て,2019/8/20 17:32,2-1_all_corrected,83,64,128,315,211,379
187078,30144_20190820190639.jpg,イオン幕張,6600,千葉,480,ち,2019/8/20 19:06,2-1_all_corrected,83,64,445,366,528,430
186965,30045_20190820183544.jpg,マックスバリュー徳川明倫,**18,名古屋,31,ゆ,2019/8/20 18:35,2-1_all_corrected,48,42,377,122,425,164
187424,30111_20190820211616.jpg,イオン稲毛,***1,千葉,806,ぬ,2019/8/20 21:15,2-1_all_corrected,60,43,314,182,374,225
186105,30157_20190820161504.jpg,関西スーパー中央,5678,神戸,31,ら,2019/8/20 16:14,2-1_all_corrected,43,41,415,176,458,217
185546,30167_20190820131202.jpg,イオン東雲店,1122,足立,325,ぬ,2019/8/20 13:11,2-1_all_corrected,74,59,126,263,200,322
186906,30111_20190820181929.jpg,イオン稲毛,8823,千葉,536,む,2019/8/20 18:18,2-1_all_corrected,47,38,107,82,154,120
185921,30167_20190820153453.jpg,イオン東雲店,8118,足立,483,さ,2019/8/20 15:34,2-1_all_corrected,38,31,391,45,429,76
186566,30144_20190820170129.jpg,イオン幕張,1988,千葉,337,き,2019/8/20 17:00,2-1_all_corrected,41,35,254,97,295,132
187476,30039_20190820215835.jpg,イトーヨーカドー大井町,2977,神戸,77,つ,2019/8/20 21:58,2-1_all_corrected,73,70,153,262,226,332
185928,30110_20190820153559.jpg,イオン金沢八景,1661,横浜,504,に,2019/8/20 15:35,2-1_all_corrected,52,43,426,155,478,198
187471,30169_20190820214749.jpg,イオン相模原ショッピングセンター,*350,相模,337,は,2019/8/20 21:47,2-1_all_corrected,74,58,297,198,371,256
186158,30169_20190820162247.jpg,イオン相模原ショッピングセンター,1446,相模,530,な,2019/8/20 16:22,2-1_all_corrected,51,43,122,246,173,289
185729,30167_20190820142534.jpg,イオン東雲店,7411,足立,230,さ,2019/8/20 14:25,2-1_all_corrected,70,56,347,350,417,406
186709,30046_20190820173346.jpg,マミーマート船橋日大[地上],3500,習志野,336,ら,2019/8/20 17:33,2-1_all_corrected,83,73,474,229,557,302
186736,30110_20190820174306.jpg,イオン金沢八景,1110,横浜,546,ら,2019/8/20 17:42,2-1_all_corrected,53,43,315,103,368,146
185972,30091_20190820154735.jpg,イトーヨーカドー木場 立体,*524,足立,334,も,2019/8/20 15:47,2-1_all_corrected,72,55,246,171,318,226
187070,30167_20190820190335.jpg,イオン東雲店,6266,千葉,581,せ,2019/8/20 19:03,2-1_all_corrected,51,37,281,254,332,291
187084,30078_20190820190840.jpg,イオンスタイル仙台卸町店,6000,仙台,332,の,2019/8/20 19:08,2-1_all_corrected,76,54,350,293,426,347
186700,30111_20190820173240.jpg,イオン稲毛,4016,千葉,302,に,2019/8/20 17:30,2-1_all_corrected,55,42,189,128,244,170
186952,30060_20190820183118.jpg,関西スーパー小野原,7070,大阪,583,よ,2019/8/20 18:30,2-1_all_corrected,42,38,329,70,371,108
186707,30060_20190820173303.jpg,関西スーパー小野原,8787,大阪,349,に,2019/8/20 17:32,2-1_all_corrected,64,62,95,128,159,190
186675,30144_20190820172553.jpg,イオン幕張,6523,習志野,580,え,2019/8/20 17:25,2-1_all_corrected,55,43,172,170,227,213
185699,30078_20190820141527.jpg,イオンスタイル仙台卸町店,6903,仙台,500,む,2019/8/20 14:15,2-1_all_corrected,97,51,267,398,364,449
186820,30132_20190820180351.jpg,イオンスタイル東神奈川,2628,品川,580,あ,2019/8/20 18:03,2-1_all_corrected,54,36,212,170,266,206
186216,30045_20190820163515.jpg,マックスバリュー徳川明倫,2525,名古屋,31,そ,2019/8/20 16:34,2-1_all_corrected,64,57,231,199,295,256
186686,30046_20190820173017.jpg,マミーマート船橋日大[地上],4299,習志野,330,さ,2019/8/20 17:29,2-1_all_corrected,71,75,527,213,598,288
185035,30062_20190820100709.jpg,ミスミモール,**18,神戸,31,ふ,2019/8/20 10:06,2-1_all_corrected,69,53,314,170,383,223
186482,30110_20190820164908.jpg,イオン金沢八景,5152,横浜,531,さ,2019/8/20 16:48,2-1_all_corrected,67,56,226,154,293,210
187301,30078_20190820202908.jpg,イオンスタイル仙台卸町店,***3,宮城,326,さ,2019/8/20 20:28,2-1_all_corrected,90,63,298,311,388,374
187133,30046_20190820192209.jpg,マミーマート船橋日大[地上],*523,習志野,336,は,2019/8/20 19:21,2-1_all_corrected,36,26,130,35,166,61
185469,30110_20190820123507.jpg,イオン金沢八景,7000,横浜,396,も,2019/8/20 12:34,2-1_all_corrected,63,59,86,189,149,248
186816,30078_20190820180222.jpg,イオンスタイル仙台卸町店,1229,仙台,331,ね,2019/8/20 18:01,2-1_all_corrected,68,53,351,143,419,196
185891,30144_20190820152229.jpg,イオン幕張,8600,千葉,333,ち,2019/8/20 15:22,2-1_all_corrected,49,31,190,88,239,119
186889,30078_20190820181622.jpg,イオンスタイル仙台卸町店,**10,仙台,584,そ,2019/8/20 18:15,2-1_all_corrected,69,52,259,125,328,177
185254,30044_20190820113005.jpg,ココス横浜港南台,1529,柏,-1,の,2019/8/20 11:29,2-1_all_corrected,74,57,275,392,349,449
186041,30110_20190820161002.jpg,イオン金沢八景,1885,横浜,330,の,2019/8/20 16:09,2-1_all_corrected,55,42,367,69,422,111
187160,30169_20190820192714.jpg,イオン相模原ショッピングセンター,1017,相模,337,み,2019/8/20 19:26,2-1_all_corrected,70,61,223,156,293,217
187390,30169_20190820210022.jpg,イオン相模原ショッピングセンター,*721,多摩,536,な,2019/8/20 20:59,2-1_all_corrected,80,64,286,231,366,295
185265,30078_20190820113340.jpg,イオンスタイル仙台卸町店,7583,仙台,530,た,2019/8/20 11:33,2-1_all_corrected,78,56,358,215,436,271
184981,30001_20190820093535.jpg,関西スーパー高石駅前,7718,和泉,483,い,2019/8/20 9:35,2-1_all_corrected,59,43,376,61,435,104
186874,30078_20190820181413.jpg,イオンスタイル仙台卸町店,9907,宮城,580,よ,2019/8/20 18:13,2-1_all_corrected,59,44,217,113,276,157
185434,30144_20190820122129.jpg,イオン幕張,8915,千葉,330,た,2019/8/20 12:21,2-1_all_corrected,53,49,52,222,105,271
186621,30001_20190820171322.jpg,関西スーパー高石駅前,4932,和泉,580,よ,2019/8/20 17:13,2-1_all_corrected,87,60,270,201,357,261
186642,30144_20190820171723.jpg,イオン幕張,*507,習志野,333,さ,2019/8/20 17:16,2-1_all_corrected,77,51,265,274,342,325
186810,30110_20190820180006.jpg,イオン金沢八景,6000,横浜,503,ね,2019/8/20 17:59,2-1_all_corrected,80,59,105,391,185,450
187103,30144_20190820191312.jpg,イオン幕張,1185,千葉,580,さ,2019/8/20 19:12,2-1_all_corrected,61,43,325,213,386,256
186687,30169_20190820173052.jpg,イオン相模原ショッピングセンター,**55,多摩,537,り,2019/8/20 17:30,2-1_all_corrected,78,78,470,351,548,429
186819,30110_20190820180344.jpg,イオン金沢八景,*408,横浜,480,と,2019/8/20 18:03,2-1_all_corrected,41,30,241,69,282,99
185495,30167_20190820125149.jpg,イオン東雲店,*394,大宮,580,む,2019/8/20 12:51,2-1_all_corrected,80,67,86,286,166,353
186479,30110_20190820164843.jpg,イオン金沢八景,*810,横浜,372,や,2019/8/20 16:48,2-1_all_corrected,73,59,163,166,236,225
186875,30078_20190820181418.jpg,イオンスタイル仙台卸町店,9907,宮城,580,つ,2019/8/20 18:13,2-1_all_corrected,71,51,212,121,283,172
185899,30111_20190820152623.jpg,イオン稲毛,8298,千葉,500,て,2019/8/20 15:25,2-1_all_corrected,39,31,53,65,92,96
186886,30157_20190820181537.jpg,関西スーパー中央,7730,神戸,480,せ,2019/8/20 18:15,2-1_all_corrected,57,43,112,345,169,388
184973,30006_20190820093138.jpg,スギ薬局南千里,*410,大阪,337,ゆ,2019/8/20 9:31,2-1_all_corrected,134,122,3,203,137,325
186627,30046_20190820171450.jpg,マミーマート船橋日大[地上],4299,習志野,330,さ,2019/8/20 17:14,2-1_all_corrected,38,27,461,55,499,82
186844,30144_20190820180813.jpg,イオン幕張,*127,千葉,532,や,2019/8/20 18:07,2-1_all_corrected,75,54,301,241,376,295
186843,30110_20190820180803.jpg,イオン金沢八景,5884,横浜,583,て,2019/8/20 18:07,2-1_all_corrected,72,54,284,232,356,286
186629,30111_20190820171456.jpg,イオン稲毛,3605,袖ヶ浦,100,さ,2019/8/20 17:14,2-1_all_corrected,54,46,263,153,317,199
185255,30110_20190820113022.jpg,イオン金沢八景,*996,横浜,50,や,2019/8/20 11:30,2-1_all_corrected,73,55,422,190,495,245
184989,30072_20190820094142.jpg,関西スーパー京阪大和田１F,1001,大阪,31,ひ,2019/8/20 9:41,2-1_all_corrected,74,60,98,308,172,368
179430,30091_20190817183050.jpg,イトーヨーカドー木場 立体,*777,水戸,313,る,2019/8/17 18:30,2-1_all_corrected,55,44,268,69,323,113
179054,30144_20190817161038.jpg,イオン幕張,2108,習志野,530,め,2019/8/17 16:10,2-1_all_corrected,57,44,193,153,250,197
179295,30045_20190817174015.jpg,マックスバリュー徳川明倫,2525,名古屋,31,そ,2019/8/17 17:39,2-1_all_corrected,68,56,210,213,278,269
179204,30111_20190817170755.jpg,イオン稲毛,*209,練馬,332,め,2019/8/17 17:07,2-1_all_corrected,68,57,271,181,339,238
179658,30169_20190817201559.jpg,イオン相模原ショッピングセンター,*148,相模,330,は,2019/8/17 20:15,2-1_all_corrected,74,56,364,204,438,260
179235,30169_20190817171813.jpg,イオン相模原ショッピングセンター,*318,相模,584,あ,2019/8/17 17:17,2-1_all_corrected,79,69,278,101,357,170
179463,30144_20190817184456.jpg,イオン幕張,6869,習志野,501,ひ,2019/8/17 18:44,2-1_all_corrected,80,53,280,300,360,353
178748,30045_20190817134151.jpg,マックスバリュー徳川明倫,**18,名古屋,31,さ,2019/8/17 13:41,2-1_all_corrected,52,46,161,194,213,240
179656,30144_20190817201506.jpg,イオン幕張,*339,千葉,301,ろ,2019/8/17 20:14,2-1_all_corrected,84,62,390,345,474,407
179251,30169_20190817172330.jpg,イオン相模原ショッピングセンター,5572,相模,330,せ,2019/8/17 17:22,2-1_all_corrected,81,64,267,95,348,159
178713,30169_20190817132123.jpg,イオン相模原ショッピングセンター,5451,相模,301,は,2019/8/17 13:20,2-1_all_corrected,78,60,323,74,401,134
178941,30110_20190817151648.jpg,イオン金沢八景,*700,横浜,346,や,2019/8/17 15:16,2-1_all_corrected,45,32,337,43,382,75
179269,30072_20190817172843.jpg,関西スーパー京阪大和田１F,3983,大阪,583,え,2019/8/17 17:28,2-1_all_corrected,110,90,45,327,155,417
178510,30078_20190817112636.jpg,イオンスタイル仙台卸町店,9999,山形,335,ゆ,2019/8/17 11:26,2-1_all_corrected,92,70,209,289,301,359
178346,30111_20190817101058.jpg,イオン稲毛,1443,習志野,583,あ,2019/8/17 10:10,2-1_all_corrected,80,60,232,259,312,319
179055,30169_20190817161204.jpg,イオン相模原ショッピングセンター,***5,相模,363,す,2019/8/17 16:11,2-1_all_corrected,83,64,311,103,394,167
179293,30144_20190817173914.jpg,イオン幕張,1623,千葉,534,な,2019/8/17 17:38,2-1_all_corrected,75,48,190,239,265,287
179657,30169_20190817201553.jpg,イオン相模原ショッピングセンター,*148,相模,330,は,2019/8/17 20:15,2-1_all_corrected,74,56,364,204,438,260
179233,30157_20190817171742.jpg,関西スーパー中央,6031,神戸,530,そ,2019/8/17 17:17,2-1_all_corrected,43,75,413,171,456,246
179496,30169_20190817185844.jpg,イオン相模原ショッピングセンター,3196,多摩,100,せ,2019/8/17 18:58,2-1_all_corrected,85,68,352,275,437,343
178312,30090_20190817095335.jpg,イトーヨーカドー木場 西棟,*724,足立,533,せ,2019/8/17 9:53,2-1_all_corrected,91,67,366,354,457,421
179205,30169_20190817170812.jpg,イオン相模原ショッピングセンター,*826,相模,532,な,2019/8/17 17:07,2-1_all_corrected,81,62,331,99,412,161
178581,30144_20190817115705.jpg,イオン幕張,2662,千葉,531,さ,2019/8/17 11:56,2-1_all_corrected,63,42,186,162,249,204
178575,30169_20190817115345.jpg,イオン相模原ショッピングセンター,6000,相模,339,そ,2019/8/17 11:53,2-1_all_corrected,96,78,162,350,258,428
178894,30006_20190817145031.jpg,スギ薬局南千里,8825,京都,331,そ,2019/8/17 14:50,2-1_all_corrected,102,59,353,69,455,128
179521,30072_20190817191153.jpg,関西スーパー京阪大和田１F,1722,なにわ,830,あ,2019/8/17 19:11,2-1_all_corrected,66,60,42,156,108,216
179377,30169_20190817181117.jpg,イオン相模原ショッピングセンター,9917,八王子,301,そ,2019/8/17 18:10,2-1_all_corrected,68,56,224,140,292,196
179142,30070_20190817164849.jpg,カナートモール住道第一,***2,大阪,30,も,2019/8/17 16:48,2-1_all_corrected,89,70,62,321,151,391
178632,30078_20190817123056.jpg,イオンスタイル仙台卸町店,*386,宮城,583,そ,2019/8/17 12:30,2-1_all_corrected,68,54,210,89,278,143
178858,30169_20190817143321.jpg,イオン相模原ショッピングセンター,7681,八王子,300,ほ,2019/8/17 14:32,2-1_all_corrected,55,40,447,0,502,40
178604,30168_20190817121314.jpg,イオン東雲店（屋上）,3527,品川,580,さ,2019/8/17 12:12,2-1_all_corrected,71,56,303,182,374,238
178436,30144_20190817105240.jpg,イオン幕張,1118,千葉,548,つ,2019/8/17 10:52,2-1_all_corrected,56,42,228,163,284,205
178856,30169_20190817143044.jpg,イオン相模原ショッピングセンター,3141,長崎,300,に,2019/8/17 14:30,2-1_all_corrected,94,67,273,134,367,201
179341,30029_20190817175525.jpg,ビッグダウン町田忠生,***5,多摩,30,そ,2019/8/17 17:54,2-1_all_corrected,59,38,173,225,232,263
178462,30110_20190817110444.jpg,イオン金沢八景,3247,横浜,330,ふ,2019/8/17 11:04,2-1_all_corrected,84,68,228,279,312,347
179324,30144_20190817175111.jpg,イオン幕張,5891,千葉,530,せ,2019/8/17 17:50,2-1_all_corrected,63,43,264,201,327,244
179116,30144_20190817164205.jpg,イオン幕張,1150,千葉,583,す,2019/8/17 16:41,2-1_all_corrected,53,40,120,127,173,167
178666,30062_20190817124647.jpg,ミスミモール,**18,神戸,31,ち,2019/8/17 12:46,2-1_all_corrected,70,59,278,157,348,216
178833,30066_20190817142353.jpg,ジョーシン和泉中央,1000,和泉,30,な,2019/8/17 14:23,2-1_all_corrected,49,36,395,89,444,125
178498,30111_20190817112045.jpg,イオン稲毛,5678,袖ヶ浦,503,ひ,2019/8/17 11:19,2-1_all_corrected,72,52,284,160,356,212
179516,30169_20190817190903.jpg,イオン相模原ショッピングセンター,*318,横浜,359,ね,2019/8/17 19:08,2-1_all_corrected,89,78,87,312,176,390
179347,30169_20190817175600.jpg,イオン相模原ショッピングセンター,4981,相模,501,み,2019/8/17 17:55,2-1_all_corrected,54,45,148,95,202,140
179188,30062_20190817170128.jpg,ミスミモール,**18,神戸,31,ち,2019/8/17 17:00,2-1_all_corrected,58,45,376,139,434,184
179385,30072_20190817181454.jpg,関西スーパー京阪大和田１F,2207,神戸,331,み,2019/8/17 18:13,2-1_all_corrected,79,60,359,212,438,272
178660,30111_20190817124319.jpg,イオン稲毛,4272,千葉,580,つ,2019/8/17 12:42,2-1_all_corrected,71,59,336,216,407,275
178463,30003_20190817110504.jpg,ならコープ学園前店,3415,奈良,330,つ,2019/8/17 11:04,2-1_all_corrected,82,61,388,88,470,149
179121,30144_20190817164348.jpg,イオン幕張,6779,習志野,301,す,2019/8/17 16:43,2-1_all_corrected,94,72,342,337,436,409
178804,30169_20190817140835.jpg,イオン相模原ショッピングセンター,6685,静岡,33,て,2019/8/17 14:08,2-1_all_corrected,54,40,211,131,265,171
179119,30110_20190817164310.jpg,イオン金沢八景,5763,横浜,330,て,2019/8/17 16:42,2-1_all_corrected,62,62,2,208,64,270
178821,30167_20190817141509.jpg,イオン東雲店,1583,足立,530,う,2019/8/17 14:13,2-1_all_corrected,71,57,233,221,304,278
179752,30078_20190817211433.jpg,イオンスタイル仙台卸町店,1001,いわき,346,つ,2019/8/17 21:14,2-1_all_corrected,83,67,145,216,228,283
178674,30144_20190817125114.jpg,イオン幕張,*718,成田,530,ほ,2019/8/17 12:50,2-1_all_corrected,73,54,260,218,333,272
178826,30070_20190817141956.jpg,カナートモール住道第一,1122,大阪,31,む,2019/8/17 14:19,2-1_all_corrected,83,61,71,237,154,298
179331,30144_20190817175326.jpg,イオン幕張,2814,千葉,330,て,2019/8/17 17:53,2-1_all_corrected,62,39,252,144,314,183
179103,30144_20190817163534.jpg,イオン幕張,4702,千葉,581,そ,2019/8/17 16:35,2-1_all_corrected,57,43,204,151,261,194
179551,30157_20190817192509.jpg,関西スーパー中央,**55,神戸,31,め,2019/8/17 19:24,2-1_all_corrected,68,54,144,393,212,447
178817,30110_20190817141347.jpg,イオン金沢八景,5356,横浜,583,い,2019/8/17 14:13,2-1_all_corrected,85,77,98,237,183,314
179300,30111_20190817174106.jpg,イオン稲毛,7893,千葉,581,さ,2019/8/17 17:40,2-1_all_corrected,74,59,278,205,352,264
179790,30090_20190817215123.jpg,イトーヨーカドー木場 西棟,3605,練馬,330,つ,2019/8/17 21:50,2-1_all_corrected,54,38,281,191,335,229
178286,30167_20190817093021.jpg,イオン東雲店,**21,千葉,347,の,2019/8/17 9:29,2-1_all_corrected,75,53,214,224,289,277
178424,30091_20190817104756.jpg,イトーヨーカドー木場 立体,9708,足立,502,ち,2019/8/17 10:47,2-1_all_corrected,62,33,248,199,310,232
178629,30072_20190817123002.jpg,関西スーパー京阪大和田１F,1001,大阪,31,ひ,2019/8/17 12:29,2-1_all_corrected,70,53,261,238,331,291
179161,30144_20190817165316.jpg,イオン幕張,**79,千葉,331,み,2019/8/17 16:52,2-1_all_corrected,83,59,253,290,336,349
179708,30167_20190817204541.jpg,イオン東雲店,1517,世田谷,480,り,2019/8/17 20:45,2-1_all_corrected,78,58,72,391,150,449
179150,30167_20190817165022.jpg,イオン東雲店,**77,多摩,324,せ,2019/8/17 16:49,2-1_all_corrected,56,45,337,155,393,200
178620,30144_20190817122242.jpg,イオン幕張,8008,千葉,563,す,2019/8/17 12:22,2-1_all_corrected,76,48,255,228,331,276
178482,30072_20190817111511.jpg,関西スーパー京阪大和田１F,1089,大阪,581,ふ,2019/8/17 11:13,2-1_all_corrected,85,82,0,303,85,385
179550,30072_20190817192500.jpg,関西スーパー京阪大和田１F,2207,神戸,331,み,2019/8/17 19:24,2-1_all_corrected,52,40,245,88,297,128
179753,30078_20190817211434.jpg,イオンスタイル仙台卸町店,1001,いわき,346,つ,2019/8/17 21:14,2-1_all_corrected,85,66,144,228,229,294
179105,30144_20190817163618.jpg,イオン幕張,2441,千葉,581,ち,2019/8/17 16:35,2-1_all_corrected,56,45,94,141,150,186
179364,30144_20190817180450.jpg,イオン幕張,5972,千葉,502,ゆ,2019/8/17 18:04,2-1_all_corrected,76,53,235,217,311,270
178887,30045_20190817144726.jpg,マックスバリュー徳川明倫,***3,岐阜,30,や,2019/8/17 14:46,2-1_all_corrected,68,54,201,257,269,311
179160,30106_20190817165306.jpg,ジョーシン東大阪長田,***1,大阪,30,ふ,2019/8/17 16:52,2-1_all_corrected,69,56,232,222,301,278
179194,30169_20190817170402.jpg,イオン相模原ショッピングセンター,3706,相模,580,ゆ,2019/8/17 17:03,2-1_all_corrected,58,45,368,28,426,73
178610,30072_20190817121749.jpg,関西スーパー京阪大和田１F,4668,大阪,503,は,2019/8/17 12:17,2-1_all_corrected,77,57,5,213,82,270
179218,30062_20190817171058.jpg,ミスミモール,8888,神戸,30,む,2019/8/17 17:10,2-1_all_corrected,54,42,413,116,467,158
179482,30091_20190817185232.jpg,イトーヨーカドー木場 立体,1103,足立,368,そ,2019/8/17 18:51,2-1_all_corrected,49,38,285,92,334,130
178306,30072_20190817094714.jpg,関西スーパー京阪大和田１F,6337,大阪,580,め,2019/8/17 9:46,2-1_all_corrected,75,59,24,170,99,229
179644,30110_20190817201012.jpg,イオン金沢八景,*345,横浜,339,な,2019/8/17 20:09,2-1_all_corrected,68,55,221,121,289,176
179023,30039_20190817155425.jpg,イトーヨーカドー大井町,*718,品川,951,な,2019/8/17 15:53,2-1_all_corrected,66,59,273,105,339,164
179211,30111_20190817170932.jpg,イオン稲毛,9999,千葉,589,そ,2019/8/17 17:08,2-1_all_corrected,54,40,317,186,371,226
179083,30169_20190817162522.jpg,イオン相模原ショッピングセンター,2418,相模,330,ま,2019/8/17 16:24,2-1_all_corrected,59,44,403,13,462,57
179289,30066_20190817173701.jpg,ジョーシン和泉中央,***8,和泉,30,ら,2019/8/17 17:36,2-1_all_corrected,71,54,238,205,309,259
179280,30009_20190817173339.jpg,西友新北習志野,*290,習志野,330,な,2019/8/17 17:33,2-1_all_corrected,169,101,310,0,479,101
178938,30169_20190817151354.jpg,イオン相模原ショッピングセンター,***3,多摩,513,み,2019/8/17 15:13,2-1_all_corrected,82,71,376,312,458,383
179228,30014_20190817171528.jpg,フォルテ蘇我ベルク棟,***5,千葉,30,る,2019/8/17 17:15,2-1_all_corrected,54,38,129,22,183,60
178567,30091_20190817115110.jpg,イトーヨーカドー木場 立体,7309,沼津,300,め,2019/8/17 11:50,2-1_all_corrected,66,54,130,183,196,237
178936,30078_20190817151212.jpg,イオンスタイル仙台卸町店,*775,仙台,583,く,2019/8/17 15:11,2-1_all_corrected,75,53,252,227,327,280
178307,30072_20190817094720.jpg,関西スーパー京阪大和田１F,6337,大阪,580,め,2019/8/17 9:46,2-1_all_corrected,69,56,258,119,327,175
179040,30144_20190817160300.jpg,イオン幕張,9107,千葉,503,す,2019/8/17 16:02,2-1_all_corrected,51,35,126,89,177,124
179272,30169_20190817172926.jpg,イオン相模原ショッピングセンター,*619,相模,532,ま,2019/8/17 17:29,2-1_all_corrected,81,62,293,98,374,160
179076,30169_20190817162340.jpg,イオン相模原ショッピングセンター,*298,横浜,481,れ,2019/8/17 16:23,2-1_all_corrected,71,59,258,100,329,159
178998,30144_20190817154210.jpg,イオン幕張,4070,北九州,300,の,2019/8/17 15:41,2-1_all_corrected,83,60,263,305,346,365
178953,30144_20190817152108.jpg,イオン幕張,2916,大阪,72,た,2019/8/17 15:20,2-1_all_corrected,50,35,220,76,270,111
178739,30085_20190817133452.jpg,業務スーパー南津守,*111,なにわ,30,は,2019/8/17 13:34,2-1_all_corrected,46,51,70,305,116,356
178570,30111_20190817115220.jpg,イオン稲毛,9218,千葉,500,つ,2019/8/17 11:51,2-1_all_corrected,43,35,83,87,126,122
179207,30045_20190817170850.jpg,マックスバリュー徳川明倫,***3,名古屋,30,は,2019/8/17 17:08,2-1_all_corrected,44,36,272,116,316,152
178919,30110_20190817150037.jpg,イオン金沢八景,7080,横浜,333,り,2019/8/17 15:00,2-1_all_corrected,47,33,401,79,448,112
179493,30062_20190817185808.jpg,ミスミモール,1188,神戸,31,さ,2019/8/17 18:57,2-1_all_corrected,65,61,223,156,288,217
179004,30110_20190817154535.jpg,イオン金沢八景,**21,横浜,586,に,2019/8/17 15:45,2-1_all_corrected,69,56,156,123,225,179
179236,30111_20190817171819.jpg,イオン稲毛,*130,千葉,587,け,2019/8/17 17:17,2-1_all_corrected,56,43,328,155,384,198
179699,30169_20190817204020.jpg,イオン相模原ショッピングセンター,*315,相模,339,も,2019/8/17 20:39,2-1_all_corrected,89,72,434,377,523,449
178972,30110_20190817153008.jpg,イオン金沢八景,5861,横浜,532,つ,2019/8/17 15:29,2-1_all_corrected,75,56,98,230,173,286
179433,30110_20190817183250.jpg,イオン金沢八景,3570,横浜,331,む,2019/8/17 18:32,2-1_all_corrected,82,63,209,352,291,415
179298,30169_20190817174026.jpg,イオン相模原ショッピングセンター,8424,相模,301,て,2019/8/17 17:40,2-1_all_corrected,52,38,141,81,193,119
178944,30169_20190817151823.jpg,イオン相模原ショッピングセンター,3500,相模,331,は,2019/8/17 15:17,2-1_all_corrected,55,42,398,133,453,175
179637,30144_20190817200817.jpg,イオン幕張,*215,千葉,301,め,2019/8/17 20:07,2-1_all_corrected,75,52,122,210,197,262
178943,30169_20190817151818.jpg,イオン相模原ショッピングセンター,3500,相模,331,ほ,2019/8/17 15:17,2-1_all_corrected,52,43,402,135,454,178
179402,30103_20190817182052.jpg,八尾老原１丁目,*111,大阪,30,ね,2019/8/17 18:20,2-1_all_corrected,45,44,256,136,301,180
178372,30001_20190817102856.jpg,関西スーパー高石駅前,2796,和泉,502,ち,2019/8/17 10:28,2-1_all_corrected,72,54,373,96,445,150
179005,30110_20190817154550.jpg,イオン金沢八景,7010,川崎,332,も,2019/8/17 15:45,2-1_all_corrected,84,70,140,253,224,323
179653,30169_20190817201401.jpg,イオン相模原ショッピングセンター,*310,多摩,362,も,2019/8/17 20:13,2-1_all_corrected,85,65,278,102,363,167
179206,30014_20190817170844.jpg,フォルテ蘇我ベルク棟,***3,千葉,30,ね,2019/8/17 17:08,2-1_all_corrected,65,56,112,46,177,102
178585,30072_20190817115822.jpg,関西スーパー京阪大和田１F,***8,奈良,30,ひ,2019/8/17 11:57,2-1_all_corrected,52,42,102,117,154,159
179665,30078_20190817201858.jpg,イオンスタイル仙台卸町店,1783,仙台,330,せ,2019/8/17 20:18,2-1_all_corrected,72,54,268,88,340,142
178942,30169_20190817151813.jpg,イオン相模原ショッピングセンター,*916,相模,531,ふ,2019/8/17 15:17,2-1_all_corrected,73,53,373,169,446,222
178525,30111_20190817113239.jpg,イオン稲毛,9236,千葉,530,さ,2019/8/17 11:31,2-1_all_corrected,55,47,211,156,266,203
178710,30169_20190817132009.jpg,イオン相模原ショッピングセンター,9975,横浜,504,み,2019/8/17 13:19,2-1_all_corrected,83,63,277,128,360,191
178206,30072_20190817080134.jpg,関西スーパー京阪大和田１F,*762,京都,800,せ,2019/8/17 8:01,2-1_all_corrected,93,69,201,381,294,450
178808,30147_20190817141102.jpg,三井のリパーク 厚木文化会館,3745,相模,400,と,2019/8/17 14:09,2-1_all_corrected,61,43,175,209,236,252
178239,30136_20190817084708.jpg,イオンスタイル新百合ヶ丘,*870,内浦,304,く,2019/8/17 8:46,2-1_all_corrected,88,60,44,284,132,344
179743,30110_20190817211012.jpg,イオン金沢八景,**15,横浜,376,や,2019/8/17 21:09,2-1_all_corrected,66,65,4,230,70,295
179728,30079_20190817205730.jpg,ピットデザイン仙台卸町駅前駐車場,*644,仙台,580,の,2019/8/17 20:57,2-1_all_corrected,87,74,196,353,283,427
178864,30167_20190817143603.jpg,イオン東雲店,**88,三河,542,ふ,2019/8/17 14:35,2-1_all_corrected,57,46,319,303,376,349
179141,30169_20190817164843.jpg,イオン相模原ショッピングセンター,1679,多摩,302,ふ,2019/8/17 16:47,2-1_all_corrected,91,73,290,125,381,198
178255,30001_20190817090105.jpg,関西スーパー高石駅前,5143,鳥取,500,ほ,2019/8/17 9:00,2-1_all_corrected,84,60,356,155,440,215
178863,30111_20190817143559.jpg,イオン稲毛,1192,千葉,530,ろ,2019/8/17 14:35,2-1_all_corrected,45,34,88,102,133,136
179719,30110_20190817205138.jpg,イオン金沢八景,6106,横浜,500,ろ,2019/8/17 20:51,2-1_all_corrected,71,60,155,214,226,274
179148,30169_20190817164959.jpg,イオン相模原ショッピングセンター,*733,相模,583,き,2019/8/17 16:49,2-1_all_corrected,69,56,373,44,442,100
178607,30110_20190817121613.jpg,イオン金沢八景,5734,横浜,580,ひ,2019/8/17 12:15,2-1_all_corrected,49,37,389,43,438,80
178690,30167_20190817130220.jpg,イオン東雲店,*516,足立,301,ふ,2019/8/17 13:01,2-1_all_corrected,52,40,323,160,375,200
179113,30169_20190817163902.jpg,イオン相模原ショッピングセンター,5580,八王子,301,た,2019/8/17 16:38,2-1_all_corrected,84,62,307,85,391,147
178836,30110_20190817142430.jpg,イオン金沢八景,6064,横浜,500,ろ,2019/8/17 14:24,2-1_all_corrected,55,41,328,72,383,113
179317,30045_20190817174801.jpg,マックスバリュー徳川明倫,**33,名古屋,31,ほ,2019/8/17 17:47,2-1_all_corrected,52,40,276,130,328,170
179787,30169_20190817214520.jpg,イオン相模原ショッピングセンター,2525,相模,586,て,2019/8/17 21:44,2-1_all_corrected,69,56,142,121,211,177
178655,30070_20190817124044.jpg,カナートモール住道第一,**55,大阪,31,に,2019/8/17 12:40,2-1_all_corrected,87,65,190,195,277,260
178652,30072_20190817123943.jpg,関西スーパー京阪大和田１F,1001,大阪,31,ひ,2019/8/17 12:39,2-1_all_corrected,68,55,444,90,512,145
178296,30078_20190817093652.jpg,イオンスタイル仙台卸町店,1201,秋田,583,あ,2019/8/17 9:36,2-1_all_corrected,74,55,236,133,310,188
179718,30078_20190817205117.jpg,イオンスタイル仙台卸町店,***2,宮城,588,た,2019/8/17 20:50,2-1_all_corrected,72,51,213,127,285,178
178854,30169_20190817143004.jpg,イオン相模原ショッピングセンター,7605,相模,580,と,2019/8/17 14:29,2-1_all_corrected,73,56,325,63,398,119
178291,30144_20190817093249.jpg,イオン幕張,5296,千葉,532,て,2019/8/17 9:32,2-1_all_corrected,49,34,144,82,193,116
178862,30111_20190817143552.jpg,イオン稲毛,*308,千葉,337,ね,2019/8/17 14:35,2-1_all_corrected,56,45,355,158,411,203
179375,30072_20190817181029.jpg,関西スーパー京阪大和田１F,*731,大阪,585,と,2019/8/17 18:10,2-1_all_corrected,68,53,84,111,152,164
179147,30070_20190817164958.jpg,カナートモール住道第一,***2,大阪,30,も,2019/8/17 16:49,2-1_all_corrected,85,63,92,270,177,333
179372,30105_20190817180903.jpg,カスミフードスクエア春日部武里,***7,春日部,354,ふ,2019/8/17 18:08,2-1_all_corrected,74,57,143,294,217,351
179716,30167_20190817205115.jpg,イオン東雲店,1010,足立,315,ろ,2019/8/17 20:50,2-1_all_corrected,58,44,390,324,448,368
179196,30169_20190817170439.jpg,イオン相模原ショッピングセンター,3901,相模,530,も,2019/8/17 17:04,2-1_all_corrected,86,66,298,141,384,207
179501,30157_20190817190149.jpg,関西スーパー中央,**55,神戸,31,め,2019/8/17 19:01,2-1_all_corrected,63,58,489,259,552,317
178205,30073_20190817080120.jpg,関西スーパー京阪大和田２F,*762,京都,800,せ,2019/8/17 8:00,2-1_all_corrected,36,30,64,113,100,143
178416,30045_20190817104209.jpg,マックスバリュー徳川明倫,1122,名古屋,31,ふ,2019/8/17 10:41,2-1_all_corrected,54,43,222,147,276,190
179154,30071_20190817165044.jpg,カナートモール住道第二,***2,大阪,30,も,2019/8/17 16:50,2-1_all_corrected,50,44,336,223,386,267
179530,30078_20190817191537.jpg,イオンスタイル仙台卸町店,**77,仙台,534,る,2019/8/17 19:15,2-1_all_corrected,87,69,159,367,246,436
179590,30078_20190817194057.jpg,イオンスタイル仙台卸町店,8155,仙台,580,に,2019/8/17 19:40,2-1_all_corrected,93,77,89,328,182,405
179335,30169_20190817175420.jpg,イオン相模原ショッピングセンター,*427,相模,530,る,2019/8/17 17:53,2-1_all_corrected,54,42,107,102,161,144
179107,30110_20190817163633.jpg,イオン金沢八景,1473,横浜,330,と,2019/8/17 16:36,2-1_all_corrected,69,80,2,327,71,407
178814,30078_20190817141315.jpg,イオンスタイル仙台卸町店,*901,仙台,580,ぬ,2019/8/17 14:12,2-1_all_corrected,88,59,267,284,355,343
179131,30066_20190817164618.jpg,ジョーシン和泉中央,***5,和泉,30,み,2019/8/17 16:45,2-1_all_corrected,54,44,228,185,282,229
179555,30014_20190817192654.jpg,フォルテ蘇我ベルク棟,***3,千葉,30,む,2019/8/17 19:26,2-1_all_corrected,50,42,162,40,212,82
178646,30072_20190817123821.jpg,関西スーパー京阪大和田１F,8402,大阪,581,さ,2019/8/17 12:37,2-1_all_corrected,73,67,0,170,73,237
179552,30063_20190817192511.jpg,コーナン相模原小山モール,7745,相模,301,そ,2019/8/17 19:24,2-1_all_corrected,64,57,485,122,549,179
179360,30072_20190817180147.jpg,関西スーパー京阪大和田１F,1841,大阪,581,た,2019/8/17 18:01,2-1_all_corrected,40,28,135,28,175,56
179199,30090_20190817170646.jpg,イトーヨーカドー木場 西棟,8918,足立,501,の,2019/8/17 17:06,2-1_all_corrected,79,57,113,279,192,336
179164,30110_20190817165430.jpg,イオン金沢八景,2923,横浜,504,と,2019/8/17 16:54,2-1_all_corrected,49,44,54,171,103,215
179197,30111_20190817170544.jpg,イオン稲毛,3605,袖ヶ浦,100,さ,2019/8/17 17:04,2-1_all_corrected,55,45,266,162,321,207
179761,30169_20190817212334.jpg,イオン相模原ショッピングセンター,**25,相模,583,ら,2019/8/17 21:23,2-1_all_corrected,72,59,323,197,395,256
179137,30072_20190817164813.jpg,関西スーパー京阪大和田１F,3141,大阪,331,つ,2019/8/17 16:47,2-1_all_corrected,41,34,269,41,310,75
179130,30169_20190817164618.jpg,イオン相模原ショッピングセンター,8424,相模,301,て,2019/8/17 16:45,2-1_all_corrected,71,50,207,141,278,191
178212,30072_20190817080632.jpg,関西スーパー京阪大和田１F,2805,なにわ,830,あ,2019/8/17 8:06,2-1_all_corrected,71,61,65,135,136,196
179334,30144_20190817175411.jpg,イオン幕張,2233,千葉,583,も,2019/8/17 17:53,2-1_all_corrected,69,49,339,234,408,283
178703,30078_20190817131216.jpg,イオンスタイル仙台卸町店,8952,仙台,580,は,2019/8/17 13:11,2-1_all_corrected,77,58,198,168,275,226
178393,30110_20190817103714.jpg,イオン金沢八景,5151,横浜,536,は,2019/8/17 10:36,2-1_all_corrected,43,32,445,69,488,101
178956,30072_20190817152131.jpg,関西スーパー京阪大和田１F,1998,大阪,302,や,2019/8/17 15:21,2-1_all_corrected,69,56,167,146,236,202
178951,30078_20190817151959.jpg,イオンスタイル仙台卸町店,7145,仙台,501,つ,2019/8/17 15:19,2-1_all_corrected,82,57,309,268,391,325
179042,30137_20190817160350.jpg,イオンスタイル品川シーサイド,7106,品川,330,つ,2019/8/17 16:03,2-1_all_corrected,86,66,340,232,426,298
178958,30144_20190817152250.jpg,イオン幕張,1018,千葉,347,ほ,2019/8/17 15:22,2-1_all_corrected,53,39,161,91,214,130
179045,30144_20190817160601.jpg,イオン幕張,8181,千葉,538,り,2019/8/17 16:05,2-1_all_corrected,51,35,179,99,230,134
178598,30169_20190817120710.jpg,イオン相模原ショッピングセンター,8556,相模,530,す,2019/8/17 12:06,2-1_all_corrected,80,59,275,100,355,159
179640,30169_20190817200912.jpg,イオン相模原ショッピングセンター,**23,相模,587,え,2019/8/17 20:08,2-1_all_corrected,77,62,410,213,487,275
178766,30045_20190817135045.jpg,マックスバリュー徳川明倫,**88,なにわ,31,め,2019/8/17 13:50,2-1_all_corrected,47,45,533,120,580,165
179215,30066_20190817171014.jpg,ジョーシン和泉中央,1001,和泉,31,と,2019/8/17 17:09,2-1_all_corrected,53,44,328,132,381,176
179276,30144_20190817173145.jpg,イオン幕張,4133,千葉,330,に,2019/8/17 17:31,2-1_all_corrected,61,38,197,146,258,184
179086,30110_20190817162619.jpg,イオン金沢八景,4444,大宮,535,つ,2019/8/17 16:25,2-1_all_corrected,63,65,50,315,113,380
178702,30070_20190817131007.jpg,カナートモール住道第一,1000,大阪,30,は,2019/8/17 13:09,2-1_all_corrected,56,41,252,97,308,138
178359,30139_20190817102146.jpg,イオン板橋ショッピングセンター,***1,練馬,30,ね,2019/8/17 10:21,2-1_all_corrected,69,53,190,246,259,299
179641,30111_20190817200917.jpg,イオン稲毛,2139,千葉,581,え,2019/8/17 20:08,2-1_all_corrected,57,45,159,162,216,207
178793,30062_20190817140428.jpg,ミスミモール,1010,神戸,31,ゆ,2019/8/17 14:04,2-1_all_corrected,72,56,343,162,415,218
179225,30169_20190817171437.jpg,イオン相模原ショッピングセンター,*627,相模,580,の,2019/8/17 17:14,2-1_all_corrected,76,63,301,176,377,239
188969,30137_20190821174948.jpg,イオンスタイル品川シーサイド,**27,品川,583,さ,2019/8/21 17:49,2-1_all_corrected,56,44,244,140,300,184
189625,30110_20190821202246.jpg,イオン金沢八景,*222,横浜,355,も,2019/8/21 20:22,2-1_all_corrected,67,57,143,177,210,234
189042,30169_20190821180616.jpg,イオン相模原ショッピングセンター,8610,多摩,503,は,2019/8/21 18:05,2-1_all_corrected,86,67,343,270,429,337
188958,30167_20190821174630.jpg,イオン東雲店,7411,足立,230,さ,2019/8/21 17:46,2-1_all_corrected,76,55,358,369,434,424
189421,30169_20190821192445.jpg,イオン相模原ショッピングセンター,*112,相模,335,ね,2019/8/21 19:24,2-1_all_corrected,68,56,406,23,474,79
188960,30111_20190821174650.jpg,イオン稲毛,*731,千葉,339,も,2019/8/21 17:45,2-1_all_corrected,69,51,309,165,378,216
188598,30138_20190821151827.jpg,イオンスタイル湘南茅ヶ崎,***6,湘南,540,ね,2019/8/21 15:17,2-1_all_corrected,71,54,271,262,342,316
188553,30078_20190821145907.jpg,イオンスタイル仙台卸町店,3657,仙台,580,さ,2019/8/21 14:58,2-1_all_corrected,76,56,208,156,284,212
188305,30167_20190821131528.jpg,イオン東雲店,3698,品川,302,む,2019/8/21 13:13,2-1_all_corrected,34,34,0,5,34,39
188137,30110_20190821120613.jpg,イオン金沢八景,8311,横浜,581,こ,2019/8/21 12:05,2-1_all_corrected,70,66,31,316,101,382
189029,30072_20190821180310.jpg,関西スーパー京阪大和田１F,2883,大阪,503,み,2019/8/21 18:01,2-1_all_corrected,86,65,51,213,137,278
189640,30111_20190821202643.jpg,イオン稲毛,4257,千葉,502,ふ,2019/8/21 20:26,2-1_all_corrected,70,50,307,175,377,225
189472,30072_20190821193711.jpg,関西スーパー京阪大和田１F,*717,大阪,587,ら,2019/8/21 19:36,2-1_all_corrected,76,65,26,172,102,237
189444,30169_20190821192939.jpg,イオン相模原ショッピングセンター,1228,多摩,583,ほ,2019/8/21 19:29,2-1_all_corrected,69,55,143,146,212,201
189488,30157_20190821194100.jpg,関西スーパー中央,3805,神戸,581,よ,2019/8/21 19:40,2-1_all_corrected,51,44,184,285,235,329
189027,30072_20190821180205.jpg,関西スーパー京阪大和田１F,2700,大阪,503,み,2019/8/21 18:01,2-1_all_corrected,72,58,14,175,86,233
188539,30144_20190821145601.jpg,イオン幕張,5211,千葉,531,て,2019/8/21 14:55,2-1_all_corrected,75,54,280,236,355,290
188966,30144_20190821174847.jpg,イオン幕張,2729,千葉,502,ね,2019/8/21 17:48,2-1_all_corrected,77,58,405,283,482,341
188992,30144_20190821175341.jpg,イオン幕張,***4,習志野,34,み,2019/8/21 17:53,2-1_all_corrected,62,43,202,210,264,253
189081,30144_20190821181218.jpg,イオン幕張,*327,千葉,540,ろ,2019/8/21 18:11,2-1_all_corrected,57,42,182,151,239,193
189247,30169_20190821184344.jpg,イオン相模原ショッピングセンター,**10,多摩,381,の,2019/8/21 18:43,2-1_all_corrected,49,38,153,121,202,159
189411,30111_20190821192235.jpg,イオン稲毛,*522,千葉,583,の,2019/8/21 19:22,2-1_all_corrected,56,44,194,188,250,232
187918,30167_20190821104339.jpg,イオン東雲店,3641,足立,302,す,2019/8/21 10:43,2-1_all_corrected,81,71,154,193,235,264
189278,30063_20190821185143.jpg,コーナン相模原小山モール,1660,相模,530,つ,2019/8/21 18:51,2-1_all_corrected,52,50,50,219,102,269
189086,30169_20190821181245.jpg,イオン相模原ショッピングセンター,9909,品川,302,は,2019/8/21 18:12,2-1_all_corrected,55,42,131,105,186,147
188957,30101_20190821174623.jpg,にしてつストアレガネット姪浜,**55,福岡,31,ね,2019/8/21 17:45,2-1_all_corrected,57,43,229,224,286,267
188769,30001_20190821162435.jpg,関西スーパー高石駅前,9838,和泉,581,い,2019/8/21 16:24,2-1_all_corrected,103,75,137,361,240,436
188903,30111_20190821172352.jpg,イオン稲毛,1232,千葉,530,る,2019/8/21 17:23,2-1_all_corrected,59,44,373,153,432,197
189683,30111_20190821205312.jpg,イオン稲毛,2459,千葉,302,ね,2019/8/21 20:52,2-1_all_corrected,50,38,132,129,182,167
189814,30072_20190821214359.jpg,関西スーパー京阪大和田１F,8664,大阪,504,す,2019/8/21 21:43,2-1_all_corrected,68,53,71,124,139,177
189017,30046_20190821180045.jpg,マミーマート船橋日大[地上],*472,習志野,583,う,2019/8/21 17:59,2-1_all_corrected,50,40,272,76,322,116
189679,30169_20190821205007.jpg,イオン相模原ショッピングセンター,3311,相模,331,は,2019/8/21 20:49,2-1_all_corrected,99,86,102,265,201,351
188552,30060_20190821145843.jpg,関西スーパー小野原,5689,大阪,480,の,2019/8/21 14:58,2-1_all_corrected,66,59,207,267,273,326
189480,30169_20190821193841.jpg,イオン相模原ショッピングセンター,4793,多摩,580,と,2019/8/21 19:37,2-1_all_corrected,48,38,66,70,114,108
187942,30168_20190821105218.jpg,イオン東雲店（屋上）,6666,大宮,353,み,2019/8/21 10:51,2-1_all_corrected,82,70,431,135,513,205
189350,30111_20190821191154.jpg,イオン稲毛,6606,習志野,501,ゆ,2019/8/21 19:11,2-1_all_corrected,57,48,226,165,283,213
188285,30045_20190821130456.jpg,マックスバリュー徳川明倫,*358,名古屋,32,と,2019/8/21 13:04,2-1_all_corrected,56,45,259,155,315,200
189368,30111_20190821191316.jpg,イオン稲毛,1963,習志野,304,つ,2019/8/21 19:12,2-1_all_corrected,48,35,151,102,199,137
189395,30169_20190821191939.jpg,イオン相模原ショッピングセンター,7312,相模,330,て,2019/8/21 19:19,2-1_all_corrected,64,57,76,258,140,315
188876,30111_20190821171711.jpg,イオン稲毛,*815,千葉,341,す,2019/8/21 17:16,2-1_all_corrected,49,42,204,124,253,166
189154,30091_20190821182606.jpg,イトーヨーカドー木場 立体,3204,足立,330,ね,2019/8/21 18:25,2-1_all_corrected,86,64,115,281,201,345
189366,30014_20190821191307.jpg,フォルテ蘇我ベルク棟,6737,千葉,-1,か,2019/8/21 19:12,2-1_all_corrected,37,36,225,197,262,233
188871,30060_20190821171453.jpg,関西スーパー小野原,5689,大阪,480,の,2019/8/21 17:14,2-1_all_corrected,81,67,250,327,331,394
188442,30167_20190821140805.jpg,イオン東雲店,*673,春日部,880,り,2019/8/21 14:07,2-1_all_corrected,69,62,185,203,254,265
187897,30167_20190821102806.jpg,イオン東雲店,5640,足立,481,り,2019/8/21 10:27,2-1_all_corrected,38,35,363,61,401,96
189109,30111_20190821181458.jpg,イオン稲毛,9374,千葉,302,そ,2019/8/21 18:13,2-1_all_corrected,59,45,358,139,417,184
189552,30167_20190821200117.jpg,イオン東雲店,*315,足立,348,そ,2019/8/21 20:00,2-1_all_corrected,54,39,304,154,358,193
188848,30144_20190821170901.jpg,イオン幕張,1022,習志野,341,ね,2019/8/21 17:08,2-1_all_corrected,78,55,142,222,220,277
188622,30169_20190821152803.jpg,イオン相模原ショッピングセンター,5597,相模,300,ま,2019/8/21 15:27,2-1_all_corrected,51,43,155,87,206,130
189152,30144_20190821182538.jpg,イオン幕張,**27,千葉,302,ち,2019/8/21 18:25,2-1_all_corrected,58,42,165,175,223,217
189509,30157_20190821194902.jpg,関西スーパー中央,2864,神戸,330,は,2019/8/21 19:48,2-1_all_corrected,53,43,175,298,228,341
189197,30144_20190821183156.jpg,イオン幕張,1923,千葉,530,み,2019/8/21 18:31,2-1_all_corrected,87,63,335,296,422,359
188846,30169_20190821170702.jpg,イオン相模原ショッピングセンター,6244,相模,580,ち,2019/8/21 17:06,2-1_all_corrected,80,64,253,108,333,172
188475,30144_20190821142547.jpg,イオン幕張,***7,野田,586,を,2019/8/21 14:25,2-1_all_corrected,47,35,155,137,202,172
189311,30111_20190821190139.jpg,イオン稲毛,8428,千葉,530,て,2019/8/21 19:01,2-1_all_corrected,65,55,204,161,269,216
188208,30039_20190821122744.jpg,イトーヨーカドー大井町,*852,相模,480,わ,2019/8/21 12:27,2-1_all_corrected,83,65,222,251,305,316
188801,30144_20190821164000.jpg,イオン幕張,4051,袖ヶ浦,580,ふ,2019/8/21 16:39,2-1_all_corrected,58,41,193,156,251,197
188837,30086_20190821170432.jpg,テックランド大阪りんくう,***3,和泉,30,と,2019/8/21 17:03,2-1_all_corrected,52,37,313,174,365,211
189549,30111_20190821200023.jpg,イオン稲毛,2370,千葉,530,ろ,2019/8/21 19:59,2-1_all_corrected,72,54,320,191,392,245
188468,30144_20190821142245.jpg,イオン幕張,*417,千葉,340,ゆ,2019/8/21 14:22,2-1_all_corrected,47,35,186,70,233,105
189728,30169_20190821211658.jpg,イオン相模原ショッピングセンター,**12,相模,538,た,2019/8/21 21:16,2-1_all_corrected,50,42,80,81,130,123
188403,30001_20190821135630.jpg,関西スーパー高石駅前,4933,堺,530,さ,2019/8/21 13:56,2-1_all_corrected,107,76,358,228,465,304
188299,30046_20190821131252.jpg,マミーマート船橋日大[地上],1368,世田谷,510,さ,2019/8/21 13:12,2-1_all_corrected,55,74,544,290,599,364
188060,30157_20190821114446.jpg,関西スーパー中央,5678,神戸,30,ら,2019/8/21 11:44,2-1_all_corrected,54,39,213,285,267,324
189374,30169_20190821191401.jpg,イオン相模原ショッピングセンター,1207,相模,337,ひ,2019/8/21 19:13,2-1_all_corrected,91,81,405,328,496,409
188855,30167_20190821171003.jpg,イオン東雲店,**21,大宮,431,て,2019/8/21 17:09,2-1_all_corrected,78,58,186,278,264,336
189513,30063_20190821195031.jpg,コーナン相模原小山モール,6130,多摩,330,ね,2019/8/21 19:49,2-1_all_corrected,70,63,508,174,578,237
188200,30111_20190821122553.jpg,イオン稲毛,9514,千葉,530,さ,2019/8/21 12:24,2-1_all_corrected,74,54,256,195,330,249
188697,30111_20190821155439.jpg,イオン稲毛,8666,長野,330,た,2019/8/21 15:53,2-1_all_corrected,74,56,338,177,412,233
188836,30110_20190821170406.jpg,イオン金沢八景,*171,横浜,504,ま,2019/8/21 17:03,2-1_all_corrected,42,30,430,89,472,119
188655,30144_20190821154025.jpg,イオン幕張,1001,千葉,382,つ,2019/8/21 15:39,2-1_all_corrected,60,42,162,156,222,198
188458,30157_20190821141403.jpg,関西スーパー中央,*107,神戸,334,り,2019/8/21 14:13,2-1_all_corrected,44,64,419,212,463,276
187870,30072_20190821100257.jpg,関西スーパー京阪大和田１F,2375,大阪,581,ね,2019/8/21 10:02,2-1_all_corrected,49,36,100,134,149,170
189122,30006_20190821181812.jpg,スギ薬局南千里,***3,大阪,350,み,2019/8/21 18:18,2-1_all_corrected,96,59,363,110,459,169
189176,30111_20190821183036.jpg,イオン稲毛,*153,千葉,11,ち,2019/8/21 18:29,2-1_all_corrected,40,29,442,39,482,68
189718,30110_20190821211340.jpg,イオン金沢八景,5000,横浜,382,ひ,2019/8/21 21:13,2-1_all_corrected,68,55,192,114,260,169
189171,30090_20190821183009.jpg,イトーヨーカドー木場 西棟,2896,静岡,330,と,2019/8/21 18:29,2-1_all_corrected,57,43,323,166,380,209
189343,30144_20190821191025.jpg,イオン幕張,*187,千葉,530,ほ,2019/8/21 19:09,2-1_all_corrected,57,40,223,151,280,191
188862,30111_20190821171106.jpg,イオン稲毛,7807,千葉,580,は,2019/8/21 17:10,2-1_all_corrected,55,43,339,160,394,203
188577,30046_20190821150942.jpg,マミーマート船橋日大[地上],9000,習志野,340,の,2019/8/21 15:09,2-1_all_corrected,75,57,337,101,412,158
188321,30066_20190821132753.jpg,ジョーシン和泉中央,***5,和泉,30,ち,2019/8/21 13:27,2-1_all_corrected,50,41,319,137,369,178
188910,30079_20190821172713.jpg,ピットデザイン仙台卸町駅前駐車場,7833,仙台,501,そ,2019/8/21 17:26,2-1_all_corrected,50,36,341,94,391,130
188125,30111_20190821120011.jpg,イオン稲毛,2137,千葉,331,て,2019/8/21 11:59,2-1_all_corrected,67,56,210,166,277,222
189004,30144_20190821175721.jpg,イオン幕張,5627,千葉,330,ひ,2019/8/21 17:56,2-1_all_corrected,57,42,205,117,262,159
189262,30111_20190821184621.jpg,イオン稲毛,*700,千葉,533,み,2019/8/21 18:45,2-1_all_corrected,50,36,408,83,458,119
189434,30157_20190821192740.jpg,関西スーパー中央,*405,神戸,584,ら,2019/8/21 19:27,2-1_all_corrected,49,38,216,223,265,261
189068,30078_20190821181115.jpg,イオンスタイル仙台卸町店,9641,宮城,581,け,2019/8/21 18:10,2-1_all_corrected,95,58,119,392,214,450
189265,30070_20190821184651.jpg,カナートモール住道第一,**55,大阪,31,に,2019/8/21 18:46,2-1_all_corrected,74,57,320,157,394,214
188944,30144_20190821174203.jpg,イオン幕張,9539,千葉,581,さ,2019/8/21 17:41,2-1_all_corrected,90,59,269,365,359,424
189862,30169_20190821223633.jpg,イオン相模原ショッピングセンター,**77,相模,131,た,2019/8/21 22:36,2-1_all_corrected,78,68,386,289,464,357
188943,30111_20190821174155.jpg,イオン稲毛,*185,千葉,332,つ,2019/8/21 17:40,2-1_all_corrected,69,55,238,153,307,208
188988,30144_20190821175302.jpg,イオン幕張,6866,千葉,583,え,2019/8/21 17:52,2-1_all_corrected,79,55,199,274,278,329
189495,30039_20190821194323.jpg,イトーヨーカドー大井町,*314,品川,533,ゆ,2019/8/21 19:42,2-1_all_corrected,64,64,147,185,211,249
188123,30001_20190821115735.jpg,関西スーパー高石駅前,7788,和泉,556,む,2019/8/21 11:57,2-1_all_corrected,80,55,419,117,499,172
189653,30110_20190821203429.jpg,イオン金沢八景,*501,横浜,352,ゆ,2019/8/21 20:34,2-1_all_corrected,72,65,491,158,563,223
189459,30111_20190821193259.jpg,イオン稲毛,1305,千葉,583,は,2019/8/21 19:32,2-1_all_corrected,57,41,337,164,394,205
188927,30072_20190821173545.jpg,関西スーパー京阪大和田１F,9625,筑豊,500,ふ,2019/8/21 17:35,2-1_all_corrected,53,38,120,65,173,103
188549,30110_20190821145824.jpg,イオン金沢八景,1018,横浜,544,と,2019/8/21 14:57,2-1_all_corrected,73,59,288,200,361,259
188929,30046_20190821173649.jpg,マミーマート船橋日大[地上],2017,習志野,332,て,2019/8/21 17:36,2-1_all_corrected,46,33,193,34,239,67
189457,30079_20190821193236.jpg,ピットデザイン仙台卸町駅前駐車場,2031,仙台,330,て,2019/8/21 19:32,2-1_all_corrected,72,77,130,297,202,374
189033,30072_20190821180429.jpg,関西スーパー京阪大和田１F,3571,大阪,302,ゆ,2019/8/21 18:04,2-1_all_corrected,85,55,23,148,108,203
188916,30072_20190821173216.jpg,関西スーパー京阪大和田１F,5680,大阪,580,め,2019/8/21 17:31,2-1_all_corrected,42,32,191,29,233,61
189636,30063_20190821202541.jpg,コーナン相模原小山モール,1637,相模,330,な,2019/8/21 20:25,2-1_all_corrected,72,57,482,240,554,297
188719,30169_20190821160358.jpg,イオン相模原ショッピングセンター,*751,相模,301,せ,2019/8/21 16:03,2-1_all_corrected,47,38,247,138,294,176
187904,30060_20190821103340.jpg,関西スーパー小野原,7372,なにわ,580,け,2019/8/21 10:33,2-1_all_corrected,73,63,458,225,531,288
188342,30079_20190821133325.jpg,ピットデザイン仙台卸町駅前駐車場,*365,仙台,483,え,2019/8/21 13:33,2-1_all_corrected,80,60,162,390,242,450
188974,30144_20190821175050.jpg,イオン幕張,1278,千葉,333,の,2019/8/21 17:50,2-1_all_corrected,85,56,224,277,309,333
188765,30144_20190821162219.jpg,イオン幕張,6446,千葉,302,に,2019/8/21 16:21,2-1_all_corrected,54,37,174,101,228,138
188901,30111_20190821172319.jpg,イオン稲毛,2184,千葉,583,あ,2019/8/21 17:22,2-1_all_corrected,56,42,350,137,406,179
189440,30045_20190821192847.jpg,マックスバリュー徳川明倫,**77,名古屋,31,ほ,2019/8/21 19:28,2-1_all_corrected,71,63,113,206,184,269
189024,30091_20190821180154.jpg,イトーヨーカドー木場 立体,**17,足立,345,せ,2019/8/21 18:01,2-1_all_corrected,71,52,262,164,333,216
189818,30046_20190821214850.jpg,マミーマート船橋日大[地上],8739,習志野,301,ほ,2019/8/21 21:48,2-1_all_corrected,74,61,404,199,478,260
189447,30111_20190821193041.jpg,イオン稲毛,*223,千葉,345,く,2019/8/21 19:30,2-1_all_corrected,54,42,166,127,220,169
188939,30046_20190821174108.jpg,マミーマート船橋日大[地上],1733,習志野,580,ひ,2019/8/21 17:40,2-1_all_corrected,40,29,212,44,252,73
189413,30045_20190821192304.jpg,マックスバリュー徳川明倫,***3,名古屋,30,は,2019/8/21 19:22,2-1_all_corrected,55,44,204,172,259,216
187748,30157_20190821085848.jpg,関西スーパー中央,8448,なにわ,409,な,2019/8/21 8:58,2-1_all_corrected,49,35,312,256,361,291
188997,30144_20190821175511.jpg,イオン幕張,*822,千葉,586,せ,2019/8/21 17:54,2-1_all_corrected,57,42,238,161,295,203
189287,30110_20190821185429.jpg,イオン金沢八景,6064,横浜,500,る,2019/8/21 18:53,2-1_all_corrected,51,45,346,74,397,119
189217,30167_20190821183836.jpg,イオン東雲店,8787,大宮,480,け,2019/8/21 18:38,2-1_all_corrected,56,44,389,345,445,389
189025,30144_20190821180155.jpg,イオン幕張,***1,品川,300,そ,2019/8/21 18:01,2-1_all_corrected,39,37,213,119,252,156
189448,30132_20190821193043.jpg,イオンスタイル東神奈川,***8,横浜,30,に,2019/8/21 19:30,2-1_all_corrected,54,42,305,190,359,232
189013,30144_20190821175928.jpg,イオン幕張,*178,千葉,544,ひ,2019/8/21 17:59,2-1_all_corrected,74,48,234,236,308,284
187946,30167_20190821105327.jpg,イオン東雲店,4565,千葉,502,せ,2019/8/21 10:53,2-1_all_corrected,52,42,303,263,355,305
188556,30167_20190821150053.jpg,イオン東雲店,7411,足立,230,さ,2019/8/21 15:00,2-1_all_corrected,59,42,337,337,396,379
188965,30144_20190821174821.jpg,イオン幕張,*903,千葉,534,ま,2019/8/21 17:48,2-1_all_corrected,90,61,355,336,445,397
189423,30169_20190821192449.jpg,イオン相模原ショッピングセンター,*112,相模,335,ね,2019/8/21 19:24,2-1_all_corrected,68,56,406,23,474,79
188996,30046_20190821175510.jpg,マミーマート船橋日大[地上],9683,習志野,300,ろ,2019/8/21 17:54,2-1_all_corrected,41,27,180,52,221,79
189627,30039_20190821202324.jpg,イトーヨーカドー大井町,*423,品川,337,ほ,2019/8/21 20:22,2-1_all_corrected,70,59,212,164,282,223
189415,30098_20190821192407.jpg,BRANCH仙台（東棟）,7172,仙台,330,ら,2019/8/21 19:23,2-1_all_corrected,99,73,252,252,351,325
187923,30167_20190821104501.jpg,イオン東雲店,4565,千葉,502,せ,2019/8/21 10:44,2-1_all_corrected,65,55,390,338,455,393
188701,30091_20190821155530.jpg,イトーヨーカドー木場 立体,9100,足立,580,え,2019/8/21 15:55,2-1_all_corrected,55,45,212,169,267,214
188396,30110_20190821135435.jpg,イオン金沢八景,4123,横浜,304,は,2019/8/21 13:54,2-1_all_corrected,78,62,182,200,260,262
188998,30144_20190821175544.jpg,イオン幕張,5325,習志野,501,み,2019/8/21 17:55,2-1_all_corrected,84,55,246,303,330,358
189135,30111_20190821182106.jpg,イオン稲毛,3236,千葉,540,ま,2019/8/21 18:19,2-1_all_corrected,46,34,56,101,102,135
189300,30046_20190821190004.jpg,マミーマート船橋日大[地上],8314,習志野,530,た,2019/8/21 18:59,2-1_all_corrected,44,32,264,56,308,88
188281,30144_20190821130225.jpg,イオン幕張,1118,千葉,560,に,2019/8/21 13:02,2-1_all_corrected,80,65,346,345,426,410
189161,30091_20190821182820.jpg,イトーヨーカドー木場 立体,7777,神戸,361,ゆ,2019/8/21 18:27,2-1_all_corrected,91,68,418,218,509,286
189157,30078_20190821182645.jpg,イオンスタイル仙台卸町店,8750,宮城,580,み,2019/8/21 18:26,2-1_all_corrected,85,65,169,278,254,343
188872,30111_20190821171503.jpg,イオン稲毛,6435,習志野,580,て,2019/8/21 17:14,2-1_all_corrected,55,43,322,138,377,181
188875,30144_20190821171656.jpg,イオン幕張,2814,千葉,330,な,2019/8/21 17:16,2-1_all_corrected,57,40,195,130,252,170
188816,30167_20190821164754.jpg,イオン東雲店,7411,足立,230,さ,2019/8/21 16:47,2-1_all_corrected,53,38,286,283,339,321
189339,30111_20190821190840.jpg,イオン稲毛,1487,千葉,502,ち,2019/8/21 19:08,2-1_all_corrected,46,37,117,98,163,135
188476,30062_20190821142548.jpg,ミスミモール,8888,神戸,30,む,2019/8/21 14:25,2-1_all_corrected,78,59,252,169,330,228
188827,30078_20190821165358.jpg,イオンスタイル仙台卸町店,*263,仙台,500,ろ,2019/8/21 16:53,2-1_all_corrected,92,67,175,379,267,446
188818,30144_20190821164808.jpg,イオン幕張,3885,千葉,530,な,2019/8/21 16:47,2-1_all_corrected,58,43,252,159,310,202
187731,30046_20190821085123.jpg,マミーマート船橋日大[地上],1304,品川,504,わ,2019/8/21 8:51,2-1_all_corrected,76,72,523,278,599,350
189337,30169_20190821190758.jpg,イオン相模原ショッピングセンター,5853,多摩,303,た,2019/8/21 19:07,2-1_all_corrected,85,75,380,275,465,350
189151,30045_20190821182516.jpg,マックスバリュー徳川明倫,*358,名古屋,32,ね,2019/8/21 18:24,2-1_all_corrected,50,39,308,132,358,171
188874,30015_20190821171611.jpg,フォルテ蘇我テナント棟,7455,千葉,-1,か,2019/8/21 17:15,2-1_all_corrected,49,62,147,358,196,420
188048,30111_20190821114143.jpg,イオン稲毛,7681,千葉,530,つ,2019/8/21 11:40,2-1_all_corrected,70,52,350,148,420,200
188873,30144_20190821171601.jpg,イオン幕張,*303,習志野,336,に,2019/8/21 17:15,2-1_all_corrected,70,51,185,160,255,211
188273,30167_20190821125510.jpg,イオン東雲店,7411,足立,230,さ,2019/8/21 12:54,2-1_all_corrected,68,53,401,376,469,429
188041,30072_20190821113748.jpg,関西スーパー京阪大和田１F,*802,大阪,583,い,2019/8/21 11:36,2-1_all_corrected,89,62,340,388,429,450
188889,30111_20190821172034.jpg,イオン稲毛,*501,千葉,583,う,2019/8/21 17:19,2-1_all_corrected,54,46,326,143,380,189
189167,30144_20190821182946.jpg,イオン幕張,**89,千葉,580,と,2019/8/21 18:29,2-1_all_corrected,90,62,311,336,401,398
189142,30105_20190821182257.jpg,カスミフードスクエア春日部武里,3375,大宮,500,る,2019/8/21 18:22,2-1_all_corrected,70,60,107,284,177,344
187875,30001_20190821100856.jpg,関西スーパー高石駅前,1066,和泉,530,ね,2019/8/21 10:08,2-1_all_corrected,105,76,346,294,451,370
187886,30111_20190821101812.jpg,イオン稲毛,1020,千葉,589,め,2019/8/21 10:17,2-1_all_corrected,54,42,351,131,405,173
189120,30078_20190821181739.jpg,イオンスタイル仙台卸町店,*878,仙台,580,ま,2019/8/21 18:17,2-1_all_corrected,68,55,254,131,322,186
189116,30078_20190821181722.jpg,イオンスタイル仙台卸町店,6925,宮城,581,さ,2019/8/21 18:16,2-1_all_corrected,71,53,199,111,270,164
187843,30138_20190821094635.jpg,イオンスタイル湘南茅ヶ崎,2402,湘南,502,と,2019/8/21 9:46,2-1_all_corrected,58,45,228,109,286,154
188695,30167_20190821155407.jpg,イオン東雲店,7401,足立,480,す,2019/8/21 15:53,2-1_all_corrected,72,56,270,180,342,236
188834,30111_20190821170143.jpg,イオン稲毛,3605,袖ヶ浦,100,さ,2019/8/21 17:01,2-1_all_corrected,56,46,263,151,319,197
189778,30167_20190821213817.jpg,イオン東雲店,*826,練馬,332,そ,2019/8/21 21:37,2-1_all_corrected,74,55,140,228,214,283
188266,30085_20190821125103.jpg,業務スーパー南津守,1001,なにわ,31,と,2019/8/21 12:50,2-1_all_corrected,42,46,109,281,151,327
188098,30157_20190821115337.jpg,関西スーパー中央,8448,なにわ,409,な,2019/8/21 11:53,2-1_all_corrected,46,33,550,200,596,233
189385,30144_20190821191632.jpg,イオン幕張,5789,千葉,330,の,2019/8/21 19:16,2-1_all_corrected,73,49,261,216,334,265
189143,30078_20190821182306.jpg,イオンスタイル仙台卸町店,*741,仙台,580,ね,2019/8/21 18:22,2-1_all_corrected,71,59,170,138,241,197
189371,30169_20190821191326.jpg,イオン相模原ショッピングセンター,*557,相模,330,る,2019/8/21 19:12,2-1_all_corrected,92,77,382,353,474,430
188439,30167_20190821140733.jpg,イオン東雲店,*673,春日部,880,り,2019/8/21 14:07,2-1_all_corrected,27,30,19,54,46,84
189144,30144_20190821182309.jpg,イオン幕張,6183,足立,300,せ,2019/8/21 18:22,2-1_all_corrected,50,35,192,102,242,137
189580,30169_20190821200756.jpg,イオン相模原ショッピングセンター,8800,相模,343,そ,2019/8/21 20:07,2-1_all_corrected,77,65,418,291,495,356
189325,30110_20190821190459.jpg,イオン金沢八景,*612,つくば,333,ひ,2019/8/21 19:04,2-1_all_corrected,65,58,478,193,543,251
188651,30144_20190821153755.jpg,イオン幕張,8343,袖ヶ浦,583,き,2019/8/21 15:37,2-1_all_corrected,54,41,195,114,249,155
189313,30169_20190821190200.jpg,イオン相模原ショッピングセンター,1335,相模,580,な,2019/8/21 19:01,2-1_all_corrected,77,64,295,212,372,276
188038,30001_20190821113619.jpg,関西スーパー高石駅前,1783,沖縄,501,ほ,2019/8/21 11:35,2-1_all_corrected,100,69,299,257,399,326
187874,30169_20190821100726.jpg,イオン相模原ショッピングセンター,*426,相模,530,り,2019/8/21 10:07,2-1_all_corrected,85,70,377,269,462,339
189266,30110_20190821184655.jpg,イオン金沢八景,**73,世田谷,583,う,2019/8/21 18:46,2-1_all_corrected,68,57,315,248,383,305
189406,30046_20190821192130.jpg,マミーマート船橋日大[地上],*516,千葉,584,に,2019/8/21 19:20,2-1_all_corrected,72,55,269,210,341,265
189694,30110_20190821205852.jpg,イオン金沢八景,3721,横浜,583,こ,2019/8/21 20:58,2-1_all_corrected,72,59,236,168,308,227
189031,30072_20190821180355.jpg,関西スーパー京阪大和田１F,1715,大阪,531,ほ,2019/8/21 18:03,2-1_all_corrected,53,45,287,111,340,156
189490,30111_20190821194219.jpg,イオン稲毛,1811,奈良,331,え,2019/8/21 19:41,2-1_all_corrected,38,31,455,37,493,68
189464,30110_20190821193329.jpg,イオン金沢八景,**15,横浜,376,れ,2019/8/21 19:32,2-1_all_corrected,70,69,28,240,98,309
189656,30144_20190821203519.jpg,イオン幕張,*611,千葉,302,そ,2019/8/21 20:35,2-1_all_corrected,92,64,244,357,336,421
187909,30144_20190821103927.jpg,イオン幕張,9556,習志野,530,た,2019/8/21 10:39,2-1_all_corrected,64,43,218,230,282,273
189099,30110_20190821181341.jpg,イオン金沢八景,3288,横浜,503,う,2019/8/21 18:13,2-1_all_corrected,38,33,364,16,402,49
188346,30167_20190821133509.jpg,イオン東雲店,1188,川口,312,せ,2019/8/21 13:34,2-1_all_corrected,68,62,106,98,174,160
189001,30144_20190821175618.jpg,イオン幕張,4278,品川,502,た,2019/8/21 17:55,2-1_all_corrected,78,53,233,263,311,316
188771,30167_20190821162536.jpg,イオン東雲店,3535,足立,334,は,2019/8/21 16:25,2-1_all_corrected,67,54,448,352,515,406
189496,30039_20190821194325.jpg,イトーヨーカドー大井町,*311,世田谷,583,う,2019/8/21 19:42,2-1_all_corrected,67,58,248,134,315,192
189462,30110_20190821193319.jpg,イオン金沢八景,**15,横浜,376,い,2019/8/21 19:32,2-1_all_corrected,66,61,523,164,589,225
189453,30157_20190821193146.jpg,関西スーパー中央,*777,神戸,591,ら,2019/8/21 19:31,2-1_all_corrected,56,41,209,351,265,392
189498,30129_20190821194329.jpg,クロスガーデン多摩（４F）,***3,所沢,30,や,2019/8/21 19:42,2-1_all_corrected,67,58,26,281,93,339
188778,30167_20190821162751.jpg,イオン東雲店,3535,足立,334,は,2019/8/21 16:27,2-1_all_corrected,69,52,354,302,423,354
203403,30079_20190826211739.jpg,ピットデザイン仙台卸町駅前駐車場,5910,仙台,330,て,2019/8/26 21:17,2-1_all_corrected,71,59,251,197,322,256
203263,30145_20190826201028.jpg,イオン高根木戸,*525,習志野,583,ね,2019/8/26 20:09,2-1_all_corrected,71,57,351,285,422,342
203297,30110_20190826202326.jpg,イオン金沢八景,*358,横浜,383,ね,2019/8/26 20:23,2-1_all_corrected,57,42,381,82,438,124
202721,30132_20190826175230.jpg,イオンスタイル東神奈川,1124,横浜,536,め,2019/8/26 17:52,2-1_all_corrected,71,60,226,200,297,260
202719,30144_20190826175200.jpg,イオン幕張,1228,千葉,541,ね,2019/8/26 17:51,2-1_all_corrected,72,55,203,218,275,273
202514,30110_20190826163959.jpg,イオン金沢八景,6925,横浜,581,か,2019/8/26 16:39,2-1_all_corrected,66,57,144,230,210,287
203290,30006_20190826202030.jpg,スギ薬局南千里,3388,大阪,541,ち,2019/8/26 20:20,2-1_all_corrected,115,71,260,38,375,109
202124,30157_20190826134324.jpg,関西スーパー中央,5787,神戸,581,の,2019/8/26 13:42,2-1_all_corrected,49,38,244,204,293,242
202918,30144_20190826183759.jpg,イオン幕張,1714,習志野,583,く,2019/8/26 18:37,2-1_all_corrected,89,64,224,338,313,402
202786,30144_20190826180732.jpg,イオン幕張,6625,千葉,330,て,2019/8/26 18:07,2-1_all_corrected,71,49,246,208,317,257
202781,30159_20190826180648.jpg,イオン臼井,4708,千葉,502,と,2019/8/26 18:06,2-1_all_corrected,56,44,276,194,332,238
202775,30045_20190826180435.jpg,マックスバリュー徳川明倫,**10,名古屋,31,つ,2019/8/26 18:04,2-1_all_corrected,52,40,244,155,296,195
203208,30157_20190826194723.jpg,関西スーパー中央,**41,神戸,533,ほ,2019/8/26 19:47,2-1_all_corrected,48,45,123,305,171,350
202929,30132_20190826183936.jpg,イオンスタイル東神奈川,*817,横浜,581,い,2019/8/26 18:39,2-1_all_corrected,80,76,185,351,265,427
201551,30001_20190826095715.jpg,関西スーパー高石駅前,9380,和泉,480,そ,2019/8/26 9:56,2-1_all_corrected,81,64,318,207,399,271
202549,30046_20190826165615.jpg,マミーマート船橋日大[地上],9012,習志野,330,て,2019/8/26 16:55,2-1_all_corrected,43,32,158,22,201,54
202718,30072_20190826175116.jpg,関西スーパー京阪大和田１F,1918,大阪,80,せ,2019/8/26 17:50,2-1_all_corrected,48,33,132,102,180,135
203291,30046_20190826202037.jpg,マミーマート船橋日大[地上],8000,習志野,589,い,2019/8/26 20:20,2-1_all_corrected,75,58,462,307,537,365
202343,30078_20190826153603.jpg,イオンスタイル仙台卸町店,*222,仙台,583,を,2019/8/26 15:35,2-1_all_corrected,54,41,272,67,326,108
202975,30111_20190826184802.jpg,イオン稲毛,1013,千葉,539,そ,2019/8/26 18:47,2-1_all_corrected,67,57,410,227,477,284
202981,30078_20190826184903.jpg,イオンスタイル仙台卸町店,*808,仙台,333,む,2019/8/26 18:48,2-1_all_corrected,86,63,178,230,264,293
202512,30144_20190826163850.jpg,イオン幕張,2925,習志野,330,ま,2019/8/26 16:38,2-1_all_corrected,70,50,290,206,360,256
203262,30009_20190826200957.jpg,西友新北習志野,*730,習志野,580,は,2019/8/26 20:09,2-1_all_corrected,137,116,239,288,376,404
202729,30072_20190826175354.jpg,関西スーパー京阪大和田１F,8087,大阪,580,も,2019/8/26 17:53,2-1_all_corrected,80,58,55,283,135,341
202716,30132_20190826174938.jpg,イオンスタイル東神奈川,1508,横浜,532,ふ,2019/8/26 17:49,2-1_all_corrected,73,56,313,160,386,216
202386,30072_20190826155120.jpg,関西スーパー京阪大和田１F,9223,大阪,581,か,2019/8/26 15:50,2-1_all_corrected,77,61,34,237,111,298
202944,30132_20190826184122.jpg,イオンスタイル東神奈川,1226,横浜,540,せ,2019/8/26 18:40,2-1_all_corrected,74,62,226,173,300,235
201762,30144_20190826112417.jpg,イオン幕張,5577,千葉,502,ま,2019/8/26 11:23,2-1_all_corrected,58,42,183,150,241,192
202122,30078_20190826134308.jpg,イオンスタイル仙台卸町店,2023,仙台,330,に,2019/8/26 13:42,2-1_all_corrected,58,43,263,66,321,109
201595,30014_20190826101939.jpg,フォルテ蘇我ベルク棟,***1,千葉,30,ろ,2019/8/26 10:19,2-1_all_corrected,69,51,159,64,228,115
201939,30110_20190826123413.jpg,イオン金沢八景,2399,横浜,330,に,2019/8/26 12:33,2-1_all_corrected,80,61,178,201,258,262
202780,30132_20190826180626.jpg,イオンスタイル東神奈川,2112,横浜,347,む,2019/8/26 18:06,2-1_all_corrected,72,62,265,160,337,222
203209,30144_20190826194726.jpg,イオン幕張,**11,千葉,364,な,2019/8/26 19:47,2-1_all_corrected,45,43,73,161,118,204
202773,30132_20190826180430.jpg,イオンスタイル東神奈川,1881,横浜,505,す,2019/8/26 18:04,2-1_all_corrected,66,56,297,157,363,213
202854,30132_20190826182418.jpg,イオンスタイル東神奈川,1286,横浜,304,は,2019/8/26 18:23,2-1_all_corrected,77,58,273,167,350,225
203185,30105_20190826193938.jpg,カスミフードスクエア春日部武里,***8,春日部,587,る,2019/8/26 19:39,2-1_all_corrected,68,61,100,284,168,345
202601,30145_20190826171117.jpg,イオン高根木戸,5755,岡山,100,あ,2019/8/26 17:10,2-1_all_corrected,42,33,176,80,218,113
203176,30167_20190826193745.jpg,イオン東雲店,*222,足立,322,そ,2019/8/26 19:37,2-1_all_corrected,55,43,332,267,387,310
202606,30072_20190826171326.jpg,関西スーパー京阪大和田１F,*626,大阪,585,あ,2019/8/26 17:13,2-1_all_corrected,55,44,142,124,197,168
203140,30111_20190826192840.jpg,イオン稲毛,8944,千葉,541,つ,2019/8/26 19:27,2-1_all_corrected,40,33,51,87,91,120
201482,30144_20190826090156.jpg,イオン幕張,1194,千葉,302,ち,2019/8/26 9:01,2-1_all_corrected,71,53,243,212,314,265
203113,30110_20190826192236.jpg,イオン金沢八景,***5,横浜,589,え,2019/8/26 19:21,2-1_all_corrected,53,42,210,144,263,186
203321,30169_20190826203258.jpg,イオン相模原ショッピングセンター,***5,相模,361,ゆ,2019/8/26 20:32,2-1_all_corrected,92,84,80,313,172,397
202690,30111_20190826174313.jpg,イオン稲毛,1026,千葉,339,め,2019/8/26 17:42,2-1_all_corrected,55,43,359,115,414,158
202652,30144_20190826173254.jpg,イオン幕張,6339,大阪,503,み,2019/8/26 17:32,2-1_all_corrected,47,35,208,72,255,107
202838,30144_20190826182031.jpg,イオン幕張,2220,千葉,331,な,2019/8/26 18:20,2-1_all_corrected,71,51,256,197,327,248
202863,30110_20190826182621.jpg,イオン金沢八景,*612,つくば,333,ひ,2019/8/26 18:25,2-1_all_corrected,56,71,5,379,61,450
202609,30111_20190826171607.jpg,イオン稲毛,*982,千葉,503,た,2019/8/26 17:14,2-1_all_corrected,78,67,364,253,442,320
202864,30132_20190826182634.jpg,イオンスタイル東神奈川,7746,横浜,480,つ,2019/8/26 18:26,2-1_all_corrected,58,44,393,207,451,251
201888,30144_20190826121417.jpg,イオン幕張,*333,千葉,342,ひ,2019/8/26 12:13,2-1_all_corrected,62,43,229,183,291,226
202899,30111_20190826183247.jpg,イオン稲毛,1201,千葉,342,る,2019/8/26 18:31,2-1_all_corrected,57,43,342,124,399,167
201872,30103_20190826121023.jpg,八尾老原１丁目,**77,大阪,31,つ,2019/8/26 12:09,2-1_all_corrected,52,42,235,86,287,128
202600,30072_20190826171105.jpg,関西スーパー京阪大和田１F,6185,大阪,302,に,2019/8/26 17:10,2-1_all_corrected,43,31,407,26,450,57
201687,30060_20190826105814.jpg,関西スーパー小野原,8139,大阪,502,せ,2019/8/26 10:57,2-1_all_corrected,53,38,110,208,163,246
202457,30106_20190826161621.jpg,ジョーシン東大阪長田,**11,大阪,31,は,2019/8/26 16:15,2-1_all_corrected,57,44,297,195,354,239
203571,30167_20190826223539.jpg,イオン東雲店,***8,習志野,356,ろ,2019/8/26 22:35,2-1_all_corrected,56,43,301,177,357,220
201470,30111_20190826084940.jpg,イオン稲毛,1020,習志野,585,ら,2019/8/26 8:49,2-1_all_corrected,70,59,247,222,317,281
201810,30111_20190826114335.jpg,イオン稲毛,**77,千葉,359,て,2019/8/26 11:42,2-1_all_corrected,66,55,343,149,409,204
203108,30167_20190826192155.jpg,イオン東雲店,*999,足立,345,ふ,2019/8/26 19:21,2-1_all_corrected,42,35,322,227,364,262
202647,30144_20190826173046.jpg,イオン幕張,*122,袖ヶ浦,586,ち,2019/8/26 17:30,2-1_all_corrected,75,57,362,291,437,348
202824,30132_20190826181713.jpg,イオンスタイル東神奈川,1927,横浜,581,く,2019/8/26 18:16,2-1_all_corrected,72,58,266,167,338,225
202671,30045_20190826173913.jpg,マックスバリュー徳川明倫,***3,名古屋,30,は,2019/8/26 17:38,2-1_all_corrected,68,54,166,195,234,249
203139,30110_20190826192835.jpg,イオン金沢八景,1091,横浜,430,る,2019/8/26 19:28,2-1_all_corrected,65,56,126,160,191,216
202020,30045_20190826130058.jpg,マックスバリュー徳川明倫,*358,名古屋,32,と,2019/8/26 13:00,2-1_all_corrected,49,37,290,147,339,184
202073,30111_20190826131949.jpg,イオン稲毛,1020,千葉,589,め,2019/8/26 13:18,2-1_all_corrected,54,42,165,140,219,182
202625,30111_20190826172407.jpg,イオン稲毛,*340,千葉,331,ね,2019/8/26 17:23,2-1_all_corrected,53,45,191,143,244,188
202870,30132_20190826182842.jpg,イオンスタイル東神奈川,*260,横浜,334,た,2019/8/26 18:28,2-1_all_corrected,73,78,47,320,120,398
202614,30167_20190826171916.jpg,イオン東雲店,7411,足立,230,さ,2019/8/26 17:18,2-1_all_corrected,56,46,483,401,539,447
203138,30111_20190826192834.jpg,イオン稲毛,2807,千葉,530,む,2019/8/26 19:27,2-1_all_corrected,51,37,134,124,185,161
203335,30110_20190826203854.jpg,イオン金沢八景,8000,横浜,356,り,2019/8/26 20:38,2-1_all_corrected,54,45,268,132,322,177
201650,30078_20190826104455.jpg,イオンスタイル仙台卸町店,*212,宮城,584,を,2019/8/26 10:44,2-1_all_corrected,95,62,248,334,343,396
202684,30001_20190826174231.jpg,関西スーパー高石駅前,8407,和泉,501,ひ,2019/8/26 17:42,2-1_all_corrected,73,55,387,78,460,133
202487,30144_20190826162754.jpg,イオン幕張,2344,千葉,502,む,2019/8/26 16:27,2-1_all_corrected,54,37,151,104,205,141
202615,30111_20190826171927.jpg,イオン稲毛,1971,千葉,531,や,2019/8/26 17:17,2-1_all_corrected,65,55,225,133,290,188
202612,30144_20190826171756.jpg,イオン幕張,*877,千葉,480,て,2019/8/26 17:17,2-1_all_corrected,87,66,185,342,272,408
202878,30072_20190826182936.jpg,関西スーパー京阪大和田１F,8326,大阪,581,は,2019/8/26 18:29,2-1_all_corrected,87,62,155,184,242,246
202847,30132_20190826182250.jpg,イオンスタイル東神奈川,*528,川崎,580,き,2019/8/26 18:22,2-1_all_corrected,60,42,332,194,392,236
201603,30072_20190826102254.jpg,関西スーパー京阪大和田１F,4670,大阪,580,ね,2019/8/26 10:22,2-1_all_corrected,44,31,328,7,372,38
202240,30111_20190826144218.jpg,イオン稲毛,1717,足立,356,の,2019/8/26 14:41,2-1_all_corrected,100,130,486,310,586,440
202885,30072_20190826183026.jpg,関西スーパー京阪大和田１F,8326,大阪,581,は,2019/8/26 18:29,2-1_all_corrected,49,39,69,54,118,93
202081,30110_20190826132258.jpg,イオン金沢八景,*181,横浜,333,ま,2019/8/26 13:22,2-1_all_corrected,83,72,216,219,299,291
203153,30132_20190826193212.jpg,イオンスタイル東神奈川,**86,横浜,480,る,2019/8/26 19:31,2-1_all_corrected,76,63,234,373,310,436
202107,30062_20190826133813.jpg,ミスミモール,1010,神戸,31,ゆ,2019/8/26 13:37,2-1_all_corrected,67,63,121,207,188,270
202756,30132_20190826180002.jpg,イオンスタイル東神奈川,1128,相模,335,ぬ,2019/8/26 17:59,2-1_all_corrected,78,57,26,391,104,448
203214,30137_20190826194959.jpg,イオンスタイル品川シーサイド,5395,横浜,300,ろ,2019/8/26 19:49,2-1_all_corrected,51,41,149,26,200,67
202935,30144_20190826184015.jpg,イオン幕張,*895,柏,500,と,2019/8/26 18:39,2-1_all_corrected,83,49,323,257,406,306
202109,30039_20190826133917.jpg,イトーヨーカドー大井町,1115,品川,362,ち,2019/8/26 13:38,2-1_all_corrected,55,44,298,124,353,168
203010,30132_20190826185522.jpg,イオンスタイル東神奈川,*716,横浜,349,に,2019/8/26 18:54,2-1_all_corrected,69,54,271,217,340,271
202758,30132_20190826180020.jpg,イオンスタイル東神奈川,4328,横浜,504,め,2019/8/26 17:59,2-1_all_corrected,73,57,244,186,317,243
202992,30064_20190826185100.jpg,コーナン相模原小山モール（４F）,2917,多摩,503,に,2019/8/26 18:50,2-1_all_corrected,98,76,276,261,374,337
203088,30060_20190826191447.jpg,関西スーパー小野原,9999,大阪,31,り,2019/8/26 19:14,2-1_all_corrected,77,61,493,258,570,319
203420,30079_20190826212840.jpg,ピットデザイン仙台卸町駅前駐車場,7914,仙台,580,に,2019/8/26 21:28,2-1_all_corrected,86,74,201,365,287,439
203044,30111_20190826190417.jpg,イオン稲毛,5691,千葉,500,そ,2019/8/26 19:03,2-1_all_corrected,50,37,384,98,434,135
202995,30078_20190826185136.jpg,イオンスタイル仙台卸町店,*363,仙台,330,た,2019/8/26 18:51,2-1_all_corrected,84,57,198,250,282,307
202702,30072_20190826174718.jpg,関西スーパー京阪大和田１F,7596,大阪,581,と,2019/8/26 17:46,2-1_all_corrected,75,52,98,205,173,257
202530,30137_20190826164615.jpg,イオンスタイル品川シーサイド,8800,仙台,334,ゆ,2019/8/26 16:45,2-1_all_corrected,95,72,232,266,327,338
203072,30072_20190826191057.jpg,関西スーパー京阪大和田１F,4949,大阪,583,す,2019/8/26 19:10,2-1_all_corrected,75,57,259,170,334,227
202957,30144_20190826184426.jpg,イオン幕張,*524,習志野,301,ひ,2019/8/26 18:44,2-1_all_corrected,60,43,145,181,205,224
201948,30053_20190826123536.jpg,マックスバリュ小牧駅西,***5,岐阜,30,り,2019/8/26 12:35,2-1_all_corrected,65,64,357,167,422,231
202153,30001_20190826135518.jpg,関西スーパー高石駅前,1201,和泉,336,ぬ,2019/8/26 13:54,2-1_all_corrected,72,53,443,79,515,132
202950,30046_20190826184230.jpg,マミーマート船橋日大[地上],8414,袖ヶ浦,580,な,2019/8/26 18:42,2-1_all_corrected,42,31,159,103,201,134
202759,30132_20190826180059.jpg,イオンスタイル東神奈川,1231,横浜,350,ひ,2019/8/26 18:00,2-1_all_corrected,74,52,58,398,132,450
202934,30132_20190826184009.jpg,イオンスタイル東神奈川,*104,横浜,537,も,2019/8/26 18:39,2-1_all_corrected,69,56,261,180,330,236
202905,30046_20190826183401.jpg,マミーマート船橋日大[地上],8015,習志野,580,の,2019/8/26 18:33,2-1_all_corrected,38,31,146,79,184,110
202334,30169_20190826153035.jpg,イオン相模原ショッピングセンター,*910,相模,584,つ,2019/8/26 15:30,2-1_all_corrected,88,71,238,157,326,228
202596,30066_20190826170926.jpg,ジョーシン和泉中央,**11,和泉,31,な,2019/8/26 17:08,2-1_all_corrected,55,44,305,158,360,202
203279,30110_20190826201437.jpg,イオン金沢八景,4929,横浜,580,や,2019/8/26 20:14,2-1_all_corrected,55,45,217,210,272,255
203073,30157_20190826191101.jpg,関西スーパー中央,***5,神戸,30,ふ,2019/8/26 19:10,2-1_all_corrected,50,38,107,409,157,447
202969,30046_20190826184656.jpg,マミーマート船橋日大[地上],*801,習志野,337,そ,2019/8/26 18:46,2-1_all_corrected,42,31,149,8,191,39
202358,30144_20190826154229.jpg,イオン幕張,3864,習志野,580,せ,2019/8/26 15:41,2-1_all_corrected,79,59,285,285,364,344
201520,30157_20190826093401.jpg,関西スーパー中央,***7,神戸,30,や,2019/8/26 9:33,2-1_all_corrected,57,35,81,383,138,418
203045,30072_20190826190506.jpg,関西スーパー京阪大和田１F,7082,大阪,580,ほ,2019/8/26 19:04,2-1_all_corrected,84,62,163,246,247,308
201947,30055_20190826123532.jpg,マミーマート東大宮（第3）,5332,大宮,583,き,2019/8/26 12:35,2-1_all_corrected,67,69,0,103,67,172
202356,30060_20190826154157.jpg,関西スーパー小野原,3406,大阪,480,な,2019/8/26 15:41,2-1_all_corrected,77,65,460,338,537,403
202993,30111_20190826185116.jpg,イオン稲毛,**48,千葉,302,に,2019/8/26 18:50,2-1_all_corrected,58,43,359,131,417,174
203006,30132_20190826185451.jpg,イオンスタイル東神奈川,*315,横浜,379,ぬ,2019/8/26 18:54,2-1_all_corrected,68,52,329,171,397,223
203001,30169_20190826185308.jpg,イオン相模原ショッピングセンター,8216,富山,581,き,2019/8/26 18:52,2-1_all_corrected,77,59,246,182,323,241
202778,30132_20190826180555.jpg,イオンスタイル東神奈川,1619,横浜,504,ゆ,2019/8/26 18:05,2-1_all_corrected,71,57,250,159,321,216
201599,30072_20190826102044.jpg,関西スーパー京阪大和田１F,3579,大阪,502,め,2019/8/26 10:20,2-1_all_corrected,72,55,307,141,379,196
202740,30132_20190826175628.jpg,イオンスタイル東神奈川,*612,横浜,352,た,2019/8/26 17:56,2-1_all_corrected,72,55,301,153,373,208
203090,30045_20190826191544.jpg,マックスバリュー徳川明倫,*358,名古屋,32,ひ,2019/8/26 19:15,2-1_all_corrected,73,59,209,254,282,313
202946,30046_20190826184137.jpg,マミーマート船橋日大[地上],8421,習志野,501,も,2019/8/26 18:40,2-1_all_corrected,84,74,475,213,559,287
202377,30039_20190826154658.jpg,イトーヨーカドー大井町,**11,品川,31,ま,2019/8/26 15:46,2-1_all_corrected,69,57,253,77,322,134
201957,30046_20190826123723.jpg,マミーマート船橋日大[地上],***5,千葉,30,な,2019/8/26 12:37,2-1_all_corrected,81,73,15,340,96,413
202984,30132_20190826185013.jpg,イオンスタイル東神奈川,5884,横浜,337,ひ,2019/8/26 18:49,2-1_all_corrected,68,62,108,260,176,322
202948,30144_20190826184203.jpg,イオン幕張,1118,千葉,339,ろ,2019/8/26 18:41,2-1_all_corrected,42,31,289,116,331,147
202722,30132_20190826175249.jpg,イオンスタイル東神奈川,1219,横浜,542,め,2019/8/26 17:52,2-1_all_corrected,71,58,245,206,316,264
202573,30111_20190826170356.jpg,イオン稲毛,1958,千葉,332,む,2019/8/26 17:02,2-1_all_corrected,58,43,334,144,392,187
201554,30001_20190826095836.jpg,関西スーパー高石駅前,8851,和泉,330,て,2019/8/26 9:58,2-1_all_corrected,93,66,332,225,425,291
201766,30072_20190826112509.jpg,関西スーパー京阪大和田１F,**11,大阪,31,ま,2019/8/26 11:24,2-1_all_corrected,70,52,101,90,171,142
202913,30063_20190826183547.jpg,コーナン相模原小山モール,5139,相模,580,ゆ,2019/8/26 18:35,2-1_all_corrected,53,48,465,117,518,165
202589,30144_20190826170756.jpg,イオン幕張,3101,千葉,480,つ,2019/8/26 17:07,2-1_all_corrected,74,58,134,231,208,289
202545,30086_20190826165426.jpg,テックランド大阪りんくう,**55,和泉,31,ぬ,2019/8/26 16:54,2-1_all_corrected,51,40,168,233,219,273
202777,30167_20190826180515.jpg,イオン東雲店,*708,足立,335,る,2019/8/26 18:04,2-1_all_corrected,76,79,4,289,80,368
201951,30063_20190826123612.jpg,コーナン相模原小山モール,***3,横浜,30,も,2019/8/26 12:35,2-1_all_corrected,51,42,178,136,229,178
202516,30111_20190826164002.jpg,イオン稲毛,3432,千葉,502,に,2019/8/26 16:39,2-1_all_corrected,72,51,306,188,378,239
201538,30060_20190826094924.jpg,関西スーパー小野原,7870,奈良,580,て,2019/8/26 9:49,2-1_all_corrected,81,65,356,322,437,387
201428,30045_20190826075937.jpg,マックスバリュー徳川明倫,**33,名古屋,31,む,2019/8/26 7:59,2-1_all_corrected,49,38,289,82,338,120
203065,30111_20190826190841.jpg,イオン稲毛,*881,千葉,530,る,2019/8/26 19:07,2-1_all_corrected,49,38,170,122,219,160
202204,30144_20190826142759.jpg,イオン幕張,***7,野田,586,を,2019/8/26 14:27,2-1_all_corrected,56,38,184,150,240,188
202000,30091_20190826125424.jpg,イトーヨーカドー木場 立体,**13,大宮,541,ね,2019/8/26 12:53,2-1_all_corrected,48,37,273,26,321,63
203542,30137_20190826215344.jpg,イオンスタイル品川シーサイド,4444,品川,532,ね,2019/8/26 21:53,2-1_all_corrected,73,51,186,149,259,200
203126,30063_20190826192455.jpg,コーナン相模原小山モール,7745,相模,301,そ,2019/8/26 19:24,2-1_all_corrected,64,62,525,137,589,199
202235,30062_20190826144049.jpg,ミスミモール,**11,神戸,31,め,2019/8/26 14:40,2-1_all_corrected,68,53,354,168,422,221
202804,30132_20190826181143.jpg,イオンスタイル東神奈川,2067,横浜,530,は,2019/8/26 18:11,2-1_all_corrected,72,52,320,144,392,196
203175,30110_20190826193732.jpg,イオン金沢八景,8288,横浜,304,め,2019/8/26 19:37,2-1_all_corrected,51,39,348,112,399,151
202261,30144_20190826145410.jpg,イオン幕張,9000,千葉,359,ぬ,2019/8/26 14:53,2-1_all_corrected,78,60,245,289,323,349
202602,30046_20190826171127.jpg,マミーマート船橋日大[地上],2027,習志野,531,に,2019/8/26 17:11,2-1_all_corrected,52,81,546,311,598,392
202430,30169_20190826160513.jpg,イオン相模原ショッピングセンター,8424,相模,301,て,2019/8/26 16:04,2-1_all_corrected,71,50,203,142,274,192
203349,30110_20190826204732.jpg,イオン金沢八景,1103,横浜,346,む,2019/8/26 20:47,2-1_all_corrected,83,69,202,228,285,297
202250,30072_20190826144925.jpg,関西スーパー京阪大和田１F,1027,なにわ,533,さ,2019/8/26 14:48,2-1_all_corrected,84,67,53,235,137,302
202633,30072_20190826172558.jpg,関西スーパー京阪大和田１F,9224,大阪,581,ぬ,2019/8/26 17:24,2-1_all_corrected,72,54,277,99,349,153
203312,30169_20190826202955.jpg,イオン相模原ショッピングセンター,4119,多摩,302,め,2019/8/26 20:29,2-1_all_corrected,94,82,443,350,537,432
201445,30072_20190826082050.jpg,関西スーパー京阪大和田１F,1568,大阪,130,あ,2019/8/26 8:19,2-1_all_corrected,97,82,35,340,132,422
201648,30072_20190826104424.jpg,関西スーパー京阪大和田１F,**11,大阪,31,ま,2019/8/26 10:43,2-1_all_corrected,54,39,358,188,412,227
203111,30110_20190826192223.jpg,イオン金沢八景,***7,横浜,30,ら,2019/8/26 19:21,2-1_all_corrected,74,60,403,262,477,322
203384,30111_20190826210421.jpg,イオン稲毛,5361,千葉,561,さ,2019/8/26 21:03,2-1_all_corrected,54,45,149,158,203,203
203142,30110_20190826192935.jpg,イオン金沢八景,8008,横浜,588,ら,2019/8/26 19:29,2-1_all_corrected,73,58,190,237,263,295
201847,30157_20190826120252.jpg,関西スーパー中央,*267,神戸,530,つ,2019/8/26 12:02,2-1_all_corrected,55,42,130,380,185,422
202860,30078_20190826182510.jpg,イオンスタイル仙台卸町店,7412,仙台,580,に,2019/8/26 18:24,2-1_all_corrected,66,60,172,119,238,179
203397,30157_20190826211516.jpg,関西スーパー中央,1709,神戸,503,み,2019/8/26 21:14,2-1_all_corrected,53,47,93,324,146,371
202889,30132_20190826183105.jpg,イオンスタイル東神奈川,2609,横浜,505,と,2019/8/26 18:30,2-1_all_corrected,71,53,280,186,351,239
202287,30144_20190826150528.jpg,イオン幕張,8372,千葉,330,り,2019/8/26 15:04,2-1_all_corrected,75,54,177,216,252,270
203158,30110_20190826193412.jpg,イオン金沢八景,*925,横浜,538,ね,2019/8/26 19:33,2-1_all_corrected,72,58,261,189,333,247
201891,30060_20190826121440.jpg,関西スーパー小野原,2579,大阪,580,ぬ,2019/8/26 12:14,2-1_all_corrected,70,59,367,203,437,262
203160,30060_20190826193453.jpg,関西スーパー小野原,9999,大阪,31,り,2019/8/26 19:34,2-1_all_corrected,85,73,470,237,555,310
202845,30132_20190826182216.jpg,イオンスタイル東神奈川,6465,横浜,304,ひ,2019/8/26 18:21,2-1_all_corrected,71,55,304,135,375,190
202644,30167_20190826172934.jpg,イオン東雲店,**21,大宮,431,て,2019/8/26 17:29,2-1_all_corrected,80,63,170,305,250,368
202485,30072_20190826162713.jpg,関西スーパー京阪大和田１F,*707,大阪,585,く,2019/8/26 16:26,2-1_all_corrected,74,66,0,184,74,250
203561,30169_20190826221648.jpg,イオン相模原ショッピングセンター,*350,相模,337,は,2019/8/26 22:16,2-1_all_corrected,86,72,93,319,179,391
202675,30111_20190826173959.jpg,イオン稲毛,6808,千葉,503,て,2019/8/26 17:39,2-1_all_corrected,57,47,212,154,269,201
202211,30167_20190826143138.jpg,イオン東雲店,**26,大宮,338,み,2019/8/26 14:31,2-1_all_corrected,50,38,296,140,346,178
203161,30105_20190826193501.jpg,カスミフードスクエア春日部武里,*705,春日部,584,ひ,2019/8/26 19:34,2-1_all_corrected,74,65,103,276,177,341
201609,30072_20190826102426.jpg,関西スーパー京阪大和田１F,2219,大阪,580,け,2019/8/26 10:23,2-1_all_corrected,50,39,439,77,489,116
202844,30137_20190826182159.jpg,イオンスタイル品川シーサイド,2285,水戸,301,み,2019/8/26 18:21,2-1_all_corrected,73,59,388,182,461,241
202424,30144_20190826160139.jpg,イオン幕張,1233,千葉,532,せ,2019/8/26 16:01,2-1_all_corrected,50,39,164,93,214,132
202616,30111_20190826171932.jpg,イオン稲毛,*303,千葉,338,ゆ,2019/8/26 17:17,2-1_all_corrected,50,43,195,135,245,178
203166,30110_20190826193543.jpg,イオン金沢八景,1787,横浜,480,あ,2019/8/26 19:35,2-1_all_corrected,73,55,185,259,258,314
202875,30110_20190826182924.jpg,イオン金沢八景,3528,横浜,504,ゆ,2019/8/26 18:28,2-1_all_corrected,43,31,392,72,435,103
202627,30144_20190826172423.jpg,イオン幕張,*500,千葉,540,は,2019/8/26 17:23,2-1_all_corrected,79,53,251,282,330,335
202886,30157_20190826183026.jpg,関西スーパー中央,2587,神戸,503,と,2019/8/26 18:30,2-1_all_corrected,54,42,197,356,251,398
202872,30078_20190826182848.jpg,イオンスタイル仙台卸町店,8278,宮城,503,と,2019/8/26 18:28,2-1_all_corrected,56,44,291,96,347,140
202826,30132_20190826181717.jpg,イオンスタイル東神奈川,1927,横浜,581,く,2019/8/26 18:16,2-1_all_corrected,68,57,322,115,390,172
202479,30110_20190826162621.jpg,イオン金沢八景,7074,横浜,301,ろ,2019/8/26 16:25,2-1_all_corrected,51,39,361,76,412,115
202689,30169_20190826174258.jpg,イオン相模原ショッピングセンター,5813,横浜,583,う,2019/8/26 17:42,2-1_all_corrected,51,43,127,109,178,152
202828,30132_20190826181733.jpg,イオンスタイル東神奈川,1388,横浜,530,む,2019/8/26 18:17,2-1_all_corrected,72,56,289,192,361,248
202810,30132_20190826181306.jpg,イオンスタイル東神奈川,*711,横浜,369,や,2019/8/26 18:12,2-1_all_corrected,68,56,254,202,322,258
201808,30022_20190826114204.jpg,業務スーパー平野駅前,***1,和泉,30,ゆ,2019/8/26 11:41,2-1_all_corrected,81,77,19,144,100,221
203286,30110_20190826201920.jpg,イオン金沢八景,9764,横浜,304,め,2019/8/26 20:18,2-1_all_corrected,78,68,131,239,209,307
202362,30167_20190826154308.jpg,イオン東雲店,7411,足立,230,さ,2019/8/26 15:42,2-1_all_corrected,58,42,373,349,431,391
202953,30167_20190826184315.jpg,イオン東雲店,6438,足立,580,ぬ,2019/8/26 18:42,2-1_all_corrected,67,77,0,238,67,315
203085,30169_20190826191410.jpg,イオン相模原ショッピングセンター,1447,多摩,543,せ,2019/8/26 19:13,2-1_all_corrected,40,37,37,20,77,57
201973,30144_20190826124650.jpg,イオン幕張,1008,千葉,531,の,2019/8/26 12:46,2-1_all_corrected,60,42,156,202,216,244
202755,30132_20190826175957.jpg,イオンスタイル東神奈川,***3,横浜,300,も,2019/8/26 17:59,2-1_all_corrected,68,52,261,193,329,245
203025,30167_20190826185938.jpg,イオン東雲店,4488,足立,583,さ,2019/8/26 18:59,2-1_all_corrected,47,34,298,239,345,273
201540,30068_20190826095103.jpg,ケーヨーデイツー唐木田,***3,多摩,30,や,2019/8/26 9:50,2-1_all_corrected,45,36,239,112,284,148
202594,30144_20190826170900.jpg,イオン幕張,*703,千葉,544,て,2019/8/26 17:08,2-1_all_corrected,82,65,308,306,390,371
203226,30110_20190826195425.jpg,イオン金沢八景,5105,横浜,532,さ,2019/8/26 19:54,2-1_all_corrected,69,69,531,187,600,256
203013,30063_20190826185707.jpg,コーナン相模原小山モール,1031,相模,537,た,2019/8/26 18:56,2-1_all_corrected,53,48,495,152,548,200
201576,30001_20190826101153.jpg,関西スーパー高石駅前,1890,和泉,501,ほ,2019/8/26 10:11,2-1_all_corrected,102,70,278,289,380,359
202535,30111_20190826165105.jpg,イオン稲毛,3605,袖ヶ浦,100,さ,2019/8/26 16:50,2-1_all_corrected,56,44,303,174,359,218
202738,30132_20190826175544.jpg,イオンスタイル東神奈川,3782,横浜,530,ふ,2019/8/26 17:55,2-1_all_corrected,81,62,188,229,269,291
202964,30132_20190826184552.jpg,イオンスタイル東神奈川,1030,横浜,350,す,2019/8/26 18:45,2-1_all_corrected,70,51,308,105,378,156
202990,30132_20190826185054.jpg,イオンスタイル東神奈川,4936,横浜,580,も,2019/8/26 18:50,2-1_all_corrected,68,51,237,151,305,202
203046,30111_20190826190518.jpg,イオン稲毛,3399,千葉,331,ら,2019/8/26 19:04,2-1_all_corrected,57,42,356,126,413,168
202736,30110_20190826175426.jpg,イオン金沢八景,1031,横浜,356,た,2019/8/26 17:53,2-1_all_corrected,92,73,427,375,519,448
202504,30169_20190826163456.jpg,イオン相模原ショッピングセンター,8424,相模,301,て,2019/8/26 16:34,2-1_all_corrected,57,41,146,99,203,140
202963,30144_20190826184552.jpg,イオン幕張,*228,千葉,331,ら,2019/8/26 18:45,2-1_all_corrected,41,35,191,124,232,159
202937,30169_20190826184037.jpg,イオン相模原ショッピングセンター,6714,相模,580,た,2019/8/26 18:40,2-1_all_corrected,56,40,373,118,429,158
202339,30168_20190826153336.jpg,イオン東雲店（屋上）,2106,岐阜,531,む,2019/8/26 15:33,2-1_all_corrected,75,59,352,215,427,274
203211,30144_20190826194822.jpg,イオン幕張,9124,千葉,301,め,2019/8/26 19:47,2-1_all_corrected,87,64,340,319,427,383
202566,30167_20190826170202.jpg,イオン東雲店,6298,品川,58,り,2019/8/26 17:01,2-1_all_corrected,80,59,21,297,101,356
202754,30078_20190826175941.jpg,イオンスタイル仙台卸町店,4113,宮城,581,ね,2019/8/26 17:59,2-1_all_corrected,69,57,167,134,236,191
202102,30090_20190826133618.jpg,イトーヨーカドー木場 西棟,3722,品川,580,い,2019/8/26 13:35,2-1_all_corrected,78,60,220,261,298,321
